# #######################################
#. .  #. . .  #. . .                  # #
# # # # ### ### ### ######### ####### # #
# #.# #.# #. . .  #. . . .  #       #   #
# # # # # ############# # # ##### #######
# #.# #. . . .# #. . .# #.#     #       #
# # ######### # # ### ### ########### # #
# #. . . . . .# #.#  . . .    #     # # #
######### ##### # ##### # ##### ### ### #
 . . . .#       #. .#   # #     #       #
####### ######### # ##### ######### ### #
#     #. . . . .# #. .#   #     #   #   #
# ### ######### ### # # ### ### # ### # #
# #            . .# #.# # # # # # #   # #
# ############### ### # # # # # ### # # #
#   #            . . .# # # # #   # # # #
### # # ############# # # # # ### # # # #
# # # # #   #         # #   #   # # # # #
# # # # # ### ### ##### ####### # # # # #
# # # # # #   #       #       # #   # # #
# # # ### # ####### # # ##### # ### ### #
#   #   # # #     # # #     # #   # #   #
####### # # # ### ### # ##### ### ### ###
#       # # # #       #   #     #     # #
# ####### ### # ####### # # # # ####### #
#   #   #   # # #       # # # #   #     #
# # # # ### # ### ### # # # ##### # #####
# # # #       #   #   # # #     #   #   #
# # ######### # ### ### # # # ##### # ###
# #       #   # #   # # # # #     # #   #
######### # ### ### # # # ### # # ##### #
#       # # #   #   #   #   # # #     # #
# ##### ### # ### ######### ### ### ### #
# #   #     #   # #   #     #     #   # #
# # ####### # # # ### # ##### # # ### # #
# #         # # #   #   #     # #   #   #
# ########### # ### ##### ### # #########
# #       #   # # #   #   #   #     #   #
# # ##### # ### # # # # ### ####### # # #
#     #   #   #   # # #   #       #   # #
#########################################
