# #######################################
#.    #. .  #. .  #. .        #     #   #
# ### # # ### # ### # ##### # # ### # # #
#.#   #.#. . .#. . .#. .  # #   # # # # #
# ##### ############### # ### ### # ### #
#. . . .#     #   #. . .#   #   # #     #
# # ##### ### ### # ### ### ### # # #####
# #     #   #     #. .#   #   #   #     #
# ##### ### ####### # ####### ######### #
#     #   # #     # #. . .# #     #   # #
# # # # ### # ### # ##### # ##### # # ###
# # # #     # # # # #. .#.#       # #   #
# # # ######### # # # # # ######### ### #
# # #         #   # #.#. .    #     # # #
# # # ######### ##### ### ### ####### # #
# # #     #     #. . .#     #         # #
# ####### # ##### ################### # #
#   #   #   #    . . . . .  #       #   #
# # # # ##### ### # ##### # ####### #####
# # # #     # #   #     #.#       # #. . 
# # # ####### # ####### # ####### # # ###
# # #   #     # #       #. .    #   #.# #
# # ### # # ### ######### # ######### # #
# # #     # #           # #. . .  #. .# #
### # # ##### ######### # # # # ### ### #
#   # # #     #         # # # #. . .  # #
# ### ### ##### ######### # ### ####### #
#   # #   #   # #     #   #   #         #
# # # # # ### # # ##### ##### ###########
# # # # # #   # #       #   #           #
### ### ### ### ########### # ##### ### #
#   #   #   #               #   #     # #
# # # ### ### # # # ############# # ### #
# # #     #   # # #   #   #       # #   #
# ######### ### # # ### # ### ### ### # #
#   #     # #   # #   # # #   #   #   # #
# # ##### ### # # ##### ### ####### ### #
# #     #   # # #   # #     #       # # #
# ######### # # ### # ####### ##### # # #
#         #   #   #   #       #     #   #
#########################################
