############# ###########################
#. .#   #  . .                          #
# # # # # # # ########### ############# #
#.#.# #   #.# #         #           #   #
# # ####### # # ##### ##### ####### #####
#.#. . . . .#       # #   # #     #     #
# ####### # ######### # # ### ######### #
#.#       #     #     # #     #. .#     #
# # ########### # ##### ####### # #######
#.#   #         # #     #. .  #.#. .    #
# ##### ######### # ##### # ### ### #####
#. . .#   #       # # #. .#. . .  #. . . 
# ### ### # ##### # # # ####### # # #####
# #. .# # #   #   # #  .#     # # # #   #
### # # # ### ##### ### # ### # # # # ###
#. .#   #   #     #   #.# #   # # # #   #
# ################### # # # ##### # ### #
#. . . . . . .        #.# #   #   #   # #
# # ####### # ######### # # ### # # # # #
# #       # #. .#. . . .# # #   # # #   #
# ####### # ### # ######### # ### #######
#       # #   #. .          # # #       #
### ### # ### ########### ### # ####### #
# #   # #   #   #       #   # #     #   #
# ### ### ####### # ### ##### ##### # # #
#   #   # #     # # # # #         #   # #
### # # # # ### # # # ### ####### #######
# # # # #     #   #   # #       # #     #
# # ### ### ########### # ### # # ##### #
# # #     #   #       # #   # # #       #
# # # # # ### ####### # ### # ######### #
#     # #   #         #   # #         # #
##### # # # ############# # # # ##### # #
#     # # #         #   # # # #   #   # #
# ##### ####### # # ### # # ##### # #####
#   #   #     # # #     # #     # # #   #
### # ### ### # # ####### ##### ### ### #
# # #   # #   # #       # #   #   #     #
# # # # ### ### # # ##### # # ### #######
#   # #     #   # #       # #           #
#########################################
