################################# #######
#            . .#    . . . .#    .  #   #
# ### ####### # ##### ##### # ### # ### #
# #   #      .#. . . .#   #.#   #.#     #
# # ######### ########### # ### # #######
# #       #. .#. . . .#   #. .# #.  #   #
# ####### # # # ##### # ##### ### # # ###
#     #   #.# #. .  #.#     #. . .# # # #
####### ### ##### ### ##### ### # # # # #
#       #  . . . .  #. .  # #   # # #   #
# # ####### ####### ### # # ##### # ### #
# # #       #. . .#   #.# # #     #   # #
# # ######### ### ### # ### # ##### ### #
# #     #  . .#. .#   #. .# # #   #   # #
# ##### ### ### ### ##### # # # # ### # #
#   #   #. .#  .# # #. . .# # # #   # # #
######### ##### # # # ### # # # ### # # #
#      . .#    .#   #. .# #   # #   # # #
# ##### ####### ####### # ### # ##### # #
#     #. . . .#. . . . .#   # #     # # #
# # # ##### # ##### ####### ####### # # #
# # # #   # #. .#   #. . .#         #   #
# # # # # # ### ##### ### ###############
# # #   # #   #. .#. .  #.#. . .    #   #
# ####### ### ### # ##### # ### ### # # #
#       #   #   #. .  #. .#.  #. .#   # #
# ##### # # ### ####### # # ##### #######
# #   # # #   #     #. .# #.#. . .  #. . 
# ### # # ######### # ##### # ##### # ###
#   # # #         # #. .#. .#.#     #.# #
### # # ##### ### # # # # ### ####### # #
#   # #     # #   # # #. .  #. .#. . .  #
# # # # ### ### # # ### # ##### # #######
# # # #   #   # # #   # # #   #. .#     #
# ### ####### ### ### # ### # ##### ### #
# #   #       #   # # #     # #     # # #
# # ##### ##### ### # ### ### # ##### # #
# # # #   #   #     #   #   #         # #
# # # # ##### ####### # ############### #
#   #   #             #         #       #
#########################################
