##### # #################################
#  . .#.#     #   #   #   #       #     #
### ### ##### # # ### # ### ### ### ### #
#. .#. .#. . .# #   #       # # #   # # #
# # # ### ### # ### # ####### # # ### # #
#.# #. . .# #.# #. .# #       #       # #
# # ####### # ### # # # ### #############
#.#       #  . . .#.# #   #   #         #
# ####### ######### # # ##### # ####### #
#. . . .#         #.# # #   # #       # #
# # ### ########### # # # ##### ##### # #
# #   #.  #. . . . .  # # #     #   # # #
# ##### # # ####### ### # # ##### ##### #
# #. . .# #.#     # #     # #   #       #
### ### ### ##### ### ##### # # ####### #
#. .#   #. .      #           #     #   #
# # ##### ######### ############### #####
#.# #. . .  #         #           #     #
# ### ####### ######### ### ### # ### ###
#. .#. .  #             # # #   #   #   #
# # ### ### ############# # # ##### # # #
# #. . .      # #       #   # #     # # #
# ##### ####### # ### ##### # # ####### #
#     # # #   #   #   #   # # # #       #
# ### # # # # ##### ### # # # # # # #####
# #   # #   # #   # # # # # # # # # #   #
### # # ##### ### # # # # ### ### ### ###
#   # #     #   #   # # #   #   #     # #
# ### ### ##### # ### # ### ### ####### #
#   #   #   #   # #   # # # #   #       #
# # ####### ### # # # # # # # ### # #####
# #       # #   #   # #   # #   # #     #
# ### # # ### ####### # ### ### # ##### #
#   # # #             # #   #   #   # # #
### # ################# # ######### # # #
#   #                   #         # # # #
# # ############### ########### ### # # #
# # #             #       #   # #   # # #
# ### ########### ### ##### # ### ### # #
#       #           #       #       #   #
#########################################
