################### ################# ###
#   #     #   #. . .#    . . .#. .#  .  #
# # # ### # # # ##### ### ### # # ### ###
# #   # # # # #. .# #   #.# #. .#. .#. .#
# ##### # # ##### # ##### # ####### # # #
#     #   #      . . . . .#     #. .# #.#
####### # ########### ### ##### # ### # #
#   #   #     #       #   #     #.# # #.#
# # # ####### ### ##### ### ##### # # # #
# #   #   #       #     #   #  . .# # #.#
# ### # # ######### ##### ##### ### # # #
# #   # #   #   #   #   #      . . .# #.#
# ##### ####### # ##### ########### # # #
#   #   #   #   # #   #       #   #.# #.#
##### ### ### ### # # ##### # # # # ### #
#     # # #   #   # #       # # #  . . .#
# ##### # # ### # # ######### # ##### # #
# #     #     # # # #   #     # #     # #
# ### # ##### ### # # # ##### ### # ### #
#   # #           # # #     #     # #   #
### # ############# ####### ##### ### # #
#     # #       #   #   # #       #   # #
### ### # ### # # # # # # ######### ### #
#   #   # #   #   # # #     #       #   #
# ### ### ### # # # # ##### # ### ##### #
# # #     #   # # # # #   # #   # #     #
# # ####### # ### # # ### # ##### # ### #
#   #       # #   # #   # #       #   # #
##### ##### # # ### ### # ########### ###
#     # #   # #   #   # # #         #   #
# ##### # ############### ### ##### # # #
#     # # #       #     #     #   # # # #
##### # # # ##### ### # ####### # # ### #
#   #   # #     #   # #       # #       #
# ####### ######### # ################# #
# # #       #     #       #         #   #
# # ##### ### ### ####### ### ##### # # #
# # #     #   #       #       #   #   # #
# # # ### ########### ######### # ##### #
#     #   #                     #       #
#########################################
