########### ######### ###################
#          .      #  . . . .#. . .#     #
# ######### ##### ######### # ### # ### #
# # #      . .  #       # #. .# #. .#   #
# # # ####### # ####### # ### # ### #####
# #   # #   #.# #. .# # #     #   #.#   #
# ##### # # # ### # # # ######### # # # #
#         # #. . .#.# # #     #   #.# # #
# # # ##### # ##### # # # ### # ### # ###
# # # #   # #   #. .#   # # #   #. .#   #
# # ### # # ### # ####### # ##### ##### #
# #     # #   # #. . . .  # #. . .      #
# ######### ### ####### ### # ###########
#     #   #   #   #   #.#. . .          #
# # ### # # # ### ### # # ####### ##### #
# #     # # #   #     #. .      # #   # #
######### # ########### # ##### # ### # #
#         # #         # # #   # #   #   #
# ##### # # # ######### ### # # ### #####
# #     # # #   #       #   # #   #     #
# # ##### # ### # ### ### ### ### ##### #
# #   #   #     # #   #   # #   #     # #
# ##### ######### ##### ### # ### ### # #
#   #   #                   # #   #   # #
# # # ### ####### ### ####### # ### ### #
# # # #   #         #   #     #   #   # #
# # # # ### ####### ### ######### ##### #
# # # # #   #   #     #   #   #     #   #
####### # ### # # # ### # # # # # ### # #
#       # #   #   #   # # # # # #   # # #
# ##### # # # ####### # # # # # ### # ###
# #   # # # # #     # # #   # # # # #   #
# ### # # # # # ##### # ####### # # # # #
#     # # # # #       # #   #   #   # # #
######### # # ########### # # # ####### #
#         # #   #     #   # # # #   # # #
############# # ##### # ##### # ### # # #
# #           # #   #   #     #   # #   #
# ####### ##### # # ### ######### # ### #
#         #     # #               #     #
#########################################
