################################# #######
#       # #                      .  #   #
# ##### # # ### ##### ####### ### # # # #
# #       # #     #   #       # #.#   # #
# ### # ### ####### ### ##### # # ##### #
# #   # #   #       #   #   #   #. . .# #
### ### # ### # ##### ### ####### # # # #
#   # # #   # #   #   #   #     # # #.# #
# # # # ##### ### # ### ##### # # # # # #
# # #   #     # # # #   #   # # # # #.# #
# # ### ### ### # ### ##### # ### # # ###
# # # #   #     #     #   # #     # #. .#
# # # ### ############### # ##### # ### #
# # # #     #             #       #   #.#
# ### # # # # ########### ########### # #
#   # # # #   #         #   #         #.#
### # # # ####### ##### ### ##### ##### #
# #   # # #   #   #   #   #   #   #. . .#
# ##### # ### ### # ##### ### ### # ### #
#     # #   #   # #   #   #     # #.# # #
##### # # # ### ##### # ####### # # # # #
#   #   # # # #     #   #         #.# # #
### ####### # ##### # ############# # # #
#           #     #   #            .# # #
### # ########### ### ### ######### # # #
#   # #             #     #        .#   #
##### # ##### # ### ### ### ####### #####
#     # #     # # # #   #   #  . . .#. .#
# ##### # ### ### # ##### ##### # ### # #
# #     # #   #   #   #   #  . .# #. .#.#
# # # ##### ### ##### ### # # ##### ### #
# # # #   # # # #   #     # #. . . .  #.#
# ### # # # # # # # ### ### # ######### #
#   # # # #   # # #     #   # #   #. . .#
# # # ### ##### # ####### ### # # # ### #
# # #   #   #   # #       # #   # #.#   #
### ### ### # ### # ##### # ##### # #####
#   # #   # # #   # #   # # #     #. .  #
# ### # ### # ##### # # # # # ##### # # #
#     #     #       # #   #   #     #.# #
##################################### ###
