######### ###############################
#   #    .    #               #   #     #
# # # ### # ### ##### ##### ### ### # # #
# # # #  .#     #         #   # #   # # #
# ### # # ################### # # ### ###
#     # #. . . . . .        #   # # #   #
# ##### ####### ### ##### ####### # ### #
# #   # #. . .#   #.    #       #   # # #
# # ### # ### ### # ### # ### ##### # # #
# #     #.# #. .# #. .# #   #     # #   #
# # ##### # ### # ### # ######### # #####
# # #  . .#   #.# #. .# #         #. . . 
# ### # ##### # ### # ### ######### #####
# #   #. . .#  . .#.# #   #   #. . .#   #
# # # # ### ##### # # # ### ### ####### #
# # # #   #.#   #.#.# # #   #. .    #   #
# # # # # # # ### # ### # ### ####### ###
# # # # # #.#    . .#   #. . .# #       #
### # ### # ######### ### ##### # #######
#   # #   #.  #. . .# #. .#     # #     #
# ##### ### # # ### ### ### ##### # ### #
# #     #. .# #.# #. .#. . .#       #   #
# # ##### ##### # # # ##### # ###########
# #     #.#. . .# # #.  #. .#           #
# ####### # ##### # # ### ### ######### #
#     #. .#.#   # # #. . .    #     #   #
# ### # # # ### # # ##### ##### ### # # #
# #   #.# #. .# # #     # #       # # # #
# # ### ##### # # ##### ### ### ### # ###
# # # #. .  #. .#     #     #   #   #   #
# # # # # ##### ### ######### # # ##### #
# # #   #. . . .  # #     #   # # #   # #
# # ##### ####### # # ### # ### # ### # #
# #     # #   #   # # #   #   # #   #   #
# ### # # # # # ### # # ##### # ### ### #
#   # # #   # # #   # # #     #   #   # #
### # ####### ### ##### # ######### # ###
# # #   #   #   #   #   # #   #     #   #
# # # ##### # # # ### ##### # # ####### #
#   #       # #       #     #   #       #
#########################################
