### # ###################################
# #.#. . .      #. .                    #
# # ##### ####### # ####### ### ####### #
# #. . .#. . . . .#.  #   #   # #     # #
# ##### # ######### # # # # # # # ### # #
# #   #.#         #.# # #   # # # # # # #
# # # # ########### ### ##### # # # # # #
# # #. .#. . .#  . .#   #     #   # # # #
# ### ### ### # # ### ############# # # #
#    . . .# #.# #. .#   #           # # #
########### # # ### ### # ##### ##### ###
#   #   #. . .# # #. .#   #   #     #   #
# # # ### ##### # ### ####### ##### # # #
# # # #. .#   # #   #. .    #     # # # #
### # # ### # # ### # # ### ##### # ### #
#   #  .# # # #     # #.  #       # #   #
# ##### # # ##### ### # # ####### # # ###
# #   #.# #     #   # #.# #     # # #   #
# # # # # ##### ##### # # ##### ### # # #
#   #  . . .# # #     #.#     #   # # # #
########### # # ### ### ##### ### # # # #
#         #. .#   #   #. .  #   #   # # #
# ### ### ### ### ##### # ##### ##### ###
# #   # # #  . .#. . .# #. .  #     #   #
### ### # ##### # ### ##### # # ### ### #
#   #   #   #  .#.# #. .#. .# #   # # # #
# ### ##### ### # # ### # # ##### # # # #
# # #   # #   #. .#    . .# #   # # #   #
# # ### # ### ### ##### ### # ### # #####
# #   #     #     #     #   #     #     #
# ### ### # ####### ##### ##### # ##### #
# #       #         #         # # #   # #
### ##### ########### ### # # ### # ### #
#   #     #   #       #   # # #   #   # #
# ######### # # ######### # # # ### # ###
# #       # #   #         # # # #   #   #
# ####### ############# ##### # # #######
#     # #               #     # # #     #
# ### # ################# # ##### ##### #
#   # #                   #             #
#########################################
