############################# ######### #
#                     #     #.#     #  .#
########### ##### ### # ### # ##### # # #
#           #       # # #   #. .# #   #.#
# ################### # ####### # ##### #
#     #       #       #   #. . .#  . . .#
####### ##### # # ### ### # ####### #####
#     #     # # # #     #  . . . .#. . .#
# ### ##### # # # ##### ######### # ### #
# #       # #   #   #     # #. .#.#   #.#
# ##### # # ####### ##### # # # # ##### #
#   # # # #       #     #  . .#. .#. . .#
### # # # ################# ####### ### #
# #   # #                 #.  #    .# # #
# ##### ############### # # ### ### # # #
# #     #               # #.#   #. .#   #
# # ##### # ############# # # ### # #####
# # #     # # #       #   #.# #. .# #. .#
# # # ##### # # ##### # ### # # ##### # #
#   #   #   # #   #   # #. .# #. . . .#.#
######### ### ### ##### # ### ####### # #
#         # #   # #   # #.  #   #. .# #.#
######### # ### # # # # # ####### # ### #
#         #   # # # # # #.#    . .#. . .#
# ########### # # # # # # # ### ####### #
# # #       #   # # # #  .# #. .#   #   #
### # ##### ### # # # ### ### # # # # # #
#   # #           # #   #. . .# # #   # #
# ### ########### ##### ##### # # #######
# #       #           #   #   # #   #   #
# # ##### ### ####### ### # ### # # ### #
# # #     #   #     #   #   #   # #   # #
# ### ##### ### ### ### ##### # # # # # #
#     #     #   # #           # # # # # #
####### ##### # # ############# # ### # #
#     # #     # # #   #       # #   # # #
# # # # ####### # # ### ####### ### # # #
# # # # #     # # #     #     # #   #   #
# # # ### ### # # ### ### ### ### # # ###
# # #     #     #         #       # #   #
#########################################
