############# ###########################
#     #      .  #. . .          #. . . .#
# ### # ### # ### ### ########### ##### #
# # # # #   #. . .  #. . . . .#. .# #. .#
# # # # # # # ######### # ### # ### # ###
#   # # # # #   #     # # #. .#. .# #. .#
##### ### ##### ##### # # # ##### # # # #
 . .#   #     #     # # # #. . . .  # #.#
### ### ##### ### ### # ######### ### # #
# #. . .#   #   #     #         #   # #.#
# ##### ### # ################# ### # # #
#     #. .# #     #   #       #   # # #.#
##### ### # ### ### # # ####### ### ### #
#   # #. .#   #     #   #       #   #. .#
# ### # ##### ################### ### ###
#     #.#  . . . . . . . . .# #   # #. .#
# ##### ### ### # ######### # # # # # # #
#   #. .#. .#   # #       #. .# # # # #.#
### # ### ### ### # ######### # ### ### #
# #  . .#. .# #   #   #. . .#.#     #. .#
# ##### ### ### ##### # ### # ####### # #
#      .#. .#   #     #. .#. .#. . . .# #
# ##### # ### ##### ##### ##### ##### # #
# #    . .#   #     #   #. . .#.# #   # #
# # ### ### ####### # ####### # # # ### #
# #   # #   # #   # #        . .#   #   #
# # # # # # # # # # ######### # ##### # #
# # # # # # #   #             # #     # #
# ### # # ##################### # # #####
# #   # #         #     #       # # #   #
# # ##### ####### # ### # # # ### # # # #
# #     # #     # # #   # # # #   #   # #
# # # # ####### # # ##### # ### ####### #
# # # #   #   #   #       #   # #     # #
# # ##### # # ############### # # ##### #
# #     #   # #       #       # #       #
# ########### ##### # ### # # # #########
#   #   #   # # #   #     # # #       # #
# # # # ### # # # # ######### ####### # #
# #   #     #   # #         #       #   #
#########################################
