######################### ######### #####
#     #    . . . . . .#  . .  #   #.#   #
# ##### # # ######### ##### # # ### # # #
# #     # #. .#      . . . .# #. . .# # #
# ### ### # # # ############# # ##### # #
#     #   # #.# #. . .#       #.#     # #
##### # # ### # # ### ######### ####### #
#     # # #. .# #. .#. .  #. . .      # #
# ##### # # # # ### ### ### ######### # #
# #     # #.# #   #. .#. . .        #   #
### ##### # ##### ### ########### # #####
#   #     #. .# # #  .          # #     #
# ### # ##### # # ### ######### # #######
# #   # #   #.# #   #.#       # #       #
# # ### ### # # ### # # ### ### ####### #
# # # # #   #.#     #.# # #   #       # #
# # # # # ### ####### # # ### ####### # #
# # # #   #  . . . .#.# # #     #     # #
# # # # ##### # # # # # # # ##### ##### #
# # # # # #   # # #. .#   #     #   # # #
# # # # # # ### # ### ### ##### ### # # #
# # # # # # # # #   #     #   #   # #   #
# ### # # # # # ### ######### # # # #####
# #   #   # #     #           # # # #   #
# # ####### ######### ######### # # # ###
#   #       #   #   #     #     # #     #
##### ##### ### # # ### # ####### ##### #
#   #     #     # # #   # #     #   #   #
# # # # # ####### ### ### # ### ### # ###
# # # # #       #     #   #   #   # #   #
# ### # # ##### ########### ### # # #####
#   # # #     # #           #   # #     #
### # # ##### # # ########### ######### #
#     #     # #             #         # #
# ####### ### ############# ##### ##### #
# #   # #   #         #   #     #   #   #
# # # # ### ######### # # # ### ### # ###
# # #   #       #     # # # # # #   #   #
# # ##### ####### ### # ### # # # #######
# #       #       #   #     #   #       #
#########################################
