############### #########################
#   #          . . .#. . . .  #. .      #
### # # ####### # # # ##### ### # ##### #
#   # # #       # #. .    #. .#.#.  #   #
# ##### # # ##### ### ####### # # # # ###
#       # #     #   # #. . .#.#.#.# # # #
######### ##### ### # # ### # # # # # # #
#       #     #   # # #. .#.#. .#.# #   #
# ##### ####### # # ### # # ##### #######
# #         #   # #   # #.#. . .#. . .  #
### ####### # # # # # ### ##### ### # # #
#   #       # # # # #   #.#   #. .# #.# #
# ######### # ### # ### # ### ### ### # #
# #           #   #   # #. .#    . . .# #
# # # ####### # ##### # # # ######### # #
# # # #   #   # #     # # #.#. .#   # # #
# # ### # # ### # ##### ### # # ### ### #
# #   # # # #   # #       #. .#. .#     #
# ### # ### # # # # ### # # ##### #######
# # # # #   # # # # #   # #   # #.#. . . 
# # # # # ### ### ### ### ### # # # ### #
# # #   # #     #   # #     # # #. .  # #
# # ##### # # # ### # ##### # # # # # ###
# #       # # #   # # #   # #   # # #   #
# ### ##### # # ### # ### # ##### ##### #
# #       # # # #   # #   #     #     # #
# ####### # # # # ##### ### # ####### ###
#       # # # # #       #   #   #   #   #
####### # # # # ######### ##### # ##### #
#       # # # # #       #     # #       #
# ####### # ### # # ### ##### # ##### # #
# #   #   #   #   #   # #   # # #   # # #
# # # ### ### # ### ### ### # ### # ### #
# # #     # # # # #   #   # # #   # #   #
# ##### # # # # # ### ### # # # ### # # #
# #   # # #   # # # #   #   # # #   # # #
# ### ### # ### # # ######### ### ### # #
#   #   # # #   #   #   #           # # #
# # ### # # # ##### # # ############# # #
# #   #   # #     #   #               # #
#########################################
