##### ###################################
#    .  #. . . . .    #                 #
# ### # # ####### # ### ######### ### # #
# #  .# #.#   #. .#   #   #     # #   # #
# ### ### # # # # ### # ### ##### # ### #
#   #. . .  # #.#   #   #   #     # #   #
### ######### # ######### ### ### # #####
# #   #. . .# #. . .      #   #   # #   #
# ### # ### ##### # ######### # ### # # #
 . .# #.#  . . .# #. .    #   # #   # # #
### ### ####### ##### ### # ### ### # ###
#  . .#. .#. .#. . .#. .# # #   #   #   #
##### # # # # ##### # # ### # ### ##### #
# #. .# #. .#.#. . .# #. .# # #   # #   #
# # ######### # ##### # # ### # ### ### #
# #.#. . . . .#.#     # #.  # #     #   #
# # # ######### ######### # # ####### ###
# #. .#       #.#. . . . .# #     # # # #
# # ######### # # ####### # ##### # # # #
# # #       #  . .#   #   #     #   #   #
# ### ##### ### # # ### ### ########### #
# #   #       # # #   # #     #       # #
# # ######### ### ### # # # # # ### ### #
#   #           # #     # # #     #     #
##### ######### # ##### # # # ##### #####
# #   #   #   #   #     # # #     #     #
# # ##### ### # ### ##### # ##### #######
#   #   #     # #   #     #     #       #
# ##### # ####### ##### ##### # # ##### #
# #   #   #       #     #     # #   #   #
### # # ##### ####### ### ### # ##### ###
#   # # #     #       #   #   #     # # #
# ### # ### ### # ##### ########### # # #
#   # #     #   # #   #       #   # #   #
### ############# ### # ##### # # # # ###
# #               #   #   #   # #   #   #
# ########### ### # ##### # #############
#             #   #   #   #             #
######### ### # ##### # ### # ### ##### #
#         #   #     #   #   #   #   #   #
#########################################
