####### ############################### #
#   # #.#     #       #            . . .#
# # # # ##### ### ### ####### ##### #####
# #   #.#   # #   # #       # #    . . .#
# ##### # # # # ### ####### # ##### ### #
# #   #.# # #   # #   #       #. .#   #.#
# # ### # ####### ### ######### # ##### #
# #. . .#      . . .# #    . . .#. . . .#
# # ########### ### # # ### ######### # #
# #. .#  . . . .#  .#   #. .#   #     # #
# ### # # ### ##### ##### # # ### ##### #
#   #.# #.#   #   #. .#. .# #     #     #
### # # # # ### # ### # ### ########### #
# #  .# #.#   # #    . .#   #     #     #
# ### # # ### # ######### ### ### # ### #
#   #.# #. .# # #         #   #   # #   #
# # # ### # # # # # ####### # ### # # # #
# # #. .# #.# # # #   #     #   #   # # #
# # ### ### ### # ### # ####### ##### # #
# #    . . .#   #   # # #       #     # #
# ####### # # ##### # ### ### ### ##### #
#   #     # # #   # # #   #   #   #   # #
# # # # ### # # ### # ##### ### ### # # #
# # # # #   # #     # #   #   # #   #   #
### ### ### # ####### # ### # # # ### # #
#   #   #   #     #   #   # # # # #   # #
# ### ### ### ### # # ### ### # # ##### #
#   # # # #     # # #   #     # #     # #
##### # # ### ### # ### ####### ##### # #
#   #   #   # #   #   #     # #     # # #
# # ####### # # ##### # ### # # ### # ###
# #   #     # #   # # #   #   #   # #   #
# ####### ### ### # # ########### # ### #
# #       #     # # #           # # #   #
# ### # ### # ### # ############# # # # #
#     # #   #   #   #     #       # # # #
# ####### # # # ######### ### ### ### # #
# #   #   # # #     #   # #   # # #   # #
# # ### ##### # ##### # # # # # # ##### #
# #     #     #       #   # # #   #     #
#########################################
