##### ############### ###################
#    .              #.#                 #
# ### ############### # ########### ### #
# #  . . .      #. . .  #   #     #   # #
# # # ### ####### ######### # ### ### # #
# # #   #. . .#. .#       #     # # # # #
# ##### ##### # ######### # ### ### # ###
#   #   #   #.#. . . . .# # # #     #   #
# # # ### # # ######### # # # ######### #
# # # #   # #.        #.# #     #     # #
# # ### ### # ####### # # ##### ##### # #
# #     # # #.#. . .# #.#     #     #   #
# # # ### # # # ### # # ##### ##### #####
# # #     # #.#.# #.# #. . . . . .#   # #
# # ####### # # # # ############# ### # #
# # #       #. .  #. .      #   #.  #   #
# ####### ### # ##### ##### # ### ##### #
#     #   #   # #   #. .#   #. . .      #
# ### # ### ### # # # # ##### ###########
#   # # #   #   # # # #.#. . .#       # #
##### # # # ##### ### # # ##### ### # # #
#     # # # #   # #   #. .  #   # # #   #
# # ### # ### # # ##### # ### ### # #####
# # # # #     # #   # # # #     # # #   #
# # # # # ##### ### # # ### ##### # # # #
# # #   #     #     # #   # # #   #   # #
# # ######### ### ### # # # # # ### ### #
# #         #   #     # #     #   #   # #
# # ### ### ### ####### # # ### #########
# #   #   # # #       # # #   # #   #   #
# ##### # ### # ####### # # ### # # ### #
#     # #     #   #   # # #     # # #   #
##### # ####### # # # # # ####### # # ###
#     #       # # # # # #     #   # #   #
# ############# ### # # # ##### # ##### #
# #           # #   # # # #     #       #
# # ######### # # ##### # # #############
# # #   #     # #   #   #     #         #
# # # # ##### # ### # # ####### ####### #
# # # #           #   #         #       #
#########################################
