################### #####################
#   # #       #    . .  #. . .  #       #
# ### # ####### ### # ### ### # # ##### #
#   #           #   #. . .# #.# #. . .# #
### ### ### ####### # # ### # ### ### ###
# # #   #   #       # #     #. . .  #. .#
# # # ### ### # ### # ################# #
#   # #   #   # #   #         #   #. . .#
# ##### ### ### ############# # # # ### #
# #     #   #             #   # # #.#   #
# # ##### # ##### ####### # ### ### # # #
# # #   # #     # #     # #     #. .# # #
# # # # # # ### # # ##### ####### ### ###
# # # #   # #   # #       #   #  . .#   #
# # # ####### ### ####### # ### # # ### #
#   # #       # #   #   # #     # #. .# #
### # ##### ### # # # ### ####### # # # #
#   #     #   # # # # #   #       # #.# #
##### # # # # # ### # # ### # ####### ###
#   # # # # # #     # # #   # #     #. .#
# ### ### # # ####### # # ### # ### # # #
# #   #   # #       #   # #   # #   # #.#
# ##### # # # # ### ##### # ### # ##### #
#       # # # #   # #     #   # # #. . .#
####### ### ##### ### ####### # # # ### #
#   # # #   #     #   # #   #   # #. .# #
### # # # # ##### # ### # ####### # # ###
#   #   # # #   # # #     #     # # #. .#
# ####### # # ### # ### ### ### ### # # #
#     #   # #     #   #     # #     # #.#
##### # ############# ### # # ##### # # #
#   # # #             #   # # #     # #. 
# ### # # ####### ######### # # ##### ###
#       #     #   # #       #   #   #   #
####### # # # # # # # ############# # # #
#     # # # # # # #   #     #     # # # #
# ##### # # # ### ####### # ### # # # # #
# #     # # #   #   #     #     # #   # #
# # ### # ##### ### ### ######### ##### #
#   #   #     #   #   # #               #
#########################################
