############################# ###########
#   #             #   #      . .        #
# # ##### # ##### # ### # ##### ####### #
# #   #   # #   # #     # #   #. . .  # #
# ### ### # ### # ####### # ### ### ### #
# # #     #     # #       #   # # #. .# #
# # ############# # ### ##### # # # # # #
# #           #   #   #       #   # #.# #
# ####### ### # ####### # ########### # #
# #       #. .#       # # #        . .# #
# ### ##### # ####### # # # ####### #####
# #   # #. .#. .#   # # # # # #. . .#. .#
# # ### # ##### # ### # ### # # ### # # #
# # #   #.#   #. .    #   # # #. .# #.#.#
### # ### # # ### ####### # # # # ### # #
#   # #  .# # #. .#     # # # # #. . .#.#
# ### ### # # # ### ### ### # # ####### #
# #   #. .# # #.# #   #   #   #       #.#
# # ### ### # # # ####### ############# #
#   #  .#   # #.#  . . .#     #  . . .#.#
####### ##### # ### ### ##### # # ### # #
 . . . .#   #. .#  .# #. . .#   #.#  . .#
######### # # ##### # ##### ##### ##### #
#         # #. . . .#      . . . .#   # #
# ######### ####### # ##### ##### # ### #
#   #     #         # #     #     # #   #
### ##### ############# ##### ##### # ###
# # #     # #           #     #     #   #
# # ##### # # ### # ##### # ### ####### #
# #   #   #   #   # #     # # #       # #
# ### # ######### # # ##### # # ##### # #
#   # # #         # # #     # # #   #   #
### # # # ######### # # # ### # # ### # #
# # # #   # #       # # #     # #   # # #
# # # # # # # ####### ######### ### ### #
#   # # # #   #     #         # #       #
# ####### ##### # # ######### # ####### #
# #     # # # # # # #       # # #   #   #
# # ### # # # ### # ### ### ### # ### # #
#   #     #       #     #       #     # #
#########################################
