################################### #####
# #       #      . . . .#. . .#  . .    #
# # ##### # ##### ##### # ### ### # ### #
#   # #   # #  . .#. . .#.# #. . .# #   #
### # # ### # # ### ##### # # ####### # #
#   #       # #.# #. . . .#   #       # #
# ####### ### # # ####### ##### ####### #
# #       #   #.#       # #     #       #
# # ####### ### ####### # # ##### #######
# # #     # #  . . .  #   #   #   #     #
# # ### # # ### ### # ####### ##### #####
# #   # #   #   #. .#       #     # #   #
##### # ##### ### # ####### ##### # # # #
#     # #   # #  .# #. .#   #   #   # # #
# ##### # ### # # ### # ##### ######### #
# #   # #   # # #. .#.#. . . .    #. .  #
# ### # ### # # ### # ####### ##### # ###
#   # #   #   # #. .#.#   # #. . . .#. . 
### # ### ####### # # ### # #############
# #   #   #    . .# #. .#  . .          #
# ##### ### ### # # ### ### # ######### #
#       #   #. .# #   #. . .#.#   #   # #
####### # ### ####### ####### # # ### # #
#   #   # # #. . . .#   #. . .# # #   # #
# ### ### # # ### # ##### ####### # ### #
# #   #   #   # # #. . . .  #       #   #
# # ### ####### ####### ##### ####### # #
# # #         #       #       #   # # # #
# # # # # # ######### ########### # # ###
#   # # # #                       # #   #
####### # # ####################### # # #
# #     # #         #     #       # # # #
# # ### # ######### # ### # ##### # # # #
# # #   #     #   #   # #   #   #   # # #
# # # ### ##### # ##### # ##### # ##### #
#   # #     #   #       # #     # #     #
##### # ##### ### ######### ####### # ###
# #   #     #   # #   #     #       #   #
# # # # ### ##### # # # ##### ######### #
#   # #   #         # #       #         #
#########################################
