############### #########################
#       #   #  . .      #   #           #
# ##### # # ### # ### # ### # # ##### ###
#     #   #     #.  # #     # #     #   #
################# ### ####### ### ##### #
#. . . . .# #    . .#       #   # #     #
# ####### # # ##### ##### ### ### # #####
#.#      .#   #. . .# #   #   #   # #   #
# ####### ##### ##### # ### ### ### # # #
#.#     #. .#  .#     #   # # #   # # # #
# # ### ### ### # ##### # # # ####### # #
#.#   #    . . .#     # # #   #   #   # #
# ### ######### ##### ### ### # ### ### #
#. .# #. . . .#     #       #   #   #   #
# # ### ##### ############### ### #######
# #.#. .#. .#. . . .  #           #     #
# # # ### # ####### # # ########### ### #
# #.#. . .#.  #   #.# #. .          # # #
### ####### ### ### ### # ##### ##### # #
#. .  # #. .#   #. .#. .#.  # #       # #
# ### # # ### ### ### ### ### ######### #
#. .#   #.#   #  . . .#. .#   #         #
# # ##### # ######### # # # ######### # #
# #.#. . .  #  . . .# #.# #           # #
# # # ######### ### # # # ####### ##### #
# #. .  #. . . .# #.# #.# #       #   # #
# ####### ####### # # # # # ####### # # #
# #   #. .#. . .# #.# #.# # #       # # #
# # # # ### ### # # # # # # ### ####### #
#   # #. .#.  #.# #.# #.# #   # #   #   #
##### # # # ### # # # # # ### # # # # ###
#   # # #. .#. .# #.# #.#   # #   #   # #
# # # # ### # ### # ### # ### ######### #
# # # #   # #. .#  . . .#   #           #
# ### ### ### # ### # # ### #############
#       #   # #. .# # #   #             #
##### ##### ### # ### ### ######### ### #
#   # #   #   # #. .# # #     #   # # # #
# # ### # ### # ### # # ####### # # # # #
# #     #     #   #.#   #       #   #   #
################### #####################
