##### ###################################
#    .          # #                     #
# ### ### ##### # # # ########### ##### #
# #. .  # #   # # # #     #     #     # #
### # ### # # # # # ####### # ####### ###
#. .# #   # #   # #         #       #   #
# ### # ######### # ############### ### #
#. .# #         #               #   # # #
# # # ### ##### # ############# ##### # #
# #.#   # #   #               #       # #
### ### # # ########### ######### ##### #
#. .  # #   #         #         #     # #
# ### # ##### ##### # ##### # # ##### # #
#.# # #           # # #   # # #     # # #
# # # ############# # ### # # ####### ###
#.#   # #. . .#   # #     # #       #   #
# ##### # ### # # # ############### ### #
#. . .#. .  #.# #   #             #   # #
# # # # ##### # # # ############# # ### #
# # #. .#. .#.# # #             # # #   #
# ####### # # ######### ##### ### # # ###
#   #   #.#. .    #   # #   #     # #   #
### # ### # # ### # # ### ######### ### #
# #   #. .# #   # # #   #   #   #     # #
# ##### # # # ### # ### ### # # ### # ###
# #    .# # #   # #   #   #   #     #   #
# # ### ### ### # ####### ########### # #
#   # #. .#   # #       # #         # # #
##### # # ### # ##### # # # ####### # # #
#   #   #. .# # #     # # # #   # # # # #
### ##### # # # ####### # ### # # # # # #
 . . .#   #.# #       # #   # # #   # # #
##### ##### # ### ### # ### ### # ### # #
#   #. . . .# #   # # #   #   #   #   # #
# # ##### ### # # # # ####### # #########
# #       #   # #   #     # # #         #
# ######### ### ######### # # ######### #
#   #     # #         #   #           # #
# # ##### # ######### ####### ######### #
# #       #         #                   #
#########################################
