####################################### #
#  . . .#    . .#    . .#         #    .#
# # ### ##### # # ### # # ####### # ### #
# #. .#. . . .#.# #. .#.# #     #   #  .#
# ### ### ##### ### ### # # ########### #
#   #.#   #. .#.#. .#  .#   #. . .#. . .#
##### # ### # # # ##### ##### ### # # # #
#  . .# # #.#.#. .#    . . . .#  . .# # #
# # ### # # # ############### # ##### # #
# #.#   # #.#.#   #           #   #   # #
# # ##### # # ### # ############### ### #
# #. . . . .#. .#   # #     #       #   #
# ##### ##### # ##### # ##### # ####### #
# #   #     # #.#     #       # #       #
# # # ##### # # # ############# ### ### #
#   #     # # #.# #             #   # # #
####### # # # # # ##### ######### # # # #
# #     # # # #.#       #     #   # #   #
# # # ### # # # ####### # ### # # # ### #
# # # #   # # #.    #   # #   # # # #   #
# # ### ### # # ### ##### ##### # # #####
#   #   #   # #.  #       #     # #     #
##### ##### # # # ######### ######### # #
# #   #     # #.# #         #       # # #
# # ##### ##### # ####### ### ##### # # #
#   #     #. . .# #   #     #     # # # #
# ##### ### # # # # # # # # ##### ### # #
# #     #. .# # # # # # # #     #   # # #
### # ### ##### # ### # # # ####### ### #
#   # #  . . .# #     # # # #     #     #
# ### ### # # ########### ### ### ### # #
# #   #   # #. .        #   # #   #   # #
### # # # # # # ####### ### ### ### ### #
#   # # # # # #.      #   #       #   # #
# ##### ### # # ######### ##### ####### #
# #   #   # # #. . . .# #     #     #   #
# ### # # # ######### # # ### ##### # ###
#   # # # #     #   #.# #   #     # # # #
# ### ### ##### # # # # ### ##### # # # #
#   #         #   # #.#     #     # #   #
##################### ###################
