####################### #################
# #   #                .  #. .      #. .#
# # # ############# # # ### # ####### # #
#   #   #   #       # #. . .#. .#. . .#.#
####### # # # ### ### ### ##### # ##### #
#     # # #   #   #     #     #. .  #. .#
# ### # # ##### ### # # ##### ####### # #
# # # # # # #   #   # #     # #     #.# #
# # # # # # # ########### # # ##### # ###
# #   # #   # #   #       # #     # #. .#
### ### ##### ### # ##### ####### # ### #
#   # # #   #   # # #   # #   # # #   #.#
# ### # # # ### # # ### # # # # # ### # #
# # #   # #   #   # #   # # #   #     #.#
# # # ### ### ##### # ### # ########### #
# #       #         #     #   #     #  .#
# ######### ### ############# # ### # # #
#           #   #   #      . .#   #   #.#
####### # ### ### # # ##### # ######### #
#   #   # #   #   #   #  . .#. . .#  . .#
# ### # # # ### ######### # ##### # # # #
# #   # # # #   #  . . . .# #. .#.# #.# #
# # ##### # # ##### ######### # # ### ###
#   #     # #     #. .#. . . .#.#. .#. .#
##### ##### ### # ### # ####### ### # # #
#     #       # # # #.#. .#   #.#  .# #.#
# ##### ##### # # # # ### # # # ### ### #
#     # #     # #   #. . .  # #. .#.#. .#
##### ### ##### # # # # ####### # # # # #
#     #   #   # # # # #       # #.#. .# #
# ##### # # ### # # # ####### # # ### # #
# #     # #     # # #     #   # #.#   # #
# # ########### # ####### ####### # ### #
# # #     #     #       #   #  . .# #   #
### # ### ################# ### # ### # #
#   # # #         #       # #. .# #   # #
# # # # ######### # ### # # # ### # #####
# # # # #         # #   #   #.# # # #   #
# # # # # ### ### ### ####### # # # ### #
# # #   # #   #       #      .#   #     #
############################# ###########
