##### ###################################
#    .    #         #. . .      #       #
# ### ### # ####### # ### ### ### ##### #
# #  . .# # # #. .# #.  #. .#   # #     #
# ### # # # # # # ### ##### ### # #######
#   # #.#   #. .#. .#.#   #.  # # #. . .#
### # # ##### ### # # # # # # # # # ### #
#   # #. . . .  # #. .  # #.# # #. .  #.#
# ### ##### ### ### ####### ### # ##### #
# #   #   #   #   # #     #. .# #.#. . .#
# ##### # ### ### ### ### # # ### # #####
#       #   #   #     # # # #. . .#. . . 
# # ##### ##### ####### # # ##### #######
# #     #     #         # # #   #       #
# ##### # # # ##### ##### ### # ####### #
#     # # # # #   #     #     #       # #
# # # # ### # # ### # ############# # # #
# # # # #   # # #   #       #   #   # # #
# # # # # ##### ####### ### # # ##### # #
# # # # # #   #       #   #   # #     # #
# # # # ### # # ##### # # ### # ####### #
# # # #   # # # #       #   # #   #     #
# # ####### # # # ##### # # # ### # ### #
# #   #     # # # #     # # # #   #   # #
# # # ####### ### ### ##### ### ### # # #
# # #         #   #   #     #   #   # # #
# # # ######### ### ### # ### ### ### ###
# # # #       # #   #   #   # #   #     #
# # ### ####### # # # ##### # ######### #
# #     #       # # # #   # #         # #
# ########### ##### # # # # ########### #
#   #         #     # # # #     #       #
# # # # ### ##### ##### # ### # ##### # #
# # # #   # #     #     # # # #   #   # #
### # ### # # # ### ####### ### # # ### #
#   # #   # # #     #     #   # # # #   #
# ##### ##### # ##### ### ### ### # # ###
# # #   #   # #     # # # #       # #   #
# # # ##### # ####### # # ############# #
#   #     #   #       #                 #
#########################################
