####################### #################
#           # #        . .    #       # #
# # ####### # # # ### # # ### ####### # #
# # #     # #   #   # # #. .# #       # #
# # ##### # ####### # # ### # # ####### #
# # #   #         # # # #. .# #   #   # #
# # # # ######### # ### # ### # ### # # #
# # # # #     #     #   #.#   # #   #   #
# # # ### ### ### ### ### ##### # #######
# # #     #       #   #  .#. .  #. . . .#
# ################# # # # # # ### ##### #
#     #     #     # # # #. .#.#. .  #. .#
# # # # ##### ### # # # # ### # ##### # #
# # # #     # #   # # # #   #. .    #.# #
# ### ##### # ##### # # ### # ##### # # #
#   #     # #       # #   # # #   # #.# #
### ##### # # ####### # # # ### # ### ###
# #     #   # #     # # # #   # #   #. .#
# ####### ### # ##### ### ### ##### # # #
# # #   #   # #       #     #   #   # #.#
# # # # ##### ######### # ##### # ##### #
# # # #     # #   #     # #   #   #  . .#
# # # ##### # # # # ### # ### ##### # # #
# #       # # # # # #   #   # #     #.# #
# ####### # # ### # # ####### # ##### ###
#       # # #   #   # # #     #   #  . .#
####### # ##### ##### # # ##### # ### # #
#     # # #     #     # # #     #   # #.#
# ### # # # ####### ### # ######### # # #
#   # #   # #       #   #           # #.#
##### # ### ##### ### ################# #
# #   # #       #   #     #          . .#
# # ### # ##### ### ##### # ######### # #
#   #   #     #   #     #   #  . . . .# #
# ### ########### ######### # # ####### #
# # # # #       #       #   # #.# #     #
# # # # # ##### ####### ##### # # # ### #
# #   # # #       # #   #   # #.# # # # #
# ### # ### ##### # ##### # # # # # # # #
#           #             #   #.#   #   #
############################### #########
