# #######################################
#. . . .            #                   #
# ##### ### ### ### ### ##### ##### ### #
# #. . .  # #     #       # #     # #   #
### ### # ### ### ##### # # # ### ### ###
#. .#   # #   # #     # # #   #   #   # #
# ### ### # # # # ### # # ######### ### #
#. .# #   # # # # #   # #         #     #
# # # # ### ### ### # # ### ### #########
# #.# # #     #     # #   #   #         #
### # # ### # ############# # ##### #####
#. .# #   # #           #   #     #     #
# ### ### # ### ##### ### ############# #
#. .#   # #   #     #   #             # #
# # ### # ######### ### ############# ###
# #.#   #   #         #     #       #   #
# # # ##### # ########### # # ######### #
# #.#   #   # #         # # #     #   # #
### ##### ##### ####### # # # # # ### # #
#. .#     #   # #         # # # #   #   #
# ### ##### ### ############# # #########
#. .#         #     #         #         #
### ############### # ######### #########
#. .#. . .      #   #         #   #     #
# # # ### ### # ##### ####### ### # ### #
#.# #.#. .  # # #     #   # #   #     # #
# ### # # ### # # ####### # # # ####### #
#. . .#.#   # #       # # # # # #   #   #
# ##### ### # ####### # # # # # # # # ###
#     #. .# #       #   # #   #   # #   #
######### # # ##### ##### ############# #
 . . . . .# # #     #                 # #
### ####### # # # ### ################# #
#   #   #   # # # #     #             # #
# ### ### ### # ### ##### ########### # #
#   #     #   #   # #         #   #   # #
### ####### # ### # # ######### # # ### #
# # # #     #   #   #     #     # # #   #
# # # # ##### # ##### ### ####### # # ###
#   #   #     #         #       #   #   #
#########################################
