########################### #############
#   #     #        . . . . .#. . . .#. .#
# ####### # ##### # # ####### ##### # # #
# #       # #     #.# #. . . .    #. .#.#
# # ####### # # ### ### ############### #
# # #       # # #  .#. .              #.#
# # ######### ### # # ################# #
#           # #   #. .#     #. . . . . .#
### ####### # # # # ### ### # ####### # #
#   #     #   # # #     # # #.#       # #
### # ### ### # ######### # # # ####### #
#   # # #     # #   #   #   #.# #. . .# #
# ### # # # ### # # # # ##### ### ### ###
# #   # # # #   # #   #   #  . . .# #. . 
# ### # ### # # # ##### # ### ##### # ###
#   # #   # # #   #   # #   #   #   #   #
### # ### ### # ##### # # # ### # ##### #
# # #   #     #     # # # #   #       # #
# # # ############# # # # # # ######### #
# # #             #   # # # #   #   #   #
# # # # ##### ##### ### # ####### # # # #
#   # #     # #   # #   #   #     #   # #
### # ##### # # # ### ####### ### ### # #
#   #   #   # # # #   #     # #   #   # #
# ##### # ### # ### ### ### # ##### ### #
#     # #   # #   # #   #     #     #   #
####### ##### ### # # ### # ### ##### # #
#     #     #   # # # #   # #   # #   # #
# # # ##### ### # # ### ### # # # # ### #
# # #     #   # #   #   #   # # # #   # #
### ##### ########### ### # # ### # # ###
#   #   #             #   # #     # #   #
# # # ##### ############### ####### ### #
# # #   #   #   #           #   # #   # #
# # ### # ### # # # ########### # ##### #
# #   # # #   # # #           # #     # #
##### # # ### # # # ######### # # ##### #
#     # # #   #   #       #   # #   #   #
# ##### ### ############### # # ### ### #
#     #     #               # #         #
#########################################
