# ##### #################################
#. .  #.#   #                       #   #
# # # # ### # ############### ##### ### #
# #.# #. . .# # #           #     #   # #
# # ####### # # # # ####### # ####### # #
# #. .  # #.# #   #       # #     # # # #
# ### # # # # # ##### ### # ##### # # # #
# #. .# #. .  #     #   # #     # # # # #
### ### # ######### ### # ####### # # # #
#. .#   #.# #     # # # # #       # # # #
# # # ### # # ##### # # # ##### # # # # #
#.# # # #. . .  #   # # #   #   # # # # #
# # # # ##### ### ### # ### # ### # # # #
#.# # # # #. .#     # # # # #   # #   # #
# # # # # # ### ##### # # # ##### ##### #
#.# # #. .#.#   #     #   #   # #       #
# ### # # # # ### ########### # #########
#. .# #.#.#. .  #           # # #     # #
# # # # # ### ### # ####### # # # ### # #
# #.# #.#. . .#   # #   #   # #   # # # #
### ### ##### # ### # # # # ####### # # #
#. .#. .#   # # # # # # # # #         # #
# # # ##### ### # # # ### ### ######### #
#.# #.#  . .#   # # #     #   #         #
# # # ### # # ### # ####### ### #########
#.# #.#. .#.# # # #       # #   #       #
# ### # ### # # # # ##### # # ### ##### #
#. .#. .#. .  #   #     #     #   #   # #
# # ##### ##### # ##### ####### ### # # #
# #.  #  .#     # #   #         #   # # #
# # # ### ####### # # # # ####### ### # #
# #.#   #. .#   # # # # #         #   # #
### ### ### ### # ### ################# #
#. .  #   #. .# #     #           #   # #
# ####### ### # ##### # ######### # # # #
#.#. . .#   #.#. .  # #         #   # # #
# # ### ### # # # ### # ############# # #
#. .# #.#   #. .#.#   # #     #     # # #
# ### # ######### # ### # ### ##### # # #
#     #. . . . . .          #     #   # #
#########################################
