##### ################### ###############
#    . . .              #.# #   #   #   #
####### # ############### # # ##### # # #
#. . .# #.#. . .    #. . .  #     # # # #
# ### ### # ### ##### ########### # # # #
#.#  . . .#.# #. . .#.  #     # #     # #
# # ####### # # ### # ### ### # ### #####
#.# #. . . .  #   #. .    # # # #   #   #
# ### ############# # ##### # # # ### # #
#. .#.#     #     # #     #   # # # # # #
# # # ##### # ### # ########### # # # # #
# #.#. .#. .# #   #         #       # # #
# # ### # # # # ########### # ####### # #
# #. .#. .#.# # #         #           # #
# ### ##### ### ######### ############# #
#   #. .  #.#   #       #   #         # #
# # # # ### # ### ##### # ### ### ##### #
# # # #. .#.  #   #   # # # # # # #     #
### # ### # ### ##### # # # # # # # #####
#   #   #.#.#   #   #   #   #   # #   # #
# # ##### # # ### # ####### ##### ### # #
# # #   #.#.  #   #     #     #     #   #
# ### # # # ### ### ##### ##### #########
# #   # #. .#     #             #     # #
# # ### # ### ######### ######### ### # #
#     # #     # #     #   #     # # # # #
# # # # ####### # ### ##### ### # # # # #
# # # #       # # # # #       # # # # # #
# # # ### ### # # # # # ######### # # # #
# # #   #   #   #   #             # #   #
# ##### ### ##### ##### ########### #####
#     # # #           #       #     #   #
# ### # # ########### ############# ### #
#   # # #   #     # #   #         #   # #
##### # ### # ### # # ### ### ####### # #
#     #   # # # # # # #     #           #
# ######### # # # # # # #################
# #         # #   # #   #         #     #
# # ########### ### # ### ####### ##### #
#                   #           #       #
#########################################
