################# #######################
#   #       #    .    #. . . .    #     #
# # # ##### ### # ##### ### # ### # ### #
# # #     # #   #. . . .  # #. .# #   # #
# ####### ### ######### # ##### # ##### #
#    . .#     #  . . .# #   #. .#       #
##### # ######### ### ##### # # ##### # #
 . . .#. . .#  . .#  . .# # #.#     # # #
########### ### ####### # # # ##### # ###
#       # #.#. .#     #.# # #. .  # #   #
# ####### # # ### ##### # # # # ### ### #
# #     #. .#. .#     #.#   # #.#   # # #
# ### # # ### # ##### # ####### # ### # #
# #   # #. .# #.    # #.#  . . .#   #   #
# # ### ### ### ##### # ### # # # # #####
# # #      . . .#   # #. . .# # # #     #
# # ##### # ##### # # # ##### # ##### # #
# #   #   # #     # #   #     # #   # # #
# ### # ### # ##### ##### ##### # # ### #
#     # #   # #   # #     #     # # #   #
# ##### # ### # # # ### ### ### ### # ###
# #   # # #   # # #     #   #   #   # # #
### # ### ### # # ####### # ##### ### # #
#   # #   #   # #         # #     #   # #
# ##### ### ### ########### # ### # # # #
# #     #   #   #         #     # # #   #
# # # ### # # ### ### ### ##### ### # # #
#   # #   # #   # #   #       # #   # # #
##### # ### # # # # ### ##### # # ### # #
#   # # #   # # # # #   #   # # # #   # #
# # # # # # ### ### ##### # # ### # # # #
# #   # # #   # #   # # # # #     # # # #
# ##### # ### # # ### # # # ### ### # # #
# # #   #   # # # #   # # # #   #   # # #
# # # ####### # # # ### # ### ### # # # #
#   #   #     # # #     #     #   # # # #
####### # ##### ####### ####### ##### # #
#     # #     #   #         #   #   # # #
# ### ####### ############# ### # # ### #
#   #         #                 # #     #
#########################################
