############################# ###########
#     #              . . . .#.    #     #
# ### ### ########### ##### # # # # ### #
# #     # #    . . .#.#    . .# # #   # #
# ##### # # ### ### # ######### ####### #
# #   #   #   #.# #. .#         #       #
# # # ####### # # ### # ######### #######
# # #       # #.#     # # #. . . .      #
# # ####### # # ####### # # ##### ### # #
# #   #. . .# #. . .#   #. .#   #.  # # #
# ### # ### # ##### # ### ### # # ### # #
#   # #. .#.#     #.#   #.#   # #.#   # #
# # # ### # ####### ##### # ##### # ### #
# # #   #.#. . . .#. . . .  #   #.#   # #
# # ##### ####### # ######### # # ### ###
# # #  . .#     #.#           # #.  #   #
# ### # ### ##### ############### ##### #
# #   #. .#      . . . .#. . .#. .#     #
# # # # # ############# # ### # # # ### #
# # # # #. . . . . .#. .#.# #.#.# # # # #
### # # ####### # # # ### # # # ### # # #
#   # #       # # #.#.#  .# #.#.#   #   #
# # ##### ### # ### # ### # # # # # ### #
# # #   #   # # #. .#. . .# #.#.# #   # #
# # # # ##### ### ##### # # # # # ### # #
# # # #       #. .#   # # # #. .#   # # #
# # # ##### ### ##### ### # # # # # # ###
# # # #   # #  . . .#     #   # # # #   #
# # # ### # # # ### ########### # # ### #
# # #     # # # #. .  #   # #   # #   # #
# # ######### ### # # # # # # ### # ### #
# # # #   #   #. .# #   # # #   # # #   #
# # # # ### ### ### ### # # # # ##### # #
# #   # # # #  . .#   # #   # #   #   # #
# ##### # # # # # ### ########### ##### #
#     # # # # # #.  #   #   #   #     # #
# ##### # # # # # ##### ### # ##### # ###
#       # # # # #. .  #   # #     # #   #
# ####### # # # ### # ### # ##### # ### #
#       #   # #   #.#   #   #       #   #
################### #####################
