######### ###############################
#  . . .#. .                      #   # #
### ### ### # ############# ### # # # # #
#. .#  . .#.#           #     # # # #   #
# ####### # ######### ### # # ### ##### #
#.#   # #.#. . . .#   #   # #   #     # #
# ### # # # ##### ##### ### ### ##### # #
#. .# #. .#     #. .  #   #   #     # # #
# # # # ########### # ### ######### # # #
# #.#  . . . . . .#.#   #       #   #   #
# # ### ######### # # ####### # #########
# #.#   #        . .#       # #         #
# # # ### ######### ### ### ####### #####
# #.# #     #   # # #     # #     # #   #
### # ####### ### # # # # # # ### # ### #
#. .#   #     # #   # # # #   # # #     #
# ##### ### ### ##### # ####### # #######
#. .  #   # #     #   #   #     #   #   #
# # # # # # # ### # # # # # ##### # ### #
# #.# # # #   #     # # # # #     #     #
# # # ### ### # ### # # # # ### # #######
# #.# #   #   #   # # # #   #   #       #
### # # # ######### # ####### # ####### #
 . .# # # #       # #   #     # #     # #
##### # # # # ### ### # # ### # ##### # #
# #   # # # # # #   # # # #   #     # # #
# # ### # # ### ### ### # # # ### ### # #
#   #   # #     #     # # # #   #     # #
##### ############### # # # ### ####### #
#                 # #   # #   #   #     #
# ### ##### ##### # ##### ### # # # #####
# #       #     # #     #   # # # #     #
# ####### # ### # ##### ### # # # ##### #
# #   # # #   # #     #     # # # #   # #
# # # # # ### # ### # ####### # # # # # #
#   #   # # # #   # # #       # #   # # #
######### # # ### ### # ############### #
#       # # #   # #   # #             # #
# # ### # # ### # # ##### ############# #
# #   #   #     # #           #         #
#########################################
