############################# ###########
#         #             #    .      #   #
# ### ### # ########### # ### # ### ### #
# # #   #   #   #. . .# #   #.#   #     #
# # # # ##### ### ### # ### # ### #######
#   # #       #  .#  . . .# #.  #   #   #
############### # ####### ### # # # # # #
#   #   #     # #. .#    . . .# # #   # #
# # # ### ### # ### ############# ##### #
# # # #   #   #   #. . . .#       #     #
# # # # ######### ##### # ######### #####
# #   # #       #     # #. . .  #   #   #
# ##### ### ### # ### # # ### # ##### # #
#     #     # # #   # # #   #.#       # #
##### ####### # ##### # ### # ######### #
#  . .#    . . .#     #   # #.  #     # #
### # ##### ### # ####### # # # # ### # #
 . .#. .#. .# #.# #       # #.# #   # # #
####### # ### # # ########### # ### ### #
#     #. .#   #.# #. .#  . . .# # # #   #
# ####### # ### ### # ### ### # # # ### #
#     #   #  . .#. .#. .#.#   # #       #
##### ####### ### ##### # ##### ####### #
#   #        . .#. .# #.#. . .#       # #
### ########### # # # # # ### ####### ###
#   #         #.# #.# #.#   #.  #   #   #
# # ####### # # ### # # ### # # # # ### #
# #     #   # #. . .#  . .# #.# # #   # #
# ##### # ### ##### ##### ### # # ### # #
# #       # #       #    . . .# #   #   #
# ######### ######### ####### # # # ### #
#     #               #       # # # #   #
# ######### # ######### ####### #########
# #         # #         #               #
### ### ##### # ####### ############# ###
#   # #   #   # #             #     #   #
# ### # # ##### ############# # ####### #
#   #   #     #     #   #   # # #     # #
### ######### ##### # # ### # # # ##### #
#   #             #   #     #   #       #
#########################################
