################################### #####
#   #         #          . . . . . .    #
# # ### ####### # # ##### ### ######### #
# #             # # #    .#   #       # #
# ### # ########### # ### ##### ##### # #
#   # # #       #   # #  . . .#     #   #
# # ### # ####### ### ##### # ###########
# #   # #         #       # #. . . . . .#
# ### # ############# ### # ########### #
#   # #     #       #   # # #. . .#. . .#
##### ##### # ##### ### # # # ### # ### #
#         # #   # #   # # # #.#  . .#   #
# # # ### # ### # ### ### # # ###########
# # #   # # #   # #   #   # #. . . . .  #
# # ### ### # ### ##### # # ######### # #
# # #   # #   #       # # #     #. .#.# #
# # ##### ##### ##### # # ##### # # # ###
# #     # #     #       #   #   #.#.#. .#
# # ### # # ### # ### # ##### ### # # # #
# #   #   # #   # # # # #     #. .#.# #.#
# ### ##### # # # # ### # ##### ### # # #
#   #   #   # # # #   # # #  . .#. .# #.#
# ####### ##### # ### # # ### ### ### # #
# #       #     # # # # # #. .#. .#   #.#
# # # ########### # # ### # ### ####### #
# # # #     # #   # #     #. .#. . . . .#
# # # # ### # # ### ### ### # ######### #
# # #   # # # # #   #   #   #. . .#   # #
# ####### # # # # ####### # # # # # # # #
#         # # #   #       # # # #.# #   #
########### # ####### ### # # # # #######
#           #         #   # # # #. .    #
####### ########### # ##### # ### # #####
#   #   #           # #     #   # #. . . 
# # ##### ##### ##### # ####### #########
# #       #     #     # #     #   #     #
############### # ##### # ### # # ##### #
# #             # #   # # #   # #     # #
# ####### ##### # # # # ### ### # ### # #
#         #     #   # #     #   #   #   #
#########################################
