##################### ########### #######
#                   #.#        . .  #   #
# ################### # ####### # ### # #
#       #   #     #. .# #. . .#.#     # #
# ##### ### # ##### ##### ### # #########
# #   # #   #. . .#.#. . .# #.#. . . . .#
### # # # ### ### # # ##### # ### # ### #
#   # # # #. .  #.#.#.#     #. .# #   #.#
# ##### # # ##### # # # ####### # ### # #
#     # #. .#   #. .#.#. .    #.#   # #.#
##### # # ### # ##### # # ##### ### # # #
#      . .#   #  . . .#.#. . . .#   # #.#
# ##### ######### ##### ######### ### # #
# #    . . . . . .# #. .#  . .#   #   #.#
# # ############# # # ### # # ######### #
# # # #   #   #   # #. .# #.#. .#. . .#.#
### # ### # # # ### ### ### ### # ### # #
#   # #   # # #   #    . . .#. .#.#  . .#
# ### # ### # ############### ### # # # #
#   # #     #     #          .#. .# # # #
### # ####### ### # ######### # ##### # #
#   #         #     #        . .#   # # #
# ############# ####### ####### # # ### #
#       #     #   #   # #   #   # #     #
# ### # ##### ### # # # # # # ### #######
#   # # #       # # # # # #   # #       #
# # # # # ##### # # ### # ### # # # ### #
# # # # #   # # # #   # # #   #   #   # #
### # # ### # # ##### # # # ########### #
#   # # # # # #   # # # # # #           #
# ### ### # # ### # # # # # # ##### # # #
#   # #   # # # #     # # # #   #   # # #
### # # ### # # ### # ### ##### # ### # #
# # #     # # # #   #     #   # # #   # #
# # # ##### # # ### ##### # ### # # ### #
# # # #     #       #     #   # # # #   #
# # # # ############# ####### # # # ### #
# # # #   # #   #     #   # #   # # #   #
# # ##### # ### ####### # # ######### # #
#   #     #             #             # #
#########################################
