######### ###############################
#     #  .  #. . . .#. . .    #         #
# ##### # ### ### # # ### # ### #########
# #     #. . .  # #. .  #.#   # #. .#. .#
# # # # # ##### ##### # # ### # # # # # #
# # # # #     #     # # #.#   #. .#. .#.#
# ### # ##### ##### # ### ##### ####### #
#     #     #     # #   #. .  #. .  #. .#
##### ####### ##### ### ### ##### ### # #
#     #       #       #   #. .  #.#. .# #
# ##### ### ### ### # ### # # ### # ### #
# #     #   #   #   #   # # #. . .#.#   #
### # ####### # ######### ######### # # #
# # # #       # #   #     #. . . .#.# # #
# # # # ### ##### # ### ### ##### # # ###
# # # # #   #     # #   #. .#    . .#   #
# # # # # ### ##### # ### ### ####### # #
# # # # # #   #   #   #. .#   #     # # #
# # # # ### ##### ##### # ##### ### ### #
# # # #   # #. . . . .#.# #     #   #   #
# # ##### ### # ##### # # # # ##### # # #
#   #     #. .# #   #.#.# # # #       # #
# ######### ##### # # # # # ### # # ### #
# #        .#     # #. .# #   # # # #   #
# # ####### # ######### # # ### ### # ###
# # #   #. .# #         # #   # #   # # #
# # # ### ### ### ####### ### # # ### # #
# # #   #.#   #   #         # # #   # # #
# # ### # # ### ### # ####### # ##### # #
# #     #.#     #   # #       # #     # #
# ####### ####### ### ######### # # ### #
# #      .      # #   #         # #     #
### ##### ##### # # ### #################
#   #. . .  #   # #   # #               #
# ### ##### # # # ### # ############### #
#   #.#   # # # #   # # #         #     #
### # # ### # ####### # # ##### ### #####
# # #.# #   # #   #   #   #   #   # #   #
# # # # # ### # # # ####### ####### ### #
#   #.#   #     # #                     #
##### ###################################
