### #####################################
#  .                  #                 #
# # ##### ####### ### # ######### ### ###
# #.    #       #   #       #   #   #   #
# # ### ######### # # # ### ### ### ### #
# #.  # #       # # # #   #   #   # #   #
### # # # ##### # # # ####### ### ### # #
#. .# # #     #   # # #     #     #   # #
# # ### # ### ##### ### ### ####### # # #
#.# #   #   #     #     # #   #     # # #
# ### ################### # ### # ### # #
#. .#                   # # #   # #   # #
# # ############### ### # # # ##### ### #
# #.      #. . .  #   # #   # #     # # #
# # ####### ### # ### # ####### ##### # #
# #. . . .#.# #.# #   # #     # #   # # #
# ####### # # # ### # # ##### # ### # # #
#       #. .# #.#   # #     #   #   # # #
########### # # # # ####### ##### ### # #
#. . . . .#   #.# # #     #       #   # #
# ####### ##### ##### ### # ####### ### #
#.#     #.#    .      #   #   #     #   #
# ##### # ##### ### ### # # # # ##### ###
#. . .# #. .#  .  #   # # # # # #     # #
# ### # ### ### # ##### # ### # # ##### #
# # #.#   #. . .#   #   #   #   #       #
# # # ### ##### ### # # ### # ###########
#   #. .#       #   # #   # # #       # #
####### ######### ### ##### ### ##### # #
 . . . .      #   #   #     #   #     # #
### ### ##### # ##### # ##### ######### #
#   #   #     #     # # #   # #         #
##### ############# # # ### # # ##### # #
#     #             # #     # # #   # # #
# ##### ############# ####### # # # ### #
# #   #   #               #   # # # #   #
# ### ### ####### # # ### # ### ### # # #
# #   #   #   #   # #   #   #   #   # # #
# # ####### # # ### ### ##### ### ### ###
#   #       #   #     #           #     #
#########################################
