########################### # ###########
# #       #         #  . . .#.# #   #   #
# # ########### ### # # # # # # # # ### #
#   #           #     #.# # #.#   #   # #
# ##### ####### ####### ### # ####### # #
#       #     # #  . . .#   #. .  #   # #
# ### ### ### ### # # ### ##### ### ### #
# #   #   # #   # #.# #   #   #.#   # # #
### ### ### ### # # # # # # ### # ### # #
#   # # #   #     #.# # # #  . .# #     #
# # # # # ######### # # ##### ### # #####
# # # # # #      . .# #     #. .# #     #
# ### # # # ##### # # ##### ### # ##### #
#   # #   #   # #.# # #   # #  . .#   # #
### # # ### # # # # # # ### ##### ### # #
# #   #   # #   #.# # #   # #   #. .# # #
# ####### # ##### # # ### # # ##### # # #
#       # #   #  .# # #   # # #   #.# # #
####### # ##### # # # # ### # # ### # # #
#     #   #     #.# #   #   # # #. .# # #
##### ##### ##### # ##### ### # # ### # #
#       #   #    .#   # #     #. .    # #
# ##### # # ##### ### # ####### ####### #
#   # # # #   #  .  #   #     #.#       #
# # # # # ### # # # ##### ##### # #######
# # # # #   # # #.# #. . . .#. .  # #   #
# # # # ##### # # ### ##### # ##### # # #
# # # #       # #.#. .    #. .      # # #
# ### ##### ### # # ##### ######### # # #
# #   #     #   #. .    #     #     # # #
# # ### ##### ##### # ##### # ######### #
# #     # #   #   # #     # # #         #
# ### ### # # # # ##### # ### ######### #
# #   #   # # # # #   # # #       #     #
# ##### ### # # ### # # ### ####### #####
#       #   # # # # # #   #         #   #
######### ### # # # ### # ########### # #
#         #   #   #   # #         #   # #
# ####### ##### ##### ####### ### # ### #
#       #           #           #   #   #
#########################################
