####################################### #
#. . . . .#      . .#      . . . .#  . .#
# ####### ####### # ####### ##### ### # #
#. . .#  . . . . .#. . . . .#    . . .# #
# ### ##### ####### ####### # ##### #####
# # #.#     #. .#   #. . .# # #. .# #. . 
# # # # ##### # # ### ### ### # # ### ###
#   #.# #. . .#.# #. .# #. .# #.#. . .# #
##### # # ##### # # ### ### ### ####### #
#. . .# #.#   #.# #.#. .# #.#. .        #
# ##### # # # # # # # # # # # ###########
#. .#   #.# # #.# #. .#. .#. .          #
# # # ### ### # ######### ############# #
# #.#   #. . .#. . .    #.          #   #
# # ######### ##### ##### ####### ### ###
# #. . .    #.#   #. . .#.#     #   #   #
# # ### ##### # # ### # # # # ##### ### #
# #   #. . . .  #   # #. .# #   # #   # #
# ##### ########### ### ### ### # # ### #
#     #   # #     #   #   #   # # #   # #
##### ### # # # ##### ##### ### # ### # #
#       # #   # #   #         # #     # #
# ####### ##### # ####### ### # ####### #
# #     #   #     #     # #   #     #   #
# # ### ### # ##### ### # ##### # # # # #
# #   #   # #   #   # # #   #   # # # # #
# # ### # # # ### ### # ### # ##### # # #
#     # # #     # #   #   # # # #   # # #
# ### # ####### # # ##### # ### # ### # #
#   # #       # #   #   # # #   #   # # #
### ##### ### # # ### # # ### ##### # ###
# #     #   # #   #   # #       #   #   #
# ### # ##### ##### ############# ##### #
#   # # #         #     # #   #   #     #
### ### # ####### # ### # # # # ##### # #
#     # # #   #   # # # # # #   #     # #
##### # # ### # ### # # # # ########### #
#   #   #   #   #     # # # #           #
# ### # ### ##### ####### # #############
#     #   #               #             #
#########################################
