##################### ########### #######
#   #             #  .# #  . . . .      #
# # # ##### ##### ### # # # ### # ##### #
# #   #     #   #   #.#   #. .# #   #   #
####### ### # # ### # ####### # ### #####
#       #   # # # # #.#. . .#.#   #     #
# ### ####### # # # # # ### # ######### #
# #   #       #   #  . .# #.#. . . . .# #
# # ### ############# ### # # # ### # # #
# #   # #     #     # # #. .# #   # #.# #
# ### # ##### # ### ### # ### ### ### # #
#   # #     # #   #     #. .#   #   #.# #
# # ####### # ### ######### ### ### # # #
# #   #             #     #.# #   # #.# #
##### ##### ######### ##### # ### # # ###
#   # #   #   #     #. . . .#     # #. .#
# # ### # ### ##### # ############# # # #
# # #   #   #     #  . .#  . . .#   # #.#
# ### ##### ##### ##### ### ### ##### # #
#     #         #      . .#.# #. .#   #.#
# ############# ######### # # ### # ### #
# #                   #  . .# # #.# #. .#
# # ######### # ##### ### # # # # ### # #
# # #   #     # #         # # #  . . .# #
# # # # ##### ### ######### # ######### #
# # # # # #     # #     #   #   #     # #
# # # # # # # # ### ### ### ### # ### # #
# # # #   # # # #   # #   # #     #     #
### # ####### # # ### ##### # # ### ### #
#   #       # #     #       # # #   #   #
# # # ##### ### ########### # # # ### # #
# # # #   #   #   #         # # # # # # #
# ### # # ### ### # # ### ##### # # # # #
# # # # # #     # # #   # #     #   # # #
# # ### # ##### ### # # # # ######### ###
# #   # #   #       # # # #         #   #
# ### # ### ##### ### # # ############# #
#   # # # #   #   #   # #   #         # #
# ### # # ### ##### ### ##### ######### #
#     #   #         #         #         #
#########################################
