####### ####################### #########
# #    . .    #. . .          #.#     # #
# # ### # ##### ### ########### # ### # #
#   #   #. . .#.# #. . .  #. . .# #   # #
####### # # # # # ##### ### ##### # ### #
#       # # #.#. .#   #. .#.#     #     #
### ### # ### ### # ##### # # ###########
#   #   #   #. . .# #. . .#.#     #     #
# ### ##### # # ### # ### # ##### # ### #
#   # #   # # #     #. .# #. . .# # # # #
# # # # ### # ####### # ####### # # # # #
# # # # #   #       # #. .    #. .# #   #
# # # # # ######### ##### ####### # # ###
# # # # # # #. . .# #   #.#. . .#.# # # #
# # # # # # # ### # # ### # ### # ### # #
# # # # #   #.# #.#   #. .#.# #. .  #   #
# # ### ##### # # ##### # # # ######### #
# #   #. . . .#  . . . .# #. .  #   #   #
# ### # ######### ####### ### ### # # ###
#   # #. .#       #. . .#   #.#   #     #
##### # # ######### ### ##### # #########
#     # #. . .    #.# #. .#. .  #       #
### # # ### # ##### # ### # ########### #
#   # #   # #. . .#. .  #. .          # #
# ####### ### ### ### ########### ### # #
# #     #   #   #. . .#         #   # # #
# ##### # # ### ### ### ####### ### # # #
#   #   # #   #   #   # #   #   # # #   #
# # # ### ### ### ### # ### # # # # #####
# # #   #   #   #   #       # #   #     #
# # ### ####### # # ######### ####### ###
# # #           # #   #   #     #   #   #
### ####### ##### ### ### # ##### ##### #
# #       # #       #   # #       #   # #
# ####### ### ### # # # # # ### ### ### #
#   # #   #   #   # # #   # # #     #   #
### # # ### ### ### ####### # ####### # #
# # #   #   # # #   #   #   #       # # #
# # ####### # # # ### # ########### # # #
#           #   #     #           #   # #
#########################################
