######################### ###############
#              . . . .#. .          #   #
### # ##### ### ##### # # ######### # # #
#   # #     #  .#    . .#         #   # #
# ### # ### # # # ##### # ############# #
# #   #   # # #.# #. .# #         #   # #
# # ####### ### # # # ########### # ### #
# # #       #. .# #.#. . .      # #     #
# # # ### ### # ### ##### ##### # #######
# # #   #   #.# #. .#   #. . .# #   #   #
# # ####### # ### ### # ##### # # # # ###
# #   # #   #. . .  # #   #. .# # # #   #
##### # # # # ### # ##### # # ### ### # #
#     # # # #   # #     # #.# # #     # #
# # ### # ##### # ### ### # ### ####### #
# # #   #     # # # #     #. .#         #
# ### ##### # # # # ####### # ###########
#     #     # # # #       # #. .        #
####### ### # # ### ##### ##### ####### #
#       #   # #         #   #. .      # #
# ### ### ### ############# # ####### # #
# #   #   # # #     #       #.#     # # #
# # ### ### # # ##### ####### # ### ### #
# # #   #   # # #     #      .# #       #
# # # ### ### # ### ### ##### # ### # # #
# # #   # #   #   # #   #. . .#   # # # #
# ##### # # ##### # # ### ### # # ### # #
#     #   # #     # # #  .# # # #   # # #
########### # ####### ### # # # ### ### #
# #   # # #   #       #. .# # # #   #   #
# ### # # ##### ### ### # # # ### # # ###
#     #       # #   #. .# #   #   # # # #
# ########### ### ### ### # # ##### # # #
# # #     #     # #  .#   # # #     #   #
# # # ### ##### # # # # ##### # ####### #
#   #   #   #   # # #.# #   # #       # #
### ### ### ### # # # # # # ######### ###
# #   #   #       # #.# # #   #     #   #
# ### ############# # # ##### # ####### #
#                   #.#       #         #
##################### ###################
