##### ###################################
#  . .  #. .            #           #   #
# # ##### # ########### ########### # # #
# #. . . .#.#. . .    #           # # # #
# # # ##### # ### ### ### ######### # # #
# # #     #. .# #. .# # #           # # #
# # ########### # # # # # ####### ### ###
# # #           # #.#   #       #   #   #
# # # ############# ########### ####### #
# # # #    . .#. . .    #     #       # #
# ### # ### # # # # ##### # ######### # #
#     # #. .#. .# # #     #     #   #   #
# ##### # # ### ### # ####### ### #######
# #   # #.# #   #   # #     # #   #     #
# # ### # # # ### ### # ### # # ### ### #
# # #   #.# # #       # #   #       # # #
# # # ### ### ####### # ##### ####### # #
# # # #  . .#   #   # #     #         # #
# # # ### # ### # # ####### ######### # #
#   #   # #. .# # #   # #   #     #   # #
##### # ### # # ##### # # ####### # #####
#   # #   # #.#     #   # #   # # #     #
# # # # # # # ### ### ### # # # # # ### #
# # # # # # #.  #     #   # # # # #   # #
# ### ### # # ######### ##### # # ##### #
# #   #   # #.#. . .      #     #       #
# # ### ### # # ### ####### #############
#   # #   # #. .  #. .      #           #
# ### # # # # ### ### ####### ##### ### #
# #   # # # #   #   #. . .      #     # #
# # ### # # ### ##### ### ### ### # ### #
# # #   # #   #     # #. .  # #   # #   #
### # ### ### ##### # # ### ### ##### ###
#   #   #   #     # # #.# #   #   #   # #
# ### # # ##### # # # # # ### # # # ### #
#   # # # #   # # # # #.# #   # # # #   #
### ### # # # # ### ### # # ### # # ### #
# #     # # # #   #   #.# # # # # #   # #
# ######### # ### ### # # # # # # ##### #
#           #     #   #.#   #   #       #
####################### #################
