################# #######################
#              . .      #   # #   #     #
# ### # ####### # ##### ### # # # # ### #
# #   # #    . .#   #   #   #   # #   # #
### # ### ### # # ### ### ####### ##### #
#   # #   #  .# #   #       #           #
# ### # ### # # ### ######### ###########
# #   #   # #.#   #           #         #
# ####### # # ####### ### ##### ### #####
# #       # #. . .  #   #         #     #
# # ######### ### # ##### ############# #
# #   #     # #. .#     #     #     #   #
# ### ##### # # # ##### ### # ##### # ###
#   #   #   # #.# #   #   # #     #   # #
# ### ### ### # ### # # # ### # ####### #
#   #     #   #.#   # # #   # #         #
# # ########### ##### # ### # ### # #####
# #     #  . . .  #   #   # #   # #   # #
# ##### ### ##### # ####### ### # # ### #
#     #   #. . .# #         #   # #     #
######### # ### # ############### ### ###
#       # #   #.#     #         #   #   #
# ##### ####### ##### # ####### ### ### #
# # #   #  . . .    #     #   #   #   # #
# # # ### # # # ##### ####### # # ### # #
#   # #   #.# #     # #     # # # #   # #
### ### ### ####### # # ### # ### # #####
# #     #  . . .# # #   #   #     #     #
# ####### ### # # # ################### #
#   #   #   # #.#       #           # # #
### ### ### ### ######### ######### # # #
#      . .#   #. .    #   # #         # #
####### # ### # # ### ##### # ######### #
#    . .#. .# # #.  #   #           #   #
# ### ##### # ### # # # # ########### ###
# # #.#   #.# #. .# # #       #   #   # #
# # # ### # ### # # # ########### # ### #
# # #.#   #. . .# # #     #     #   #   #
# # # # ######### # ####### ### ##### # #
#   #.#           #           #       # #
##### ###################################
