##################### ###################
#              . . . .      #     #     #
##### ####### # ##### ##### # # ### ### #
#     # #     #. . .#     #   #   #   # #
# ### # # ### # # # ### # ####### # ### #
#   # # #   # # # #.  # #   #   # # #   #
### ### # # ### ### # # ### ### # # # # #
# #     # # #   #. .# #   #   # #   # # #
# ######### # ### ### ### ### # # #######
#           # #. .# #   #   #   #       #
######### ##### # # ### # # ########### #
#         #  . .# #     # #   #     #   #
### ######### # # ####### ### # ### # # #
#   #    . . .# # #   #   #   # # # # # #
# ####### ##### # ### # # # # # # # # ###
# #  . . .#     #   # # # # # #   # #   #
# ### ### ######### # # # # ##### # ### #
#   #.#   #. . .  #   # # #       # #   #
# # # ##### ### # ##### ####### ### #####
# # #. .#. .  #.#   # #       # # #     #
### # # # ##### ### # ### ### # # #######
#   # #.#.#. .#.  # #   #   # # # #     #
##### # # # # # ### ### # # # # # # ### #
#     #. .#.#. .# #     # # # #   # # # #
####### ### # # # ####### # # ##### # # #
 . . .# #. .# # #         # #         # #
##### ### # # # ##### ##### # ######### #
#   #. .#.# # # #   # #     #   #   #   #
# # ### # ### # # # ### ####### ### # # #
# #   #. .#   # # #   #       #     # # #
# ### # ### ### ##### ####### ######### #
# # # # #   #       #   #   #     #     #
# # # ### # # # # ##### # ##### ### # # #
# # #     # # # #     # # #   # #   # # #
# # ####### # ### # ### # # # # # ### # #
# #         #   # #       # # # #   # # #
# ############# # ### ##### ### ##### ###
#     # #     # #   # #   #   #     # # #
# # # # # ### # ### ### # ### # ### ### #
# # #   #   #     #     #     #   #     #
#########################################
