##################################### ###
# #     #   #     #  . . . . .#    . .  #
# # ##### # # ##### # ####### ##### # # #
# # #   # #   #     #.# #. . .#. . .# # #
# # # # ##### ### ### # # ##### ##### # #
# # # #       #   #  .#  . .#  .#     # #
# # # ####### # # # # ##### ### ####### #
# # #     #     # # #. .#  . .#. .#     #
# # ####### ##### # # # ##### ### # ### #
#       #   #     # # #. . .#. . .#   # #
####### # ### ##### # ##### ##### ### ###
#     # # #     #   # #   #.#. .#   #   #
# ##### # # # # # # # # # # # # ####### #
# # #   # # # # # # #   # #. .#. . .#   #
# # # ### # ### # # ############# # #####
# #   #   #   # # #             # #. . . 
# # ### ##### # # ######### ### # #######
#       #   # # #         #   # #   #   #
######### # # # ######### ##### ### ### #
#       # #   #   #     # # # #   #   # #
# ####### ####### # ##### # # # # ### # #
# #       #       # #     # # # #   #   #
# # ##### # # ##### ### # # # ### # #####
#   #     # #     #     # #       #   # #
##### ##### # ### ########### # # # # # #
#     #     #   #     #     # # # # # # #
# ##### ### ####### ### ### ### # # # # #
# #     #   #     #   # #       # # #   #
# ### # ##### ##### ### ##### ### #######
#   # # #   #   #   #   #     #       # #
# # # ### # ### # ### ### ##### # # # # #
# # #     #     #   # #   #   # # # #   #
### # ############# # # ### ### # #######
#   #         #   # # # #     # #   #   #
# ########### # ### # ### ### # # # # # #
# #       # # #   # #       # # # # # # #
# # ##### # # ### # # ####### # ### ### #
#     #   # #   # # # #     # #   #     #
# ######### # ### # ### ### # ### #######
#           #     #     #   #   #       #
#########################################
