########### ####### #####################
#    . .#  . . .  #.#             #     #
# ### # # # ### ### # ######### # ##### #
# #. .#.# #   #.#. .  #       # #       #
# # ### ##### # # ########### # #########
# #.# #. .#   #.#.# #       #           #
# # # ### ##### # # # ### # ########### #
# #.#    . . .#.#. .# # # # #   # #   # #
### ######### # ### # # # ### # # # ### #
#. .#     #  . .  #.# # #   # #   # #   #
# # # ##### # ##### # # ### # ### # # ###
#.# #       # #. . .    #   # #   #   # #
# ############# ######### # ### ####### #
#. . . .    #. .      #   # #   #     # #
# ##### ##### ##### ### ##### ### ### # #
# #   #. . .#.#   #   # #       # #   # #
# # # # ### # # # ### # # ####### # # # #
# # # #   #.#.# # # # # #         # # # #
# # # ##### # ### # # ### ### ##### ### #
#   #     #.#. .#   #       #   # #   # #
# # ##### # ### ### ######### # # ### # #
# # #   # #. . .  # #   #     # #   # # #
# ### # # ##### ### # # # ##### ### # # #
#   # # #     #     # #   #   # #   # # #
# # ### # ### ####### ##### ### # ### # #
# #     #   #       # #   #     # #     #
# ######### # ### # ### # ####### #######
#   #     # #   # #     #         #     #
### # ##### ### ### ####### ####### #####
# #   #       #   #       #             #
# ##### # # # ### ##### ####### ####### #
#       # # #   #     #   #   #     #   #
######### # ####### ##### ### ####### ###
#     #   # # #   # #   #   #         # #
### # # # # # # ### # # # ############# #
#   #   # # # #     # # #               #
# ####### # # ##### # # ### #############
# #       #   #   # # # #   #     #     #
# ############# # ### # # ### # ### #####
#               #     # #     #         #
#########################################
