######################### # #############
# # #     #              .#.#     #   # #
# # ### # ######### ##### # # ### ### # #
# #     #   #       #    .#.#   #   #   #
# ######### ##### ####### # ####### # ###
#         #   #   #. . .#.#.#  . .# #   #
######### ### # ### ### # # # # # # ### #
#   #     #   # #  .#  . .#.# #.#. .# # #
# ### ####### # # # ##### # ### ### # # #
#   # #         # #. .#   #. . .# #.# # #
### # ######### # # # # ######### # # # #
# #       #     # # #.# #         #.# # #
# ####### # ##### # # # # ######### # # #
#     #     #     # #.#   #. . .#. .  # #
# ### ####### # ### # ##### ### # ##### #
# #           # #   #. .  #.# #. .  #   #
# ######### ##### # # # # # # ####### ###
#   #       #     # # #.# #.# # #     # #
# # ##### # # ####### # # # # # # ##### #
# #   #   # # #     # #.# #. .  # #     #
# # # # ### # ##### # # ##### ### # #####
# # # # # # #     #   #. . . .#   #     #
# ### # # # # # ####### # ##### ### # ###
# #   # #   # #       # #       #   #   #
# # ### ######### ### # ######### ##### #
# #   #   # #     # # #   #     # #     #
# # # # ### # ### # # # ### ### # # #####
# # # # #   #   #   # #       #   # #   #
# ### # # ##### ##### ####### # ##### # #
# #   #   #   #     # # #   # #   #   # #
# # # # ### # # ### # # # # # ### # ### #
# # # #   # # #   # # #   # #   # # #   #
# # # ### ### ### # # ##### # ### ### ###
# # #   #   #   # # #       #   #     # #
# ##### # ##### ############### ####### #
# #     #     #       #   #   #   #     #
# ####### ### ##### ### # ### # ### ### #
#     # #   # #     #   #     #   # # # #
##### # ### # # ##### ######### # # # # #
#     #     #         #         #   #   #
#########################################
