########### ############# ###############
#   # #   #.# #   #      .      # #     #
# # # # # # # # # # ##### # ### # # ### #
# # # # # #.  # # # #    .#   # #     # #
# # # # ### ### ### # ### ### ### ##### #
# # #   #. .    #   # #. .  #       #   #
# # ### # ####### ### # # # # ####### ###
# #    . .  #     #   #.# # # #   #   # #
####### ##### ### ##### # # ### # # # # #
#     #.# #   #   #   #.# #     # # # # #
# ### # # # ######### # ########### # # #
#   # #.# #         # #. . .  #     # # #
##### # # ##### ##### ##### # ### # ### #
# # #  . .#   #       #. . .# #   # #   #
# # ##### # ########### # ### ####### ###
#       #. .#   #    . .# #   #   #   # #
####### ### # ### ### ### # ##### # ### #
#   #   #  .#   # #. .#   # #     #. .  #
# ### ##### ### # # ####### # ##### # ###
# #   #    . .#   #. . . .# # #. . .#. .#
# # ######### ####### ### # # # ####### #
#   #       #. . . .#   #.# #. .  #. . .#
# ### ##### ####### ### # # # ##### # # #
#     # # #        . .# #.# #. .#. .# # #
# # ### # ########### ### ##### # ### # #
# # #   #         # #. .#. . . .#.#   # #
# # # ########### # ### ### ### # ##### #
# # #       #   # #   #. .#   # #.#     #
### ####### # # # ### ### ### ### # #####
#   # #   # # # # # # #. .#   #. .# #   #
# ### # # # # ### # # # ####### # # ### #
# # #   #   #       # #.#  . . .# #     #
# # # ####### ####### # # # ### # # #####
#   #     #   #   #   #.# #. .# # #     #
######### ### ### # ### ##### ### #######
#   #   #   #   # #   #. . .#.#   #     #
# # ### ### ### # ### ##### # # ### ### #
# #   #   #       # #      . .#   # #   #
# ### ### ####### # ######### # # # # ###
#   #                         # #   #   #
#########################################
