####### #################################
#   #  . .    #   #   # #           #   #
# # ### # ### # # # # # # ### ### # # # #
# #     #.# # # #   #   #   #   # # # # #
# # ##### # # ####### ### ##### # ### ###
# # #   #.# #       # #   #   # #   #   #
# ### # # # ### ##### # ### # # ### ### #
# #   # #.#       #     #   # #   #   # #
# # ##### ######### ##### ##### # ### # #
# # #  . .      #   #         # #   #   #
# # # # # ####### ### ### ### ##### #####
# # # #.#             # #   # #   #     #
# # ### ############### # # # # # # # ###
#   #. .    #           # # # # # # #   #
##### # ### # ############# # # # ### # #
#    .#   # # # #       #   # # #   # # #
##### ### ### # # ##### # ######### ### #
#. .#.  #   # # #   #   # #       # #   #
# # # # ### # # ### # ### # ##### # ### #
#.#. .#   # #     # # #   #     # # # # #
# # ####### ##### ### # # ####### # # # #
#.# #. . .#     # #   # #       # # #   #
# # # ### ### # # # ### # ##### # # #####
#.# #.  #. .# # # # #   # #   # # #   # #
# ### ##### # ### # ####### ### # ### # #
#. . .    #.#     #   #   # #   #   # # #
######### # ### ##### # # # # # ### # # #
#. . . .# #.  #       # # # # # #   # # #
# ##### # # # ########### # # # # ### # #
 .#   #.# #.#             # # # # # # # #
# # # # ### ### ##### ##### ##### # # # #
# # # #. . .  # #   #       # #   # # # #
# # ##### # # # # ### ####### # ### # # #
# #     # # # #   #   #     #   # #   # #
# ##### # # # ##### ### # # # ### # ### #
# #   #   # # #   #     # # #       #   #
# # # ##### # # # ####### ### ####### ###
#   #   #   # # #   #   #           #   #
####### # ##### ### # # ####### ##### # #
#       #         #   #       #       # #
#########################################
