### #####################################
#  . .                # #             # #
### # ####### ### ### # # ########### # #
#   #.  #   # # # #   # # #   #         #
# ### # ### # # # ##### ### ### #########
# #  .#     #   #     #                 #
# # # ############# # # ############### #
# # #. .  #         # # #             # #
# ##### # # ########### # ##### ##### ###
# #   #.# # # #. .        # # #     #   #
# # # # ### # # # ### ##### # ##### ### #
#   # #. .# #. .#.  #       # #   # # # #
##### # # ### ### # ####### # ### # # # #
#   # # #.#. .  #.#     # # #   # #   # #
# ### # # # ##### ##### # # ### # ##### #
#     # #. .#. .#. .  # #   # #         #
######### ### # ### # # ##### ######### #
 .#  . .#   #.#. . .# #     #         # #
# ### # ##### ### # # ### ### ### ### ###
#. . .#.#  . .#   # # # #     # #   #   #
####### ### ####### # # # ##### ### ### #
#   #  . . .#       #   #       #     # #
# ### ##### # ################### # ### #
# #   #     # #     #             #   # #
# # ### ##### ##### # ########### ### # #
#   #   #         #   #       #     # # #
# ### # # ### # # ##### ##### # # ### # #
# #   # # #   # # #         # # # #   # #
### ### # # ### # # ######### ##### ### #
#   #   # # #   #           # #     #   #
# ### ##### # ### ######### ########### #
#   # #     # # # #     #   #   #       #
##### ####### # # # # ### ### # # ### # #
#   #       # #   # #   # #   # # #   # #
### ##### # # ##### ### ####### ### # # #
#       # # #   #     #       #     # # #
####### ### ### # ########### # ####### #
#     #       #   #   #     # # #     # #
# ### ##### # ##### # ##### ### # ### # #
#   #       #       #       #   #   #   #
#########################################
