# #######################################
#.      #             #. .        #     #
# ##### # ############# # ##### ### ### #
#.    #   #. . .#. . . .#. .  #     #   #
# ######### ### # ######### # # ##### # #
#. . . . .#.# #.#. .#. . . .# #     # # #
# ##### # # # # ### # # ##### ##### # # #
#     # #. .# #. . .#.# #     #     # # #
# ### # ##### ####### # # ########### ###
# # # #     # #. . . .# # #       # #   #
# # # ##### # # ##### # # ####### # # # #
#   #     #   #.#   # # #         #   # #
##### # ####### # ### # ############### #
#   # #       #.#     #         #       #
# ########### # ##### # ####### # ##### #
# #           #. .  # #       # # #     #
# ### ########### # ########### # # #####
#     #  . . . .#.#       #     # # #   #
######### ##### # ####### # # ### # ### #
 . . . .#.#    . .    #   # # #   #     #
####### # ############# ##### ###########
#   #. .#. . . .# #     # #   #         #
# # # ##### ### # # ##### # ### ### #####
# #  . . .# # #.# # #     #       # #   #
# ####### # # # # # # ####### ####### # #
# #     #.#   #.# # # #     #         # #
### ### # ##### # # # # ### ####### ### #
#   # # #. .#  .#   #   # #   #   # #   #
# # # # ### # # ######### ### # # ### # #
# # # # #  .# #. .          # # # #   # #
# ### # ### ### # ####### ### # # # ### #
# #   #    . .# #.      #     # # # #   #
# # ######### # # ##### # ####### # # ###
#   #       #.# #.    # #       #   #   #
##### ##### # ### ### # ####### ### # # #
# #   #   # #. . .#   #       # #   # # #
# # ### ### # # ####### ##### # ####### #
# #   # #   # # #     #   #   #     #   #
# ### # # ##### # ### ##### ####### # ###
#     #         #   #       #       #   #
#########################################
