# #######################################
#.  #. .                #           #   #
# ### # ##### ####### ### ####### ### # #
#. . .#. .  #       #     #     # #   # #
# ##### # ##### ### ####### ### # # ### #
# #   # #. .  #   #   #   # #     # #   #
# ### # # # ##### ### # ### # ### # ### #
#     # # #. .  #   #   #   #   # #   # #
####### ##### ### # ############# ##### #
#     #     #.#   #       #       #     #
# ########### # ######### # ####### #####
# #      . . .#       # # # #   #   #   #
# ### ### ######### # # # ### # # ### # #
#     #  . . .    # # #   #   #   #   # #
######### ### ### # # ##### ########### #
#   #     #. .  # # #   #   #         # #
### # ##### # ### ##### # ### ### # ### #
#   # #  . .# #   #   #       #   #     #
# ### # # ##### # # # ### ##### #########
#     # #. . .# # # #   # #     #   #   #
# ##### ##### # ### ### # ######### # # #
# #     # #. .# #   #   #             # #
### ### # # ### # ### # # ### ######### #
#   #   # #. .#     # # #   #         # #
# ####### # # ####### # ####### ##### ###
#     #   # #.      # #   #   #     #   #
# ### # ##### ##### # ### ### ### # ### #
#   #   #. . .  #   # #   # #   # # #   #
### ##### # # # # ### # ### ### # # # ###
#   #    .# # # # # # #     # # # # # # #
# ### ### ### ### # # ####### # ### # # #
# # # #  . .#   # #   #       #   # # # #
# # # # ### ### # ##### ### ##### # # # #
#   # # #. .  # #         #   # #   # # #
##### # # # ### # ######### # # ####### #
#     # #.# #   #   #     # # #     #   #
# ####### # # ##### # ### # ### ##### ###
#     #. .# #     #   # # #     #     # #
##### # ######### ##### # ####### ##### #
#     #.#               #               #
####### #################################
