################################### #####
# #     #      . .#   #  . . . .#  .    #
# # ### # ### # # # # # # ##### # # ### #
# # # #   #   #.#.# # # #.#   #.# #.# # #
# # # ####### # # # ### # # ### ### # # #
# #   #       #.#.#     #.#    . . .#   #
# ######### ### # ####### ###############
#   #       #. .#.#      . .#. . . . . . 
# # # # ##### ### ######### # ######### #
# # # #     #.#  . .#. . .#.#. .#     # #
### # ##### # ##### # ### # ### ##### ###
# # #     # #. . .#. .#  .#.  #. .# #   #
# # ####### # # # ####### # # ### # ### #
#           # # #.#      . .# # #. . .# #
####### ### # # # ########### # ##### # #
#       #   # # #.#. . . .#   # #. . .  #
### ##### ### ### # ##### ##### # #######
#   #     #     #. .  # #.#. . . .      #
# ### ######### # # # # # # ########### #
#   #   #   #   # # # # #. .  #       # #
# # ### # # # ### # # # # # ### ### ### #
# # # # # #   #   # #   # # #   # #   # #
### # # # ##### # # ### # ### ### ### # #
#   # # #   #   # #   # #         #   # #
# ### # ### # ####### # ##### ##### # # #
#   # #   # # #   # # # #   # #     # # #
### # ##### # ### # # ##### ### # ##### #
#   #       #     # #     #     # #     #
# # ####### # ##### ##### ##### # # #####
# # #       #     # #     # #   # # #   #
# # # ### ######### # # # # ##### # ### #
# # #   # #       # # # # #     # # #   #
# ##### ### ##### # # ### ##### ### # ###
#     #   #     #   #   # #       # # # #
##### ### # ##### ##### # ####### # # # #
#   #   #   #   # #     #     #     #   #
# # ######### # ### # # ##### ######### #
# #     #     #     # #   # #     #     #
# ####### ########### ### # # ### # #####
#         #             #   #   #       #
#########################################
