########### #############################
#          . .              #       #   #
# ######### # ### ######### ####### ### #
# #  . . .# #.  #   #   # #       # #   #
# ### ### ### # ### ### # ##### ### # ###
# #. .#  . . .# #     # #     # #   # # #
### # # ######### # ### ##### # # ### # #
#. .# #   #       # #   # #   #   #   # #
# ####### # ######### ### # ##### # ### #
#. . . .# #               #     # #   # #
# ##### ############# ######### # ### # #
# #   #. . . . . .  #           #   # # #
# # # ####### ### # ################# # #
#   #       #   #.#         #         # #
# ######### ##### ##### ### # ######### #
# #   #     #. .#.#   # #   #           #
# # ### ##### # # # ### ##### ##### #####
# # #   # #. .#. .#     #         #     #
# # # ### # ############# ########### # #
#   #     #. . .#. . . . .  #       # # #
############### # ##### # # # ##### # # #
#        . . .#. .#. .# #.# # #   # # # #
# ####### ### # ### # ### # # ### # # # #
# # #. . .#. .# #. .#. .#.# # #   #   # #
# # # ##### ##### ##### # # # # ####### #
#   #.#   #.#  . .#    . .# # #         #
##### # # # # # ### ####### #############
 . . .# #  .# #.#   #     #     #   #   #
########### ### ##### ### # # # ### # ###
#   #      . .#. . .# # # # # # #   #   #
# ### ####### # ### # # # ### # # ##### #
#     #     #.#   #.# #       #   # #   #
####### ### # ##### # ############# # ###
# #     #   #. . . .#               # # #
# # ######### # ### ####### ######### # #
#           # # #   #     #           # #
########### ### # # # ### ############# #
#   #     #     # # #   #     #       # #
# ### ### ####### ##### ##### # ####### #
#     #                     #           #
#########################################
