################# #######################
#        . . .#  . .                #   #
# ####### ### ### # ### ######### ### # #
# #. . . .# #. .# #.  #   #     #     # #
### # ##### ### ### # ##### ### ####### #
#. .# #. .#   #. . .#         #     #   #
# ##### # ### # # # # # ########### # ###
#. . . .#. .#   # # # #           # #   #
# # ####### ##### # # ############# # # #
# #   #. . .#   # # #     #         # # #
# ### # ##### # ### ### # # ##### ##### #
#   # #.# #   # #     # # # #     #     #
### ### # # ### # ### ### ### ##### # # #
#   #. .#   # # # #   #   #   #   # # # #
# ### ####### # # # ### ### ### # ##### #
#   #. . .    #   # # # #     # #     # #
######### ####### # # # ####### ##### # #
 . . .#. .      # #   #       # #   # # #
##### # # ##### ############### # # # # #
#    . .#     #         #       # # # # #
####### ### # # ### ### # ### ### # # # #
#     # #   # #   #   # #   #   # # #   #
# ### ### # # ####### # ####### # ### # #
# # #     # #       # #   #   # #   # # #
# # ### # # # ####### ### # # # ### ### #
# # #   # # # #         #   # #   #     #
# # # ### # ### ### ### # ### ###########
#   #   # # #   #     # #   # #         #
######### # # ### ### # ##### # ### #####
#   #     # # #   #   #     # # #     # #
# # # ##### # ##### ####### # # # # ### #
# # # #     #   #   # #   # #   # # #   #
### # ### # ### # ### ### # ####### # ###
# # #   # #   # #         # #     # #   #
# # ### # ### # ##### ##### ##### # ### #
# #     # #   # #   #     #       # #   #
# ####### ##### # # ##### # ####### # ###
# #     #     # # #     # # #     # # # #
# # ### ### # # # ### # # ### ### ### # #
#   #       # #   #   # #       #       #
#########################################
