################# #######################
# #     #        .    #   #   #   #     #
# # ### # ### ### ### # ### # ### # #####
#   #   #   # #  .  # #     # #   # #   #
# ### ####### ### # # ####### # ### # # #
# # # #   #   #. .# #             # # # #
# # # # # # ### ### # # ##### ### # # # #
#   #   # # # #.#   # #     #   # # # # #
### ####### # # # ### ##### ### ### # # #
#     #     # #.# #   #   #   #   #   # #
##### # ##### # # # ##### ### ### # ### #
#   # #       #.# # #     # #   # #   # #
# ### ######### # # # ##### ### ### #####
#   #   #  . . .# # #         #         #
### ### # # ### # ### ### # # ######### #
#. . . .# #.#   #       # # #         # #
# ##### # # ########### ### ####### # # #
#. .# #.# #. . . .    #   #       # # # #
# # # # ######### ### ### # # ### # ### #
# #.# #. .#. .#. .  # #   # #   # # #   #
# # # ### # # # # ### ####### ### # # ###
# #.#    . .#. .#   #   #   # #   # #   #
# # ############### ### # # # # ### ### #
# #.  #. . . . . .#   #   # # # # #   # #
# # ### ######### ### ##### # # # ### ###
# #. .#. . .#   #.#   #   # # #   # #   #
# # # ##### ### # ##### ### ####### ### #
# # #. . .#. . .#. . .  #   #         # #
# # ##### ##### ##### ### ### ######### #
# #     #.  #  .#   #.  #       #     # #
# ##### # # ### # # # ########### ### # #
#     # #.#   #.# # #. . .      # #   # #
# ### ### ### # ### ##### ##### ### ### #
# #   #. .#   #. . .#   #. .#   #     # #
# # ### # ######### # ##### ##### ##### #
# # # #.# #. . . . .# #   #. .    #   # #
### # # ### ####### # # # ### ####### # #
#   # #. . .#     #   # # # #.  #   #   #
# ### # ##### ### ##### # # # # ### #####
#     #         #       #   #.#         #
############################# ###########
