####### #################################
#  . . .#. . .#. .      #     #         #
# # ##### ### # # ### # ##### # ##### ###
# #. . .#.# #. .#.# # # #     #   # #   #
# ##### # # # ### # # # ##### ### # #####
#     #. .  #   #.#   #     #   #   #   #
################# ######### ### ### # # #
#. . . . . .#. . .        #   # # # # # #
# ######### # # # # # ####### # # # ### #
#. .# #. . .#.# # # #       # # # #   # #
### # # ##### # # ### ### # ### # ### # #
#. .#  . . . .# #   #   # #   #   # # # #
# # ######### # # # ### # ### ### # # # #
 .# #         # # # #   #   #       # # #
### # ######### # # ####### ### ##### # #
#   #   #       # #       #   #     # # #
######### ### ### # # # # ### ### ### # #
#   #     #   #   # # # #   #   #     # #
# # ### ####### # # # # ### ### ####### #
# # #   #       # # # #   #   #         #
# ### # # ##### # # # ### ### ### ### ###
# #   # # #     # # #   #   #   #   #   #
# # ### # ####### # ### ### ### ### ### #
#   #   # #       #   # #     #   # # # #
######### # ####### # # # # ##### # # # #
#   #     # #       # # # # #     #   # #
# ### # # ### ######### # # # ######### #
#     # # #   #       # # # # #         #
##### ### # # # ##### # # ### ##### ### #
#   # #   # # #   # # # #   # #     #   #
# # ### ### ##### # ### # # # ###########
# #     #       #   #   # # #           #
# ####### ### # ### ### ### ######### ###
# #   #   # # #   #     #           #   #
# # # # ### # # ########### ####### # ###
# # #   #   # # #     # #   #   #   #   #
# # ##### ### # # ##### # # # # ####### #
# #     # #   #   #   # # # # #     # # #
# ####### # ####### # # # ### ##### # # #
#         #         #   #     #     #   #
#########################################
