############################### ####### #
#       #      . . . . . . . .#.#. . . .#
# ##### ####### ############# # # ##### #
# #   #   #    . . . . .#   #.#.#. .#   #
# ### ### # ##### ##### ### # # # # #####
#   #       # #   #   #. . .#.#.# #. . .#
# # ######### # ### ####### # # # ##### #
# #     # #   # #         #.#. .# #   #.#
# ##### # # ### ######### # ##### ### # #
# #   # # # #   #     # #  . .# #     #.#
# # ### # # ##### # # # ##### # ####### #
# # #   # # #   # # #   #    . . . . . .#
# # # # # # # # ### ### ### ### # ### # #
#   # # # #   #     # #     #   # #   # #
##### # # ########### ####### ### # ### #
#   # # #                     #   #   # #
# # ################# ######### # ##### #
# # #                 #         # #     #
# ### ### ### ### ##### ######### # # ###
#     #     # #   #     #         # #   #
####### # # ### ### ############# ### # #
# #     # #   #   # #     # #   #   # # #
# # ### # # # ##### # ### # # # # # # # #
#   #   # # # #   # # #   # # # # # # # #
# ####### ### # ### # ##### # # ### # # #
# #       #   # # # # #     # # #   # # #
### ##### # ### # # # # ### # # # ### # #
#   #     # #     #   #   #   # #   # # #
# ######### # ########### ######### # # #
#   #       # #   # #   # #         # # #
# # # ####### # # # # # # # # ######### #
# # # #   #   # # #   # # # # #   #     #
### # # ### ### ### ### # # # # # ### # #
#   # #   # # #   # #   # # #   # #   # #
# ### ### # # ### # ##### ######### ### #
# #   # #         #   #             #   #
# ##### ######### ### ####### ##### # ###
#     # # #     # # #         #   # # # #
# # ### # # ##### # ######### # ### # # #
# #       #                   #     #   #
#########################################
