### ############################### #####
#  . .      #. .  # #. .  #. . .  #.#   #
# # # ####### # # # # # ### ### # # # # #
# # #.  # #. .#.# #. .#. . .#. .# #.# # #
# # # # # # ### # # ######### ### # ### #
# # #.#   #.# #.# #.#   #   #.#   #. .# #
# # # ##### # # # # # # # # # ####### # #
# # #. . . .  #.# #.# #   # #. . .  #.# #
# # ### # ##### ### # ##### ##### ### # #
# #   # # # #  .#. .#     # #. . .#. .# #
# ### # # # # # # ####### # # ##### ### #
# # # # # # # #.#.  #     # #. . . .    #
# # # # ### # # # ### ##### # # # #######
# # # #   # # #. .    #     # # #       #
# # # ### # ### ############# # ####### #
#   #   # #   #         #   # #   # #   #
####### # ### ##### ### # ### ### # # ###
#       #   #   # #   # #     # # #   # #
### # # # # ### # # # ####### # # ##### #
#   # # # # #     # #       # # #       #
# ### # # ### ##### ### # # # # ####### #
# #   # # #   #   #   # # # # #       # #
# # ### # # ##### ### # # # ######### # #
# # #   #         #   # # #         # # #
# ### # # ############# # ####### # # # #
# #   # #     #   #   # #       # # # # #
# # ######### # ### ##### ##### # # # # #
# #         # #     #     #   # # #   # #
# ####### ### # ##### # ### ### ####### #
#       #   # #   #   # #   #   #       #
# ##### # # ### ### ### # ### ### ### # #
#     # # #     #   #   #     #   #   # #
####### # ####### ### ############### # #
#   #   #   #     #                 # # #
# # # ##### # ### ### ############# # ###
# # # #   # #   # #   #         #   #   #
# # # # # # ### ### ### ##### # # ##### #
# # # # # #   #   #         # # # # #   #
# ### ### ####### ########### # # # # # #
#       #         #           # #   # # #
#########################################
