####################### #################
#         #     #      .  # #. . . . .  #
# ####### # # # ### ### # # # ##### # # #
#   #   #   # #     #  .#   #.#   # #.# #
# # # ####### ######### ##### ### # # ###
# # #   #     #      . .  #. .#   # #. .#
# # ### # # # # ##### ##### ### ##### # #
# #   #   # # # #    . . .#.# # #. .# #.#
# # ####### # # ######### # # # # # ### #
# #   #     # #         #.#. . .#.#. . .#
##### ### # # ##### ### # ##### # ##### #
#     #   # # #   # #   #. . . .#. .#   #
# ##### # # # ### # # # # # ####### #####
# #     # # #     # # # # #       #.#. . 
# # ##### # ######### # # ######### # ###
# #   #   # #         # #   #. . . .#.# #
# # # # ### # ### ### ##### # # ##### # #
# # # # #   #   # # # #     #.# #. . .  #
# # ##### ####### # # # ##### ### #######
# #   #   #       # # # #   #. . .      #
##### # ##### # ### # # # ### # ####### #
#     #   #   # #   # # #     #       # #
# ####### ### # # ### # ######### ##### #
# #       #   # #   # #     #   #     # #
# ##### # ##### ### # # # ### # ##### # #
# #     # #     #     # #     #   #   # #
# # ### ### ##### ### # # ####### #######
# # # # #   #     #   # # #     #       #
# # # # # ######### ### ### ### # ### ###
# # #   #         # #       # # #   # # #
# # ########### ### ####### # # ### # # #
# #           #   #   #   #   # # # # # #
# # ############# ### ### ##### # # # # #
# #       #         #     #     # # #   #
# ####### # ################# ### # #####
# #     # #       #           #   #   # #
# # ### ##### ##### # ######### ### # # #
#     #     # #     # #     # # #   # # #
# ####### # ########### ### # # ### # # #
#       # #               #   #     #   #
#########################################
