####################### #################
#. . . . .#    . . . .#. .              #
# ####### # ### ##### # # ##### ####### #
#.#   #. .# #. .#   #.# #. . .#       # #
# # # # ##### ##### # ####### ### ### # #
#.# #  . .#. .#   #  . . .#. .# #   # # #
# ####### # ### # ####### # # # # ### # #
#. . .#  . .#   #        . .#   #   # # #
# ### # ################### # ##### ### #
# #. .#   #   #   #         # #     #   #
# # # ##### # # # ### ### ##### # # # # #
# #.# #     #   #     #   #     # # # # #
# # # # ### ########### ### ##### # # ###
# #.# # #   #   #     # #   #     # #   #
### # # ##### ### ### ### ### # ##### # #
 . .# #     # #   # #     # # # #   # # #
### # ##### # # # # # ##### # # # # ### #
#   # #   # # # # # # #   #   # # #     #
# ### # # ### # # # ### # ##### ####### #
#   # # #   #   # # #   #   #         # #
# # # # ### ####### # ##### # # # ### ###
# # #     #         # #     # # #   #   #
### # ##### ####### ### ##### # ### ### #
#   #     #       # #   #     # #     # #
# ##### # ### ### ### ### # ### ####### #
#     # #   #   #     #   #   #   #     #
### # ### # ### ####### ### # # # #######
# # #   # # # #   #   # #   # # #       #
# # ### # # # # # # ### # ### # # # ### #
#   #   # # # # # # #   # #   # # #   # #
##### ##### # # # # # ### # # # # ### # #
# #   #   # # # # #   #   # # # # #   # #
# # ### # # # # # ######### # # ### ### #
# # #   # # # # # #         # # #   #   #
# # # ### # # ### # ##### # ### # # #####
# # #   # #   #   # #     # #   # # # # #
# # ##### ######### ####### # ### ### # #
# #     # #       # #   #   # # #   #   #
# ##### # ####### # # # ### # # # # ### #
#       #           # #     #   # #     #
#########################################
