####### #################################
#  . . .  #. . .            #           #
### # ##### ### ##### # ### # ### #######
#. .# #. . .# #. .  # # #   # # #     # #
# ### # ##### # # # ### ##### # ##### # #
#.#   #. . .# # #.#   # #     # #   #   #
# # ####### # ### ### # # ##### ### #####
#.#   #   #.# #. .#   #   #. . . .  #. . 
# ### # ### # # ### ####### ##### ### ###
#. .#   #. .  #. .# #. . . .#   #. . .  #
# # ##### ####### ### ####### # # ### # #
# #. .  #. .    #. . .#       # #   # # #
# ### ##### ########### ####### ### ### #
#   #. . . .        #         #   # # # #
# # # ########### # # ########### ### # #
# # # #         # #           # #     # #
# # ### ### ### ############# # # ##### #
# # #   #     #             #   # #   # #
# # # ### ############# ### ##### # # # #
# # #   # #   #       #   #   # # # # # #
# # ### ##### # ##### # ##### # # # ### #
# #   # #       #   # #   #   # # #     #
# ### # # ####### # ##### ##### # ### # #
# # #     # #     #     # #   # # #   # #
# # # ##### # ######### # # # # # ##### #
#   # #       # #   #   # # #   # #     #
# # # ##### ### # ### ### # ##### # #####
# # #       #     #   #   # #     # #   #
# # # ####### ##### ### # # # ### # # # #
# # # #     # # #   #   # # # # # # # # #
# # # # ### # # # ####### # # # # # ### #
# # # #   # #   #   #     #   # # #     #
# # ##### ##### ##### ### ### # # # #####
# #       #     #     # #   # # # #     #
# ######### ####### ### ### # # # ##### #
#         # #       #   #   # # #     # #
####### ### # ##### # ### ### # ### # ###
#     #     # #   # #     # # #   # #   #
# ############# # # ##### # # ### ##### #
#               #   #     #   #         #
#########################################
