########################### ####### #####
#     # #         #       #.# #  . .#. .#
# # # # # ####### # ####### # # # ### # #
# # # #   #       # #. . .#.#   #.#. .#.#
# # # ##### ##### # # ### # ##### # ### #
# # #   #   #   # # #. .#. .#. .#. .  #.#
# # ### # # ### # # ### ##### # ####### #
# # #   # #     # #  . .#    .#. . .#. .#
# # ### ######### ### ####### ##### # ###
# #   #             #. . . . .# #. .#. .#
# ### ############# ### ####### # ### # #
# # # #     # # # #     #   #. . .#   #.#
# # # # ### # # # ####### # # ######### #
#   # # #   # # #       # # #.#    . . .#
##### # ##### # ####### # # # ##### # # #
#     #       # #       # #  . . . .# # #
# # ### # ##### # ##### ##### ### ##### #
# # # # #       # #         # #   #     #
# ### # ######### # ####### ### ### #####
#   #     #       # # #       #   # #   #
######### ######### # ####### # # # ### #
#                   #     #   # # #   # #
# ####################### # ### # # # # #
# #   #         #     #   #   # # # # # #
# ### # ####### # ### # ##### ### # # # #
#     #   #   # # # #   #         # #   #
######### # # # # # ##### # # ##### # ###
#         # # #     #     # # #     #   #
### ####### # ##### ####### # # ### #####
#   #       # #             # # #   #   #
# ##### ##### ### ####### # # # ##### # #
# #   # #   # #   #   #   # # #       # #
# ### # ### # # ### # ##### # ### # ### #
#   # #   #   # #   #       #   # # #   #
# # # ##### ### ### # ####### # # ### # #
# # #   # #     #   # #   #   # #   # # #
# # ### # ####### ##### ### ### ### # # #
# # # #   #       #     #   #   # # # # #
# # # ### ##### # # ##### ### ### ### # #
# # #           # #       #     #     # #
#########################################
