### #####################################
#  .#. . .      #         #         #   #
# # # ### ### # ### ##### # ### ### ### #
# #. .  #.  # #         # #   # #   #   #
# ####### # ######### ### # ######### ###
# #     #.#         #   # # #   #       #
# ##### # ######### ### # # # ### ##### #
#     # #. .#. .  # #   # #   #   #     #
# # # # # # # # # # ####### ### #########
# # #   # #. .#.# #       # #   #. . . . 
# ### ### # ### # ####### # # ### ##### #
#   # # # # #. .#   #   #   # # #.#   # #
### # # # # # ##### # ####### # # # # ###
#   #   # # #.#   # #. .      #. .# #   #
# ####### # # ### # # # ####### ####### #
# #       # #. .#   #.#. .#. . .  #     #
# ### # ### # # ##### ### # ####### #####
# #   # #   # #. . . .  #. .            #
# # ##### # # ##### ################### #
# # #   # # #     #   #           #   # #
# # # # # ####### ##### ##### ##### # ###
# # # # #       #   #       #     # #   #
# # # # ##### # # ### ##### ##### ##### #
# # # # #     # #   # #   #     #   #   #
### # # # ######### # # # ### # ##### ###
#   # #   #       #     #   # #       # #
# ######### ##### ####### # ########### #
#       #   #   #   #     #             #
# # # # # ### ##### #####################
# # # #   #   #   #                     #
# # # ##### ### ##### # # ######### #####
# # #     #   # #   # # #   #     #     #
# ##### # ### # # # # ##### # ######### #
#   #   #   #   # # #     #           # #
# # ### ##### ### # ##### ######### # # #
# # #   #     #   #   # # #   #   # # # #
# # # ### ##### ##### # # # ### # ### # #
# # # #   #     #     # # #   # #     # #
# # ### ######### ##### # ### ######### #
# #                   #     #           #
#########################################
