########################### ##### #######
#     # #       #         #. . .#.  #. .#
# ### # # # ### # # ##### ##### # ### # #
# # # #   # # # # #     #   # #.#. . .#.#
# # # ##### # # ########### # # ####### #
# #         #         #     # #. . .#. .#
# ######### ######### # ##### ##### # # #
#   #       #         # #. . .  #. .#.# #
# # # ######### ### # # # ### ### ### # #
# # #       #   #   # # #.# #. . .#  .# #
# ########### ### ### # # # ######### # #
#   #         #   # # #. .#        . .# #
### ### ####### ### # # ########### ### #
#   #   #       #   #  .#    . . . .# # #
# ### ####### ##### ### ##### # ### # # #
#   # # #   # #       #. . . .# #   # # #
##### # # # # # ##### ####### ### ### # #
#   # # # # # #   # #   #     #   #     #
# # # # # ### ### # ### ####### ##### # #
# #   #         # # #         #   #   # #
# ######### # ### # ######### ### # ### #
#   #   #   #   # #   #         # # #   #
# # ### ####### # ### ######### # # # # #
# #   #   #     # # # #     #     # # # #
# ####### ### ### # # # ### ####### # # #
# # #   #     #   #     # # #       # # #
# # # # ####### ######### # # ######### #
#   # #     #         #   #   #         #
##### ##### ### # # # # ##### # ##### # #
#     #         # # #   #     # #     # #
# ### ########### # ########### # ### # #
#   # #   #     # # #           # #   # #
# # ### # ##### # # # ####### ### # # # #
# #   # #   #   # # # # #   # #   # # # #
# ### # ### ### # ### # # # ### ##### # #
#   # #   #   # # #   # # #     #     # #
##### ### ##### # # ### ########### # # #
#     # #     # # # # #   #         # # #
### # # ##### # ### # ### ##### ####### #
#   #   #           #           #       #
#########################################
