##################################### ###
# #   #   #         #                .  #
# # # # ####### ### # ### ########### # #
#   #   #     # # # #   # #    . . .#.# #
# ######### # # # # ### # ##### ### # ###
#   #       # #   #   # #   #  . .#.#. .#
### # ### ### ### ##### ### ##### # # # #
#   # #   #     #   #   #   #   #.#.# #.#
### ### ### ### ### # ### ### # # # ### #
#       #   # #   #   #   #   # #.#. .#.#
# # ####### # ### ##### ### ##### ### # #
# # #       #   #     #     #    .# #.#.#
# # # ### ##### ##### # ######### # # # #
# # #   #     # #   # #   #  . . .# #.#.#
# # ### # ### # ### # ##### # ##### # # #
# # #   # # # #   #         #.# #. . .#.#
# ### # # # # ### ####### ### # # ##### #
# #   # #   #   #     #   #  .#  . . . .#
# # ################# ##### # ######### #
# # #     # #     #     #   #. . . .# # #
### # ### # # ### ##### # ######### # # #
#   # # # #   # #     # #   #. . . .#   #
# # # # # # ### ##### # ### # ###########
# # # # #           # #     #.#. . . . . 
# ### # ### ####### ######### # ####### #
#   # #   # #            . . .#. .#   # #
### ##### ### ########### ### ### ### # #
# #       #   #      . . .#   #. .#   # #
# ####### # ### ##### # ####### ### ### #
#   #   # # #   #    .# #. .  #. .#   # #
### ### # # ### # ### # # # ##### ### ###
#     # # #   # # # #.# #.#. .  #.  #   #
##### # ### # # # # # # # ### ### ##### #
#   # #   # # # # # #.# #.  #. . .#   # #
# # # ### ### # # # # ### ####### # ### #
# # #   #     # # # #. . .      #   #   #
# ##### ####### # # ##### # ### ##### ###
#     #       # # #     # #   #       # #
##### ####### # # ##### # ############# #
#               #       #               #
#########################################
