############# ###########################
#       #    .                    #     #
# ####### ### ########### ####### # ### #
# # #     # #. . .      #       # # # # #
# # # # # # ### # ##### # ##### # # # # #
#   # # # #   # #. .#   #     # # #   # #
### # # ##### ##### # ##### # # # ##### #
#   # #       #. . .# #     # # #       #
# ### ######### ##### # ### # # # #######
# #   #    . . .#   # # #   # # # #     #
# # ### ### # # # # # # ##### # ### ### #
# #   # #. .# # # # # #     # #   # #   #
# ### # # ##### # ### # ### # ### # # ###
#   # # #. . .# #     #   # #   #   # # #
### ### # ### # ### ####### ######### # #
#       # # #.#   # #     #         # # #
####### # # # ### ### ### ### ####### # #
#       #   #.  #       #   #   #     # #
# ########### ############# ########### #
# #        . .#. . . .    #   #         #
# # ### ### # # ##### ####### # # ### ###
# # #   #  .# #.    #. . .  #   #   #   #
# # # ### # ### ##### ### # ##### # ### #
# # # #   #. . .#   # #. .#   #   #   # #
# # # # # # ##### # ### # ### ####### ###
# # # # # #       #   #.#   # #     #   #
# # ### ############# # ### # # # # ### #
# #   # #    . . .#   #. .# # # # #   # #
##### # # ### ### ##### # # # # # ### # #
#     # # #. .#  . . .# #.# #   #   # # #
# ### # ### ######### ### # ####### # # #
#   # # #. .#   #. . .#. .#       # # # #
# # # # # # # # # ##### # ####### # # # #
# # # # #.# # # #. . .#.# #     # # # # #
### ### # # # ####### # # ##### ### # # #
#   #   #.# #   #    . .# #         # # #
# ### ### ##### ##### ### # ##### ##### #
# # # # #. .  #     # #   # #     #     #
# # # # # # # ##### ### ### # ##### #####
#   #   # #.#     #     #   #     #     #
########### #############################
