############# ###########################
# #    . . . .                          #
# # ### ##### # ########### ####### ### #
# #   #.#     #       #   #   # # # #   #
# ### # ######### ### ### ### # # # # ###
# #   #. .  #       #   # # #   # # #   #
# # ### # ### ##### ### # # ##### # #####
#   # # #. .# #   #   #   #   #   #     #
##### # ### # # ### # # # ### # ####### #
#. . .# #. .# #   # # # # #   # #     # #
# ### ### # # ### ### # ### ### ##### # #
#.# #.#. .# #   #     #     # #     #   #
# # # # ### # ############### ##### #####
#.#. .#.#   #     #               #     #
# # ### ##### # ### # ########### ##### #
#.#.#  . .  # #     #     #     #       #
# # ##### # ### ### ### # # ### ### #####
#.#. .#. .#   #   #   # #     #   #   # #
# ### # # ### ### ### # ######### ### # #
#.#  . .# # #   #   # #         #   #   #
# ##### # # # ##### # ######### # # ### #
#. . .# #   # #   # #         # # #   # #
# ### # ##### # # # ####### ### # # # ###
# #. .#   #   # #         # #   # # #   #
### # ##### # # ######### # # ### # ### #
 . .# #     # # #       # # #   # #   # #
### ### ### ### # ######### ### # # # ###
#   #   #   #   # #         #   # # #   #
# ### ### ### # # # # ### ### # # ### # #
# #   # # #   # #   # #   #   # #   # # #
### # # ### ### # ##### ### # # ### # # #
#   # # #   #   # #   #   # # #   # # # #
# ### # # ### ### # # ##### # ### # # # #
# #   #   #   #   # # #     # #   # # # #
# ################# # # ### ### ### ### #
#             #   # # #   # #   #   #   #
# ########### # # ### # # # # ### #######
# #         # # #     # # # # #       # #
# # ### ### # # ######### # # ####### # #
#   #   #   #   #         # #       #   #
#########################################
