############################### #########
#   #     #                    . .#. . .#
# ### ##### ####### ### ####### # # ### #
#   #     #     #   #   #       #. .  #.#
# ####### ####### # ##### ####### ##### #
#               # # #     #. . .# #. . .#
# ############# # ### ##### ### ### ### #
# #     #   #     #   #. . .#  .#. .# # #
# # ##### # ### ### ### ####### # # # # #
# #       #     #   #  .# #    . .# #   #
# ############### ##### # # #############
#     #   # #   #     #.#   #. . . .    #
##### # # # ### # # # # ##### ##### ### #
#   #   # # # #   # # #. .  #.#. .#. .# #
# ######### # ####### # # ### # # ### # #
#       #   #         # #. . .#.#. .#.# #
####### # ####### ############# ### # # #
#     #       #   #    . . .#. .#  . .# #
# ### ####### # ### ### ### # ##### ### #
#   #     # # # #   #. .#  . .#   # #   #
######### # # ### ### # ####### ### # ###
#         # # #   #. .# #. .#   #   #   #
# ######### # # ### ##### # # ####### # #
# #           # #  . .#. .#.#       # # #
# ######### ### # # # # ### ####### ### #
#   #           # # #. .# #.      #     #
### ### # # ##### ####### # #############
#       # # #   #         #. . . .      #
######### # # ################# # ### # #
#       # # # #        . . . .# #.  # # #
# ##### ### # # ####### ##### # # # ### #
# #   #     # # #   #  . . .#.# #.#   # #
# ### ####### # ### ####### # ### ### # #
#   # #   #   #   #     #. .#. . .  # # #
# # # ### ### # # ##### # ########### # #
# # #   #     # #     # #.# #         # #
### ### ##### # ### ### # # # ######### #
#     #       #   #     #.# #   # #     #
# ########### ########### # ### # # # ###
#           #            .#     #   #   #
######################### ###############
