########### # ###########################
# #       #.#. . . . . .      #. .      #
# ####### # ####### # # ####### # #######
#     # # #. . . .# # #. .#. . .#. . . .#
##### # # ####### # ### # # ####### ### #
#   # #   #   #  .#   # #.#.#     #   #.#
# # # # ### # ### ### # # # ##### ##### #
# #   # #   #   #.#   # #.#. .#   #. . .#
# ### # ####### # ##### # ### # ### # # #
# #   #     # # #. . .# #. . .  #. .# # #
# ### ##### # # ##### # # ####### ##### #
#   # #   #   # # #. .# # #. . .#.#   # #
##### # # ### # # # ### ### ### # # # # #
#   #   # #   # # #.# # #. .# #. .# # # #
# ### ##### ### # # # # # # # ### # # # #
# #   #     #   #. .#   #.# # # # # #   #
# # ### ##### ### ####### ### # # # # # #
#   # #   #. . . .#      .#   #   # # # #
# ### ### # ############# # ####### # # #
#     # #  .#      . . . .#         # # #
##### # ### ####### ### # # ##### ### # #
#   #      . . . . .#   # # #     #   # #
# ######### ####### ##### # # ##### ### #
#   #   # # #   # # #     # # #     # # #
### ### # # # # # # # ### ### # # # # # #
# #       # # #   # # #   #   # # # # # #
# ####### # # ##### # ##### ### # ### # #
#       # # #       #     # #   #     # #
# ##### # ############# # # ########### #
#   # # #     #         # #           # #
### # # ##### ### ### ### ########### # #
# # # #     #     #   #   #     #   # # #
# # # ########### ##### ### ### # ### # #
# #               #     #   #   #     # #
# ################# ### # ##### ####### #
#               #   #   # #   #   #     #
# ##### ####### ### # ### ### ### # # ###
# #   # #   #       # # #     #   # # # #
# # # ### # ######### # ######### # # # #
# # #     #           #             #   #
#########################################
