####### #################################
# #    .      #         #     #         #
# # ### ### ### # ##### ##### # ####### #
#   #  . .#     #   # #     # # #     # #
### # # # ######### # ##### # # # ##### #
#   # # #. . .#     #       # # # #   # #
##### # # # # ############### # # # # # #
#     # # # #. .    #       #   #   # # #
# ##### # ##### ### # ##### # ####### # #
#   #   #     #.  #       #         # # #
### # ######### # ####### # # # ##### # #
#   # # #  . . .# #     # # # #       # #
##### # # # ### # ### ### # #############
#     #   #.#   #       # #   #         #
# ######### # # # ##### # ### # ####### #
#   #. . .#.# # # #   # #   #     #   # #
### # ### # # ### # # ### # ##### # ### #
# # #. .#. .#   #   #   # #     # #     #
# # # # # # # # ####### # ##### #########
#   # #.# # # #       # #     #     #   #
##### # # # ### ##### ##### ####### ### #
#. .# #.# #   #     #     # #     #     #
# # ### # ### ####### # # # # ### #######
#.#.#. .#   # #     # # # #     #       #
# # # # ##### # ### ### ########### ### #
#.#. .# #     # # # # #           # # # #
# # ### # ##### # # # ### ####### # # # #
#.# #   #   #   # #   #       #   # #   #
# ### ### # # ### ##### ####### ### #####
#. .# #   #   # #       #   #   # #     #
# # # # ####### ####### ### # ### #######
# #.# #         # #   #   #   #   #     #
# # # ########### # # ### ####### # ### #
# #.#         #     # # #   #     #   # #
# # ##### # ### ##### # # ### ####### ###
# #. .  # #     #   #   # #         #   #
##### # ##### ### ####### # ####### ### #
 . . .#     #   #         #   #   #   # #
### # ##### ############### ### # ##### #
#   #     #                     #       #
#########################################
