########### #############################
# #   #    .      #   #     # #         #
# # # # ### ##### ### ##### # # ####### #
#   # # #  .    #         # #   #     # #
# ### # # # ########### ### ######### # #
# #   # # #. . .      #       #     # # #
# ##### # # ### ##### ######### ### # # #
# #     # #   #. .  #             # # # #
# # # ### ### ### ### ############# # # #
# # # #     #   #. .#     #         # # #
# # # # ########### ##### # ######### # #
#   # # #    . . .#.  # # #     #     # #
### # # ##### ### # # # # ####### ##### #
# # # #     #.#  . .#   #               #
# # # ### # # ### # # ####### ###########
#   #   # # #. .# # #   #   #         # #
####### ### # # # # ##### # ####### # # #
#     # #   # #.# #       #   #     # # #
# ### ### ##### # # ### ##### # ### # # #
#   #     #  . .# #   # #   # #   # #   #
# # ######### # # ### ### ### ### ##### #
# # #  . . . .# #   #   #       #     # #
##### # ######### # ### ######### # # # #
#     #.#   #     # # #     #   # # # # #
# ##### # # # ##### # ##### ### ### # # #
# #  . .# #   #     #     # #   #   # # #
# ### # # ##### ######### # # ### # # ###
#   #.# #   #   #         # # #   # #   #
### # # ### ##### # ####### # # ####### #
#   #.#   #     # #     #   # # #       #
# ### ### # # ### ##### # # # # #########
#   #. .# # # #   #   # # #   #         #
### # # # ### # ### # # ### ### #########
# # # #.# #   # #   # #   #   #   #   # #
# # # # # # ### # ### ### ####### # # # #
#   # #.# # #   # #     #       # # #   #
##### # # # # ##### ####### ### ### #####
 . .# #.# # #   #   #     # #   #   #   #
### ### # ### ### ####### # # ### ### # #
#  . . .#                 # #         # #
#########################################
