####### #################################
#      .    #. . . . .    #. .    #. .  #
# # ### ##### ##### # ##### # ##### # ###
# # # #.  #. .    # #. . . .#.  #. .#. .#
### # # ### ##### ### ##### # ### ##### #
#   # #. . .    #   # #   # #. . .# #. .#
# ### # ####### ### ### # # ####### # # #
#     #       #   #     # #       # #.# #
# ######### ### ######### ####### # # ###
#       # #   #   #     #       #   #. .#
####### # ### ### # ########### ####### #
#     #   #   #   # #   #   #   #  . . .#
### # ##### ####### # ### ### # # # # # #
#   # #     #   #     #   #   # # #.# # #
# ### ### ### # # ##### ### # ### # ### #
# # #   #     #       # #   # #   #.#   #
# # ### ############# # ### ### ### # # #
#   #. .#  . . .#   # #   #   # #. .# # #
##### # ### ### ### ##### ##### # ### ###
 . . .#. . .# #. .#     #     # #. .#   #
######### # # ### ##### ##### # # # ### #
#   #   # # #    . . . .#   #   # #.# # #
# ### # # # ########### # # ##### # # # #
#     # # # #   #     #.# #       #.#   #
####### ### # # # ##### ########### #####
# #   #     # # #      . . . . . .#. .  #
# ### ######### ######### # ##### ### # #
#       #           #     # #   #. .#.# #
####### ### ####### # ##### ### ### # # #
#           #       #   #   # # #  . .# #
############# ##### ##### # # # ##### # #
#       #     #   #       # #     #   # #
# ####### ##### # ####### ####### # ### #
#   #     #     #     #   #   #   # #   #
### # ##### ######### # ### # # ### # ###
# #   #       #     #   #   # # #   #   #
# ######### # ##### ##### ### # ####### #
#   #   #   # #   # #     #   #         #
### ### ##### # ### # ####### ######### #
#             #       #                 #
#########################################
