##### ######### #########################
#    . .      #.#   #         #         #
# ##### ####### ### ######### # ####### #
# #  . .#. . . .#   #     # # # # #   # #
# ### # # ####### ### ### # # # # # # # #
# #. .# #. .#   # #   #     # # # # #   #
# # # # ### ### # # ####### # # # # #####
# #.# #   #. . .#   #     #   # #   #   #
# # # ### ##### ##### ####### # ##### # #
# #.#   # #   #. .# # #   #   # #     # #
# # ### # # # ### # # # # ### # # ##### #
# #. .# # # #    . . .# #   # # # # #   #
# # # # # # ######### ##### # # # # #####
# # #.# # # #   #   #. .#. . .  #       #
# ### # # ### # # # ### # ### ##### #####
#   #.# # #   # # # # #. .# #.#     #   #
### # # # # ### # # # ##### # # ##### # #
# # #.# # #   # # # #. . . . .# #     # #
# # # # # ##### # # # ######### # ##### #
#   #.# #       # # #.#       # #     # #
##### # ########### # # ####### ####### #
#. . .#         #   #.#   #       #     #
# ### ######### # ### ### # ####### #####
#.#   #. . . .# #. .#. .# # #           #
# ##### ##### ### # ### # # # ######### #
#.#. . .#   #. . .#.  #. .  #         # #
# # ##### ####### # ##### ### # ##### ###
#.#. . . .#     # #. . . .    #   # #   #
# ####### # ### ### ########### # # ### #
#.  #   #.#   #   # #   #   #   # # #   #
# # # # # ####### # ### # # # # # # # # #
#.# # # #.#. . .# #     # # # # #   # # #
# # ### # # ### # ######### # ####### ###
#.#     #. .# #.  #   #   #   #     #   #
# ########### # ### ### # ##### ### ### #
#. .  # #. . . .#       #       # # # # #
# # # # # ####### ############# # # # # #
# #.# #. .  #     #     # #   # # # #   #
# # ### ##### ##### ### # ### # # # #####
# #. . .              #   #     #       #
#########################################
