############### #########################
#         #    .  #. . . .      #       #
# ######### ### ### ##### ### # # ##### #
#   #       #  . .#.    #.  # # #   # # #
### ##### ### ### # ##### # # ##### # # #
# # #     #   #. .#.#. . .# #     # # # #
# # # ######### ### # # ######### ### # #
#   # #       #.#. .#.# #. . .  #     # #
# ### ####### # # ### ### ### # # ##### #
# # #         #. .  #. .#.# #.# #       #
# # ################# # # # # ######### #
#  . . .#    . . . .# #. .  #. .      # #
### ### ##### ##### # ######### ##### # #
 . .#  . . .#.#  . .# #. . . .#. .  # # #
########### # ### ##### ##### ### # # # #
#     #    . .#  . . . .#    . . .# # # #
# ### # ### ### ### ############### # ###
# # #   #   #   #   #     #     #   #   #
# # ##### ### ### ### ### # ### # ##### #
# #       #   # #   # # #   # #   #     #
# ######### ### ### # # ##### ##### # # #
#     #     # # #   # # #         # # # #
##### # # ### # ##### # # ### ### # # # #
#     # #   # #       #   #   #     # # #
# ### # ### # ##### ####### # ### ### # #
# #   # # # # #   # #       #   # #   # #
# ##### # # # # # ### ####### # ### ### #
#     #   # #   #     #     # #   # #   #
##### ##### ### ######### # # ####### # #
# #   #       # #         # # #   #   # #
# ##### ### # # # ######### # # ### # # #
# # #   # # # # # # #     # #   #   # # #
# # ### # # # # # # # ### # ##### ### # #
# # #   #   # # #   #   # # #     #   # #
# # # # ### # ######### # # # ### # ### #
#     # # # #     #   # #     #   # # # #
####### # # ### ### # ############# # # #
#     # # #   #     #     #         # # #
# ##### # ### # ######### ########### # #
#       #     #         #             # #
#########################################
