##################### ###################
#   #   #            . . . .#. . . . .  #
# # # # # ### ### ### # ### # ####### ###
# # # # # # # #   #   #   #. .      #. .#
# # # # # # # # ### # ### # ######### # #
# # # # #   # # #   # # # # #. . . .# #.#
# ### ####### ### ### # # ### ##### # # #
#             #   #   #   #. .#   #.# #.#
####### ### ### ### ####### # # ### ### #
# #   # #   #   # # #    . .# #   #. .#.#
# # # ### # # ### # ##### ####### ### # #
#   #   # # #     #     #. . . .# # #. .#
# ##### # # ####### # # # ##### # # # # #
#   #   # #   #   # # # # # #. .# #   # #
### ##### # ### # # ### # # # # # ##### #
# #       #     # # #   # # #.# #       #
# ### ### # ##### ### # # # # ###########
#   # #   #   #   #   # #   #. . .  #. . 
### # # ##### # ### ######### ### ### ###
# # # # #     # #     #     #   #. . .# #
# # ### # ##### ### # # ##### # # ### # #
# #   # # # #   #   # #     # # #   #   #
# ### ### # ### # ### ##### # # ### #####
#   # #   #   # # #     # # # #   #     #
### # # ##### ### # # ### # # # ### ### #
#   # #     #   # # #     # # #   # # # #
# # # # # ##### # # # ##### # ### # # # #
# # # # #   #   # # #   # # #   # # #   #
### # ##### # ### # ### # # ##### # #####
# # #     #   #   # # #   #       #     #
# # ##### ##### # # # ######### # ### # #
# #         #   # # #     #     # #   # #
# ##### ### # ### # ##### # ##### # ### #
# #     #     #   #     #   #   # # # # #
# # ##### ### # # # ### ##### # # # # # #
# # #   #   # # # #   # #     # # # #   #
# ### # ##### # # ##### # ##### ### #####
# #   #   #   # # #   # # #   #   #     #
# # ##### # ### ### # # # ### ######### #
#   #       #       # #   #             #
#########################################
