##################### ###################
#       #            .          #. . .  #
# ##### # ####### ### ########### ### # #
#     # # #       #  . .#. . . . .  #.# #
##### ### ##### ### # # # ######### # # #
#         #     #   # #. .#       # #.# #
########### # ### ### # # # ##### ### # #
#           # #   # # # #   #   # #. .# #
# ##### ####### # # # # ##### ### # #####
# #     #   #   # #   #   #     # #. . .#
# # # # # ### # ####### # # ### ### # # #
# # # # #   # # #     # #     #   # # #.#
# # # # ### # ### ### # ######### # ### #
# # # # #     #     # # #       # # #. .#
### # # ####### ##### ### ####### # # # #
#   # # #       #     #   #       # #.# #
# ### # # ####### ##### ### ######### # #
#   # #     #     #     #   #      . .# #
# # # ############### ### ### ##### # # #
# # # #               #   # # #   #.# # #
# # # ############### # # # # # ### ### #
# # #     #     #   # # # # #   #. .#   #
# ##### # # ##### # # ### # ##### ### ###
# #     #   #     # # #   #  . . .#   # #
# # # ####### ##### # ####### ##### # # #
# # # #     #   #   #        . .#   # # #
# # ### ### ### ############# # ####### #
# #       #   #   #           #. . .    #
# # ####### ##### ### ##### ### ### #####
# #       #     # #   #     #   #. .    #
# ####### ### ### # ### ######### # #####
#       #   #   #   #   #  . . . .# #   #
### ####### ######### ##### # # ### # # #
# #     #   #     #   #  . .# # #   # # #
# ##### ##### ### # # ### ##### # # # # #
#     #         # # #   #.# #   # # # # #
##### ########### # ### # # # ### ### # #
#   #         #   #   # #.# # # #   # # #
# # ######### ######### # # # # # # ### #
# #                     #.#   #   #     #
######################### ###############
