### #####################################
#  . . . . .    #     #           #     #
# # # ##### ### # ### ########### ##### #
# # # #   #.#   # # # #       # #. .    #
# # ### ### # ### # # # ### ### # # #####
# #     #. .#       #   # #     #.#. . . 
# ####### # ########### # ####### #######
#   #  . .# #. . .    # # #   #. .#     #
# # # # ##### ### ### ### # ### ####### #
# # # #. . .#.# #.  #     #    .# #     #
# # ### ### # # # ############# # # #####
# #   #   #.#.  #. . . . .    #.# # #   #
### # ### # # ########### ### # # # ### #
# # #   # #.#.          #. .# #. .#     #
# ### # ### # ######### ### # ### ##### #
#   # #   #. .        #   #.#   #.#     #
### ##### # ####### ##### # ### # # #####
#       # #       #   #   #. .# #.#   # #
####### # ##### # ### ####### ### ### # #
#   #     #   # #   #       #. .#.#   # #
# # ### # ### # ### # ##### # # # # ### #
# #   # #     # #   #   #   # #. .  #   #
# ### ######### # ####### # # ### ### ###
# #             #   #   # # #   #   #   #
# ####### ##### ##### # # # # # ##### # #
#       # #     #     #   # # #   #   # #
# ######### ##### ##### # # ##### # ### #
#       #   #       #   # #   # #     # #
####### # ########### ### # # # # ##### #
# # # # #       #     #   # #   #   #   #
# # # # ####### # ##### ########### # ###
# # # #       # #   #         #     #   #
# # # ######### ### ### ##### ####### # #
# #   #           #   #     #       # # #
# ### ##### # # # # # ######### ### # # #
#           # # # # #   #     #   # # # #
############# # # ##### ### # ### # # # #
#   #         # #   # #   # #   # # # # #
# # ########### ### # # # ##### ### # # #
# #               #   # #     #     # # #
#########################################
