################################# #######
#   #   #               #        . . . .#
# # # ### ##### ####### # ##### ####### #
# #   #   #         # #   #     #     #.#
# ##### # # ### # # # ##### # ### ##### #
#       # # #   # # # #     #     #. . .#
####### ### ####### # # ########### ### #
#       #   #     # # # # #     #  . .# #
# ####### ### ### # # # # # ##### # # # #
# #           # # #   # #         # #.# #
# # ####### ### # # # # ########### # # #
# # #     #     # # # #   # #       #.# #
# ### ### ####### # ##### # # ### ### ###
# #     # #       #   #   # #   #   #. .#
# # ##### # # ####### # # # ### ### ### #
# # # #   # # # #   # # # #     #   #. .#
# # # ####### # # ##### ######### ### # #
# # #         # # #     #         #  .# #
# # ########### # ### # # ####### # # ###
# # #         #     # # #   #     # #. .#
# # ### ##### ##### # # ### # ##### # # #
# #     #   #         #   # # # #   # #.#
######### ############### # # # # ##### #
#       #   #           # # # #   #. . .#
# ####### # # ######### ### # ##### ### #
#         # #     #   #   # #     #. .# #
# ########### # # # # ### # ##### # # ###
#   #     #   # #   #   # #     # # #. .#
### ### # ############### ####### ##### #
# #     #               #       #     #.#
# ##### ############# # ##### # ##### # #
#   #   #             #       #     # #.#
### # ### ### ##### ############### ### #
# # # #   #   # #   #      . . .# #  . .#
# # # # ### # # # ### ##### ### # ### # #
# # # # # # # # # #   #. . .#  . .#. .# #
# # # # # # # # # # ### ######### # ### #
# # # # #   # #   # # #.# #   #  .#.# # #
# # ### ##### ##### # # # # # ### # # # #
#       #         #   #.#   #    . .#   #
####################### #################
