########### #############################
#          .#. . . .  #             #   #
# ##### ### # ##### # # # ####### # ### #
#   #   # #.#.#. .#.#   #       # #     #
# # # # # # # # # # ######### # ### #####
# # # # # #.#. .#.#. . .  #   #   # #   #
### # ### # ##### ##### # # # ### ### # #
#   # #   #. . . .  #. .# # #   #   # # #
# ### # ### # ####### ##### ####### # # #
# # #     # #   #   #.#     #   #   # # #
# # # # ### ### ### # ####### # ####### #
# #   # #   # #   # #. .      #       # #
# ####### # # # # # # # ######### ### # #
# #       # # # #   # #.    #       #   #
# # # # # ### # ####### ##### # # ### ###
# # # # # #   # #    . .  #   # #   #   #
# ### ### # ##### ### ##### # # ### ### #
#   #   # #       #. .#     # # # #   # #
### # # # ######### # # ### ### # ### # #
#   # # #   #  . . .# # #   #   # #   # #
# ##### ##### # ##### # # ### ### # # # #
#     #   #   #.#   # # # # # #   # # # #
##### ### # ### # ### # # # # # ### ### #
# #   #   # #. .# #   # # # #   #     # #
# ##### ### # # # # ### # # ######### # #
#   #   #   #.# #   #   # #         # # #
### ### # ### # ##### ### ##### ##### ###
# #     # #. .# #     # #   # # #   #   #
# ######### # # ##### # ### # # # # ### #
# #      . .# #   #   #     #   # #   # #
# # ##### ### ### ########### ### ### # #
#   #    . .#   #     #         # # #   #
# # # ### # ### ### ### ####### # # # # #
# # # #   #. .#   #     #     # # # # # #
### # # ##### ### ### # # ### # ### ### #
#   # #     #. .#   # # # #   #   # #   #
# ### ######### ### # ### ####### # # # #
# #   #       #.#   # #   #     # # # # #
# # ### ##### # # ##### ### ##### # # # #
# #     #     #.#         #       #   # #
############### #########################
