##### ################### ###############
#    .  #. . . . . .    #.#       #   # #
##### ### ######### ##### # ##### # # # #
#. . .#. .        #.#. .#.#     # # #   #
# ### # ########### # # # ##### # # ### #
#.#   #. .#. . . . .#.#.#. . .# # #   # #
# ####### # ####### # # ##### # # ##### #
#. .  #. .#.#       #.#. .  #.# # #     #
# # ### ### ######### ### ### ### # #####
# #. . .  #. .      #.  #. . .    #     #
# # ######### ####### ### ######### #####
# # #       #.  #. . .  #     #         #
# # # ##### # ### ##### ####### ### ### #
# #   #   # #.#. .    # #         # #   #
# ##### ### # # ##### ### ######### #####
#     #   # #.#.#   #     #       #     #
# # # ### # # # # # ####### ##### # # ###
# # # #   # #. .  #   #         # # #   #
# # # # ### # ##### # ##### # # # ##### #
# # # #     #   # # #     # # # #     # #
# # ########### # # ##### # # ######### #
# #     #     # # # #     # #     #     #
# ### # # ### # # # ####### ### # ##### #
#   # # # # #   # #       #   # #     # #
### # # # # ##### # ### ### ######### # #
#   # # # # #     #   #           #   # #
# ### # # # # ####### ########### # ### #
# #   # #   #   #   #         #   #   # #
# # # # ####### # ########### # ##### # #
# # # #     # #   #     # #   # #   # # #
# # ######### ### # ### # # ### # # # # #
# #               #   # # # #   # #   # #
# ##### ############# # # # ########### #
#     #               #   #       # # # #
# # # ######### ################# # # # #
# # #         #   #             # #   # #
# ######### # ### # ##### ####### ### # #
#   #     # # # #   #     #     #     # #
# # # ##### # # ##### ##### ### ####### #
# #   #     # #       #     #           #
#########################################
