############################### #########
#  . .#. . .#      . . . . .#  .        #
### # # ### # ##### ####### ### ### ### #
#. .#.#.# #.#     #. .#    . . .#     # #
# ### # # # ####### # ######### # ### # #
#.# #.#.#  . . . .# #.#         # #   # #
# # # # ######### ### # ######### ##### #
#.#  . .#   #    . .#.#     #     # #   #
# ####### # ####### # ####### ### # # # #
#.  #     # #     #. .#       #   # # # #
# ### ##### # ### # # # ### # ##### # # #
#. .# #   # # # # # # #   # # #     # # #
# # ### # # # # # # # # # ### # ##### # #
# #. . .# #   #   # # # #   # #   #   # #
####### # ####### ### # ### # ### ##### #
 . . .#.# #     #     #   # #   #   #   #
##### # # ##### ### ####### ####### ### #
#    . .#     #     #     #       #     #
# ### # # ### ####### ### # # ###########
# #   # #   #         # # # #       #   #
### ### ##### ######### # # ######### ###
#   #       #         # # #   #     #   #
# ### # ### ######### # # # ### ### ### #
# #   #   #         #   # #       # #   #
# ####### # # # ######### ### ##### # ###
#     # # # # #   #         #     #     #
# ### # # # ### # # ##### # ##### # ### #
#   # # # # #   # #   #   #     # #   # #
##### # # # # # # ### ####### # # ### ###
#     #   # # # #   #       # # #   #   #
# ########### ############# # ### ##### #
# #     # #   #     #     # #   #   # # #
# # ### # # ### ######### # ### ### # # #
#     #   # #   #         # #   #   # # #
########### # ### ######### # # ##### # #
# #     #         #         # # #     # #
# # ### # # # ########### ### # # ##### #
#   #     # # # #         #   # # #   # #
########### # # ### ##### # ##### # ### #
#           # #     #     #       #     #
#########################################
