####################################### #
#     #         #               #    . .#
# ### # ####### ### ######### # # # # # #
# # # # #           # #       # # # #.# #
### # # # ########### # ### ### ### # ###
#   #   # # #         # #   #       #. .#
# ##### # # # ### ### ### ######### # # #
#       # # # #   #       #         # #.#
######### # # # ####### ### ######### # #
# #     #   # # #   #   #   #         #.#
# # ### ##### # # # # ### ### ######### #
# # #   #     # # # #   # # #         #.#
# # ##### ####### # ##### # # # ##### # #
#     #   #   #   #       #   # #   # #.#
##### # ##### # ######### ##### # # # # #
#   #   #   # #   #     #     # # # # #.#
# ##### # # # ### # ### ####### # # # # #
# #     # # #   # # #   #       # # # #.#
# # ##### # ### ##### ### # ##### ### # #
# #     # #   #     #   # # #     #   #.#
# ##### # ### ##### # ### ### ####### # #
#       #   #     # # # # #   #       #.#
########### ##### # # # # # ### # ##### #
# #       #     #       #   #   # #    .#
# # ##### ####### ######### ##### # ### #
#       # #     # #       # #     # #  .#
# ####### # ### # ####### ### ##### ### #
# #   #   # #   #   #   #     #     #. .#
# # # # ### ####### ### ####### ##### # #
# # # #   #   #   #   #     #   #. . .# #
# ### ####### ### ### # ### # ### ### # #
#   #           #       #   # # #.#   # #
### ### ####### ########### # # # ##### #
#       #     # #         # #   #. . .# #
# ######### # # # ####### # ##### ### # #
# # #     # # #   #     # #     #   #.# #
# # # ### # ### ####### # ##### ### # ###
# # # #   #   # #  . . .#    . . .# #. .#
# # # ####### ### # ### ##### ### ##### #
#   #             #.#  . . . .#  . . . .#
################### #####################
