############################### #########
#   #                 #      . .#. .    #
# ### ####### ### ### ### ### ### # #####
#     #       # # # # #   #  . . .#. . .#
### # # ### ### # # # # # # # ######### #
#   # # #   #   # #   # # # #     #   #.#
##### # # # # ### ### # # # ##### # # # #
#   # # # #   #     #   # #   # #   # #.#
# # ### ### ##### # ##### # # # ####### #
# #   #   # #     #   #   # # # #    . .#
# ### # # # # ##### # # ##### # # ### # #
#   # # # # #     # # # #   # #   #  .# #
### ##### # ### # # # # ### # ##### # ###
# # #     #   # # # # #     #     # #. .#
# # ### # ### # # ### ####### ##### ### #
#       # #   # #   # #   #     #   # #.#
########### ####### # # # ### # # ### # #
#     #     #       # # #     # #   # #.#
# ##### ####### ####### ########### # # #
# #     # #   #   #   #   #     # # # #.#
# # ##### # # ### ### # # # ### # # # # #
# #       # #   #     # # # # #   #   #.#
# ######### ############# # # ######### #
#         #               #   #  . . . .#
# ####### # ########### # ### # # # #####
# #   # # # #       #   # #     #.# #. . 
# ### # # ### ##### ### # # ##### ### ###
# #   #       #   #     # #   #  . .#. .#
# # ############# ####### ##### ### ### #
# # #             #       #     #. .  #.#
# # # ##### ##### # ##### # ##### ##### #
# #   #     #     # #   # #   #  . . .#.#
# ####### # ##### ### # # # # ### # # # #
# #       # #   #     #   # #   # # #. .#
# ##### ##### # ##### ##### ### # #######
# #   # #     #   #   #     #   #       #
# # ### # ####### # ### ##### ###########
# #     # #   #   # #   # #   #     #   #
# ####### # # ### ### # # # # # ### ### #
#   #     # #         # #   #     #     #
#########################################
