######### ##################### #########
#      . .#. . . .    # #. .  #.#. .#   #
# ##### ### ##### ### # # # # # # # ### #
# #  . .#. .#   #. .# #. .#.# #. .#. .# #
# # # ### ### ##### ### ### ######### # #
# # #. . .  # #   #.#. .  #. .  #. . .# #
# # ######### # # # # ####### ### ##### #
# #           # # #. .  #   #. . .    # #
# ############# # # # ### ####### ### # #
#       #       # # #   #       #   #   #
# ### # # ####### # ### ####### ### #####
#   # #   # #   # #   # #     # # #     #
# # # # ### # # # # ### # ### # # ##### #
# # # #   #   # # #   #     # # #   #   #
# # # ### ##### # ### ####### # ### # # #
# # #   # #     #   #       #     # # # #
# # ### ### ######### ### # ##### # # # #
# #   #     #       # #   #     # # # # #
# ### ####### ####### # # ##### ### # ###
# # # #             # # # #   #     #   #
# # # # ########### ### # # # ######### #
#   # # #               # # #           #
##### ### ######### ### # # ########### #
#     #   #     #   #   # # #         # #
# ### # ### ### ##### ### ### ####### # #
# #   # #   # #       #     # #     # # #
# # # # ### # ########### # # # ### ### #
# # # # #   # # #       # # #   # # #   #
# # # ### ### # # ##### ### ##### # # # #
# # #   #     # #   # #     #   #     # #
# ### # ####### ### # ### # ### ####### #
# # # #         # # #     #     #     # #
# # ####### ### # # ########### # ##### #
# #       #   #   #           # # #     #
# ####### ### ############# # # # # ### #
#   #   # # # #   #       # # # # # #   #
# # # # # # # # # ####### # # ### # #####
# #   #   # #   #         # #   # #     #
# ######### ################### # ##### #
#         #                     #       #
#########################################
