######################### ###############
# #              . .# #  . .            #
# # ### ######### # # # ### ##### # ### #
#   #   #    . . .#. .#   #.#   # # # # #
##### ### ### ####### ### # ### ### # # #
#     #   #  .#     #. .# #. .#     #   #
##### ####### ##### ### # ### ### #######
#     #. . . .#   #   #.#   #.  # #     #
# ##### ##### # # ### # ### # # ### #####
# # #. .#     # #   # #. .# #.#   #   # #
# # # ### ##### ### # ### ### ### ### # #
#   #.#   #   # #   #    . . .  #   #   #
##### ##### ### ### ######### # ### ### #
#. . .#. . .  #   #       #   #   #   # #
# ### # ### # ### ####### # # ### ### # #
#.#   #. .#.#   #   #   #   #   #   # # #
# ####### # ### ### ### ### ####### # # #
#. . .  #.#. .#   #   # #   #       # # #
# # # ### ### ### ### # ####### ##### # #
# # #. . .  #. .#   # #         #       #
# # ########### ### ######### # # ### # #
# #         # #.  #   #       # # #   # #
# ######### # # ##### ######### # ### # #
#         #   #.#   # #   #     # #   # #
######### ##### # ### # # # ##### # ### #
#     #   #  . .# #   # #   #     # # # #
# ##### ##### # # # # # ####### ### # # #
# #     #   #.# #   # # #   #   # # # # #
# ### ##### # # # ##### # ### ### # # # #
#   # #     #.# # #     #   # #   # #   #
### # # ##### # # # # # ### # # ### #####
 . .#   #. . .# # # # #   # #   # #     #
### ##### # ### # # ####### ##### # # # #
# #. . . .# #   # #       # #     # # # #
# ####### ### # # # ### # # # ##### # ###
#         #   # # #   # # # #       #   #
########### ### # ### ### # ########### #
#       #   #   #   # #   #           # #
# ##### # # # ##### ################# # #
#     #   # #     #                 #   #
#########################################
