################# ##################### #
#           #   #.#   #     #          .#
# ##### ### ### # # ### ### # ######### #
# #   # #     #  .#   #   # # #    . .#.#
### # # ##### ### ### ### ### ##### # # #
#   # #   # #   #. . .# #     #. . .#. .#
# ####### # ### ##### # ####### ##### # #
# #   #   #          . .#  . . .#     # #
# # # # ############### # # ########### #
# # #   #       #   # #.# #.#. . . . .# #
# # # ### ##### # # # # # # # ##### # ###
# # # #   #   # # # #. .# #.#.#. .# #. .#
# ### # ### # # # # # ### # # # # ##### #
#   # # #   #   # # #.#   #. .#.#. . .#.#
### # # # # ### # # # ####### # ##### # #
#   # # # # # # # #  . . . .# #.#    . .#
# ##### # # # # ########### ### # ##### #
# #     # # #              . . .# #   # #
# # ####### ################# ### # # # #
# #       # #     #           #   # #   #
# ####### # # ##### ########### ### ### #
# #     # # # #     #   #     #   # #   #
# ##### ### # # ####### ##### ##### # # #
#           # #         #           # # #
######### # # ########### ####### # # ###
#     #   # # #       #   #     # # #   #
# ### # ### # ####### # # # ### ### # # #
# # # # #   #     # # # # #   #     # # #
# # # ### ####### # # ### ### ######### #
# #       #     # #         # # #       #
# ####### ##### # ### ### ### # # ##### #
#   #   # #   #       #   #   # # #     #
# # ### # # ########### ### ### # #######
# #   #   #     #       #       #       #
# ### ######### # ### ##### # ### # #####
# # #       #   # #   #   # #   # #     #
# # # ### # # ### # ##### # ##### # ### #
# # #   # # # #   #       # #     #   # #
# # ### # # # ############### ######### #
#   #   # # #                 #         #
#########################################
