##################################### ###
#     # #       #               #  . .  #
# # ### # ##### # ####### ##### # # ### #
# #     #   #   # #       #. . .# #.#   #
# ######### # # ### ####### ### # # #####
#     #     # #     #   #  . .#.# #. .  #
##### ### ### ### ##### # ### # ##### # #
#         #     # #   # # #. .#. .#. .# #
# ########### # ### ### # # ##### # ### #
# #       #   #     #. .# #.#    . .#   #
### ####### ### ##### # # # ######### # #
#   #       #   #  . .#.# #.#. .#     # #
# ### ### ### ### # ### ### # # #########
# #   #   #   #   #.# #. . .#.#. . . .  #
# ### # ### ### ### # ### # # ####### # #
#   # # #   #   #  .#     # #. . .  #.# #
### # # # ### ##### ####### ##### ### # #
#     # # #   #   #. . . .# #  . .#. .# #
# ####### # ##### # ### # # ### ### ### #
# #   #   # #     #   # #.#   #.# #. .# #
# # ### ### # ### ### # # ### # # ### # #
# #     #       #   # # #.#   #.#   #.# #
# ##### ### # # ##### # # ##### ### # # #
# #     #   # #   #   # #. . . .    #.# #
# ####### # # ### # ### ##### ####### # #
#   #     # # # # #   #     #     #  .# #
### # # # ### # # ### ##### ##### # # # #
# # # # # #   # #   #   # #   # # # #.# #
# # # # # # ### # # # # # # # # # ### # #
#   # # # # #   # # # # # # # # # #. .# #
####### # # # ### # ### # ### # # # #####
#   #   # #     # #   # #     #   #. . . 
# ### # # ####### ### # ########### # ###
# #   # # #     #   # #     #     # #   #
# # # ### # ### ##### # # ### ##### ### #
# # # #   #   # #     # # #       #   # #
# # ### ### ### # ####### # ######### ###
# #   #     #   # #   # #   # #     #   #
# ### ####### ### # # # # ### # ### ### #
#     #       #     #   #   #   #       #
#########################################
