########################### #############
#       #     #      . . . .  #. . . . .#
# ##### ### # ### ### ######### ####### #
#     #     #     #. .#. . . .#.      #.#
# ### ####### # ### # # ##### # ####### #
# # # #       # #  .# #.    #. .#. . .#.#
# # # ######### # # ### ##### ### ### # #
# # #     #     # #. . .#   #   #.#  . .#
# # # ##### # ### ####### # ### # ##### #
# # #   #   # #         # #   # #. . .# #
# # ### # ##### # # ### ### ### # ### # #
# #   # # #     # #   #     #   # # #.# #
# ### # # ####### ### ####### ### # # ###
#     # #   #   #   #       # #   # #. .#
# ### # # # # # ### ####### # # ### # # #
#   # # # #   #   #       # # #     # #.#
# # # # # ##### # ####### # # ####### # #
# # # # # #   # #   #   # # #     # # #.#
# # ### # ### # ### # ### # ### # # # # #
# #   # #     #   # #     #   # # #   #. 
# # # # ####### # ######### # ### #######
# # # # #       #     #   # #   # #     #
# # # # ######### ### # # ### # # # ### #
# # # #         #   # # #   # # #     # #
# # # # ####### ### ####### ### # # ### #
# # # # #     #   #   #         # # #   #
# ### # # ####### ### ######### # ### # #
# #   #   #         #       # # #   # # #
# # ######### # # ######### # # # # ### #
# #     # #   # #         # # # # # # # #
# ##### # # # # ######### # # # ### # # #
# #   # # # # # # #     # # # #   # # # #
### # # # ### # # # # # ### # ### # # ###
#   #   #   # # #   # #     #     # #   #
# ##### ### ### ##### ############# ### #
# #   # # # #   # #   #               # #
### # # # # # ### # ### ######### ##### #
#   # # # #   # #   #   #   #     #     #
# ##### # ### # ##### # # ### # ### #####
#       #     #       # #     #         #
#########################################
