##################################### ###
#        . . . . . .#      . . .#    . .#
### ##### # ####### ####### ### ####### #
#   #    .# #      . . . . .# #. .#. . .#
# ### ### ### ############### ### # # # #
#   #   #. .# #             #    . .# # #
# # ##### # ### ########### ####### # # #
# #     # #.#   #     #. .# #       # # #
# ##### ### # ### ##### # # # ####### # #
# #     #. .# #. . . . .#.# # # #. .# # #
# # ##### ##### ######### # # # # # # # #
# # #   #. . .#.      # #.# # #. .#.# # #
# # ### # # # # ##### # # # # # ### # # #
# #   # # # #. .    #   #.#   #.# #.# # #
# ### # # # ### # # ##### ##### # # # # #
#   # #   #   # # #     #.#. . .  #.# # #
### # ####### # # ##### # # ####### # # #
# # #   #     # #     # #. .#   #. .# # #
# # # # # ### # ####### ##### # # ##### #
# # # # #   # #       #       # #.#     #
# # # ##### # # ##### # # # ### # #######
#   #     # # # #     # # #   # #. . . . 
########### # ### ### # # ### # ### #####
# #     #   # #   #   # #   # #   #     #
# # ### # # ### ### ### # ### ### ##### #
# # #     # #   #   #   #   # # #   # # #
# # # ##### # # ##### # ### # # # # # # #
#   # #     # # #     #   # #   # #   # #
# ### # ##### # # ####### # ##### ##### #
# #   #     # # #   #   # #     #   #   #
### # ####### # ### ### ### ######### # #
#   # #       #   #   #     #         # #
# # ### # ### ##### # ####### ### ##### #
# # #   # # # #   # #   # #   #   #   # #
# ### ### # # ### ### # # # ### ##### # #
# #   #   #   # #   # # # #   #   #   # #
# # ##### ##### ### ### # ### # # # ### #
# # #   #   #   # #     #     # # # #   #
# ### # ####### # ############### # ### #
#     #         #                 #     #
#########################################
