########################### #############
#           #              . .          #
# ##### ### ### # # ### ##### ### ##### #
# #   #   #   # # # #   #   #.# #     # #
# # ##### ### # # ### ### # # # ### # ###
#   #   #   # # #   # #   # #.#   # #   #
# ### # ### # # # # ### ### # ### ### # #
# #   # #   # # # #       # #. .#   # # #
# # ### ### ### ########### # # ### ### #
# #   #   # #   #   #     # # #.  #     #
# ####### ### ### # # ### # # # # ##### #
# #   # #     #   #   # # # # #.#   #   #
# # # # ######### ##### # # ### ### #####
# # #       #     #    . .#   #.  #     #
# ######### # ######### # ##### ####### #
#         #   #    . . .#. .#. .#   #   #
######### ######### ####### # # # ### # #
#    . . .#    . . .#      . .# #     # #
##### ### ##### # ### ####### # ####### #
#. . .#  . . . .# #   #       # # #     #
# # ####### ####### ### # ##### # # # # #
#.# #. . .# #   #   #   # # #   #   # # #
# ### ### # # ### ### ### # # # ### ### #
#. . .  #.# #     #   #   # # # #   #   #
##### ### # # # ### ##### # # # ##### ###
 . .# #. .# # # #   #     # # #     #   #
### ### ### ### # ### # ### # ### ##### #
# #. .#.# # #   # # # #   # #   #   #   #
# ### # # # # ### # # ### # # # ### #####
# #  . .#   # #   # #   # # # #   #     #
# # # # ##### # ### ##### # # ### ### ###
#   # # # #   #   #     #   #   #   #   #
####### # # ####### ### ##### # ### ### #
#     # # # #   # #   #     # #   # #   #
# ### # # # # ### ### ### # ##### ### # #
# #     #   #       # # # #       #   # #
# ##### ##### ####### # # # ####### ### #
#     # #     # #     # # # #     # # # #
# ### ### ##### # ##### # ### ### # # # #
#   #           #       # #   #     #   #
#########################################
