########### ############### #############
#          . .  #     #   #.      #     #
######### ### # # ### # ### ##### # ### #
#     #     #.#   # #   #. .# # #     # #
# ### # ### # ### # ##### ### # ##### # #
# #   # #   #.  # # #   #.#   #   # # # #
# ####### ### # ### # ### # ##### # # # #
#         #. .#     #. . .# #   # # # # #
##### ##### # ####### ##### # ### # # # #
#     #    .# #. . . .  #   # #   #   # #
# ##### ### # # ######### ### # ####### #
# #     #  .# #.#     #   # # # #       #
# # # ##### # # # ### # ### # # # ### ###
# # # #   #.# #.# #. .#       # #   #   #
# # # # # # ### ### # ####### # ####### #
# # # # # #. .#.#. .#. . .  # # #       #
# # ### # # # # # ####### ### # # ##### #
# #     # # #.#. .#   #. .#     # #     #
# # ##### # # ##### ### ### #############
# # #     # #. . . . . .#   #       #   #
# # # # # # ##### # ##### ######### # # #
# # # # # # #   # #               # # # #
# ### # # # ### # ############### # ### #
# #   # # # #   #               #   # # #
# ####### # # ######### ##### ####### # #
#   #   # # # #       #     #     #     #
# # ### # # # ####### # ### ### # ##### #
# #   #   # #         #   # #   #     # #
# ### ##### ### ######### ### ####### # #
#   #   #       #     # #   #     #   # #
### ### # # # ### ### # # # ##### ##### #
# #   # # # #       #   # #     # #     #
# ##### # # ############# # # # # # #####
#       # #   #           # # # #   #   #
### ##### # ### ############# # ### # ###
#   #     #   #   #     #     #   # #   #
### # ####### ######### # # # ### ##### #
# # #       #         #   # #   #   #   #
# ################### ### # ### ### # ###
#                     #   #   #   #     #
#########################################
