########################### #############
#                   #      . . . . .    #
# # ######### ##### # ### # ### # # ### #
# #   #       # #     #   #   # # #.  # #
##### # ### # # # # ######### # # # ### #
#     # # # # # # # #       # # # #.#   #
# ##### # # # # # # # ##### # # # # # # #
# #     #   # #   # #     # # # # #.# # #
# # ### ##### ##### ##### # # # ### # ###
# # # # #   #   #   #     # # # #. .#   #
# # # # # # ### # ####### ### ### # ### #
# #   #   #   # # # #         #. .# #   #
# ############# # # # ##### ### # ### ###
#     #       # # # # #     #  .# #   # #
####### ##### ### # # ### ### # # # ### #
#       #         #   #   #   #.# #   # #
### # ### ############# ### ### # ### # #
#   # #   #       #   # #   #  .#   #   #
# ### # ### ##### # ### ### # # ### #####
# #   #   #   # # # #   #   # #. .#     #
# ########### # # # # ### ### # # ##### #
#   #       # # # # # # # #   # #. .  # #
# ### ##### # # # # # # # ##### ### ### #
# #   #       # # # #   #     #   #. .# #
### ####### ### # # ######### ####### # #
#   #     # #   #             #. . . .# #
######### ### ##### ########### # ##### #
#       # #   #     #          .# #     #
# ##### # # ##### ### # ####### # # #####
#   #   # #       #   # #  . . .# # #   #
##### ### ########### ### # ##### # # # #
#   # # #   #       #   # #.#     # # # #
# # # # ### ##### # ### # # ####### # # #
# #       #     # #   # # #. .#   # # # #
######### ##### # ##### # ### # ### # ###
#   #   #     # # #     #   #.#     #. . 
# # # # ##### # # ### ##### # ####### ###
# # # #       #       # #   #.    #. .# #
# # ######### ####### # # ### ##### ### #
# #                   #   #  . . . .    #
#########################################
