############# ###########################
#   #   # #  . . . . . . . .        #   #
# # # # # # # # ### ####### ##### ### # #
# # # #   # # #   #     # #. .  #   # # #
# # # ##### # ### ##### # # # ##### ### #
# # # #     #   #     #   # #. .#   #   #
# ### # # # # ##### # ##### # # ##### ###
#       # # #     # # #   # # #.#. . .  #
# ### # ### # # ### # # ### # # # ### # #
# #   # #   # #   # # # #   # #. .  #.# #
### ### # ####### # # # # ####### ### # #
#   # # #       # # #   #       # #. .# #
# ### # ####### # # ########### # # ### #
# #   # #     # # #       #     # #.#   #
# # ### # ### # # ##### ### ####### # # #
# # #   # #   # #     #   # #    . .# # #
# # # # # ##### # ####### # ##### ### # #
# # # # #   #   #     #   # #. . .# # # #
# # # ##### ### # ### ##### # ### # # ###
#   #       #   # # #   # # #.#   # #   #
############# # # # # # # # # # ### ### #
# #   #       # #   # # #   #.# #     # #
# # # # ##### ####### # ##### # ##### # #
# # # #   # #       # #   #. .#     #   #
# # ### # # # # ### # ### # ####### #####
# #   # # #   #   # # # # #. . . .# #. . 
# ### ### ######### # # # # # ### ### ###
# #     #     #     # #   # #   #. . .# #
# ##### ##### # ##### # ### ### # ##### #
#   #         # #     # #     # #       #
### ####### ### # # ##### ### # #########
# #       # #   # # #     #   # #       #
# ####### ### ### # # # ####### # ##### #
#   # # #     #   # # # #     #   # #   #
### # # ######### # # # # ### ##### # # #
#   # #           # # #     #     #   # #
# ### ####### # ### # # ####### # #######
#   # #       # #   # # #   # # #       #
### # # ######### ### ### # # ##### ### #
#       #         #       # #       #   #
#########################################
