################################# #######
#. .#     #  . . . . . . . .#. . .  #   #
# # ##### # # ####### ##### # # # ### # #
#.#. . .#   #.#   #   #    . .# #   # # #
# ##### ##### # # ##### ####### # # # ###
#.#    . . . .# # #     #     # # # #   #
# # ########### # # ####### ### # # ### #
#.# #. .#       #   # #         # #   # #
# ### # ########### # # ########### # # #
#. . .#. .    #     #   # #     # # # # #
# ####### ### ########### # ### # # # # #
#       #. .#           #   # #   # #   #
####### ### ######### ### ### ##### # ###
#     # # #.#       #   # # # #     #   #
# ### # # # # ####### # # # # # ####### #
# #   #   #.#       # # #     # #       #
# ######### ####### ### ##### # #########
#       #  . . .  #         # # #       #
####### ### # # ############# # # ##### #
#     #     # #.#. . .    #   # # # #   #
##### # ### # # # ### # ### ##### # # ###
#     # #   # #. .#. .# #     #   #   # #
# ####### ### ##### # # # ##### ####### #
#       #   # #   #.# #   #   #. . . . . 
####### ### # # ### # ##### # # #########
#         # #   #. .# #. . .# #.  #     #
######### ####### ##### ### ### ### ### #
#                .#. . .  #. . .      # #
# ##### # ####### # ######### ######### #
# #     # #  . . .#. .#     #     #     #
# ####### # # # ##### # ### ### ### ### #
#       # # #.# #. . .  # #   #   # #   #
# ##### # # # # # ####### # ##### # #####
#   #   # # #.# #.#   #   #   # # #     #
##### ### # # ### # # # ##### # # ##### #
#   # #   # #. . .  # #     # #   #   # #
# # # # ### ############### # ##### # # #
# #   #   #             #   #     # #   #
# ####### ########### ### ##### # # ### #
#       #           #     #     # #   # #
#########################################
