################### #####################
#              . . .#. . . .      #   # #
# # ########### # ### ##### ##### ### # #
# # #   #      .# #. .    #. . .#   # #. 
### # ### ##### # # ########### ### # # #
#   #     #. . .# #.  #       #.  #   #.#
# ######### ####### ### ##### # # ##### #
# #       #. . . . .#   #   # #.#   #. .#
# ####### # ### # ### ### # # # ### # ###
#         #   # #   #   # # # #. .# #.# #
# # ####### # # ##### ### ### # # # # # #
# #   #   # # #       #   #   # #.# #. .#
# ### ### ### ######### ### # # # ##### #
#   #   #   #           #   # # #. . .#.#
# # ### ### # # ######### ##### # ### # #
# #   #     # #     #   #   #   #   #. .#
# ### ### ### # ### # # ### # # ####### #
# # #   #   # #   # # #   # # # #     # #
# # ### ### # ##### ##### ### # # ### # #
# #     # # #     #         # # # # # # #
# ####### # ##### # ### ##### ### # # # #
# #     # # #   # #   #     #       # # #
# ##### # # # ### ### ### # ######### # #
#     # # #   #     #   # # #     #   # #
# ##### # ##### # # # # ### # ### # ### #
#     #   #     # # # # #   # #   # #   #
# ### ### # # ### ### # # ### # ### #####
# #     # # # # #   # # #     # #       #
### ### # ### # ### # ######### ### #####
#   # # #     #     #         #   # #   #
# ### # # ########### # ##### # # # # ###
#   #   # #       #   #   #   # # # #   #
# # ####### ### # ####### ####### # ### #
# #           # #     # #       # #   # #
### ######### ####### # # ### # # # ### #
#           # #   # #   #   # # # #     #
# ######### ### # # ######### # # #######
# #     #   #   # #       #   # #   #   #
# # ##### # # ### ####### # # # ##### # #
# #       # #   #           # #       # #
#########################################
