### #####################################
#  . . . .  #         #     #       #   #
# # ##### # ######### # ### # ##### ### #
# # #   #.# #       #   #   #     #   # #
# ### ### # # ### # ### ##### ##### # # #
# #   #. .#     # # #   #     #   # # # #
# # ### ##### ### ### ### ##### # # # # #
# # #. .#   # #   #   # # #   # # # #   #
# # # ##### ### ### ### # ### # # ##### #
# # #. . .#     # #. . .      # # #   # #
# # # ### ####### # ### ####### # # # ###
#   #   #. . . .  #.# #.        # # #   #
# ##### # ##### ### # # ######### ##### #
#   # # #     #.#. .  #. .      #       #
# # # # ##### # # ####### ###############
# #   #     # #.#.  #   #. . . .      # #
# ##### # # # # # ### # ####### ##### # #
#     # # # # #. .    #     # #.    # # #
####### ### # ############### # ### # # #
#       #   #       #         #.# # #   #
# ### ### ####### ### ######### # # #####
#   # #         # #   #. . . . .#   #   #
### ### ##### # # # ### ##### ####### ###
# #   # #     # # # #  .#     #. . . . . 
# ### # # ### ### # # # ####### ##### # #
# #   # #   # # #   # #. . . . .#   # # #
# # # # # # ### ##### # ########### # ###
# # # # # #         # #     #     # #   #
# # # # ##### ##### # ##### # ### # ### #
# # # #   # #     # #     #     #     # #
# # ##### # ##### ####### ############# #
# # #     # #   # #     #       #   #   #
# # # ### # # # # ##### # ### # # ### # #
#   #   # #   # #     # # # # # #     # #
# # # # ##### ### ### # # # # # #########
# # # #   #   #     # # #   # #         #
# # ##### # ### ##### # ##### ######### #
# #   # #   # # #   # # #     #   # # # #
# ### # # ### # # # ### # # ### # # # # #
#   #   #     #   #     # #     #   #   #
#########################################
