############# ###########################
#   #   # #  . . .      #   #   #   #   #
### # # # # # # # ### # ### # # # # # # #
#   # #   # # # #. .# #   #   # # # # # #
# ### ##### # # # # # ### ##### # # ### #
# #         # # # #.#   #     # # #     #
# # ######### # ### # # # ### # ####### #
# #   #       # #. .# # #   # #       # #
# ##### # ####### ### # ##### ##### ### #
#       # #    . .#   # #         # #   #
######### # ### # # ### # ######### # ###
#   #     # #. .# # # # #   #     # #   #
### # ##### # # ### # ##### ##### # # # #
#   # #     #.# #   #   # #     # # # # #
# ### # # ### ### ##### # ##### # # # # #
# #   # # # #. .#     #   # #   # # # # #
# # ### # # # # ##### ### # # ### # # ###
# # #   #   # #.  # #     #   #     #   #
# # # ######### # # ### ######### # ### #
# # # #      . .# #   #   #       #     #
# # # # ##### ### ### ### ############# #
#   # # # #  .#     #   #             # #
####### # # # ##### # ################# #
#       #   #. .  # # #           #     #
# ############# # ### # ######### # #####
# # #. . . . .#.# #   # # #     # #     #
# # # ####### # # # ### # # ### # ##### #
#   #. .#    . .# #. .    #   # #     # #
##### # # ####### # # ####### ### ### # #
#     #.# #. . .# #.#. .    #     #   # #
# ##### ### ### ### ### ############### #
# #  . .#. .  #. . .  #.#. . . .        #
# # # ### ### ######### # ##### #########
# # #. . .  #   #     #. .    #. . . .  #
# ######### ### # ### # ############# # #
#   #   # # #   # #   # #     #     #.# #
# # ### # # # ##### ### # ### ##### # ###
# #     # # #       # # #   #     # #. . 
# ####### # ######### # # ##### ### # ###
#       #             #       #     #   #
#########################################
