############################### #########
# #   #                . . . . .        #
# # # # # ######### # # ############### #
# # # # # #         # #. .#             #
# # # ### ### ####### # # ###############
# # # #   #   #       # #. . . . . . . .#
# # # # ### ### ### # # # ####### ##### #
# # # # #   #   #   # # # #     #     #.#
# # ### ### # ### # # # # # ### ##### # #
#   #   #   # #   # # # # #   #     # #.#
### # ### # # # ##### # ##### ##### # # #
#   # #   # # # #     #     # # #   # #.#
# ### # ##### # # ##### # ### # # ##### #
#   # # #   # # #     # #     # #   #. .#
# ### # ### # # ##### ### ##### ##### # #
# #   #   #   #     #   # #   #      .# #
# # ##### ##### # # ### ### # # ##### # #
# # #     #   # # #   # #   # # #    .# #
# # # ### ### # # ### # # ### # # ### ###
# # # # # #   # #   # # #   # # # #  . .#
# ### # # # ### ### # ##### # # # ### # #
#   # # # #     # # # #     # # # #   #.#
### # # ######### ### # ##### ### # ### #
# # # #     #         #   #       # #. .#
# # ####### ######### # ########### # ###
# #   #   # #         #   #         #. .#
# ### ### # # ### ######### ########### #
#       # # #   # #       # #  . . . .#.#
####### # # # # ### # ### # # # ##### # #
#     # #   # #   # #   #   # #.# #. .#.#
### # # ### ##### # ### # ### # # # ### #
#   # #   #       # #   # #   #.# #. . .#
# ### ### ########### # ### ### # ##### #
# # #       #   #     # #   #  .#     # #
# # ####### # ### ####### ### # ##### # #
# # #   # # #     #       #   #.  #   # #
# # # # # # ####### ########### # # ### #
# # # #   #   #     # #  . . . .# # #   #
# # # ####### # ### # # # ####### # ### #
#   #           #   #   #.#       #     #
######################### ###############
