############################# ###########
#       #              . .#. .          #
##### # # ### ######### # # #############
#   # # # #   #    . . .#. .#. .  #. . .#
# # # ### ### # ### ####### # # ### ### #
# # #     #   # #  . .#     #.#. . .#. .#
# ### ##### # # ##### ####### ####### # #
#   # #     # #     #. . .  #.#     #.# #
### ### # ######### # # # ### # ### # # #
#       #         # # # #. . .# #   #.# #
####### # ##### ### # ##### # ### ### # #
#     # # # #   #   # #   # # #   #  .# #
# ### ### # # # # ### # # # ### ### # # #
#   #   #   # # #   # # # #   # # # #.# #
# # ### ##### # # # ##### ### # # # # # #
# # # #       # # #     # # # # #   #.# #
### # ##### ### ##### ### # # # ##### # #
#   #       # #     #       #   #. . .# #
# ######### # ##### # # ##### ### # #####
#   #     # #       # #     # #  .# #. . 
# # # ### # ######### ##### # # # ### ###
# #     # #   #     #   # # # # #. .#.# #
# ##### # ### ##### ### # # ### ### # # #
#     # #   #     #     # #   # # #. .  #
# ### ### ##### # ####### ### # # #######
#   #   #   # # #         # # # #       #
####### ### # # ########### # # ####### #
#         #   #             # #     #   #
# ############# ### ######### ### ### ###
# #         #   # #         #   #     # #
# # ####### # ### # # # ### # # ### # # #
# #   #   # # #   # # #   # # #   # # # #
# ### ### # # # ### # ### # ### # # ### #
#     #   # # #   # # # # #   # # #     #
# ##### ### # # ### # # # ### # # #######
#       #   #   #   #   #   # # #     # #
############### # ######### # ### ### # #
#   #         # #     #     #   #   # # #
### ### ##### ####### # ####### # # ### #
#       #             # #       # #     #
#########################################
