##### ###################################
#    .            #       #         #   #
##### # ### # ##### ### # # ##### # # ###
#. . .#   # #       #   #   #   # # #   #
# ### # # ########### # ##### # # ##### #
#. .# # #   #     #   # #   # # #     # #
# # # # ### ##### # ### # ### # ### ### #
# #.# #   #     # #   #   #   # # #   # #
# # ##### ##### # # # ##### ### # ### # #
# #. .  #   #   # # #   #   #   #   #   #
# ### # # # ##### ##### # ### ##### #####
#   #.# # #           # #   # #   # #   #
##### # # ####### ### # ##### # ### # ###
#  . .# #     # #   # #     # #   # #   #
# # # # ##### # # # # # ##### ### # ### #
# #.# #     # # # # # # #   # #   #   # #
# # # ### ### # # ### # # ### ### ### # #
# #.#   #   #   # #   # #   # #   # #   #
# # ####### ##### # ### ### # ### # ### #
# #.#. . .#   #   # # #   # #   #   # # #
# # # ### ### ### # # ### # ### ### # # #
# #. .  #.  #   # # #     # #   # # # # #
# ### ### ##### # # ####### # ### # # # #
#   #   #. .# # # #     #   #   #   # # #
### ### # # # # # ##### # ### # # ### # #
# #   # # #.#   #     #   #   #   #   # #
# ### # # # ##### ######### ####### ### #
#     # # #.  #       #             #   #
##### # # # # ######### ############# ###
# #   # # #.#   #                     # #
# # ### # # ### # ##################### #
#   #   # #.#   #. . . .        #       #
##### ### # ##### ##### ### ### # #######
#   #   # #. . . .    #.# #   # #     # #
# # # # ####### ##### # # # # # ##### # #
# # # #   #   #     # #.# # # #     # # #
# # ### # ### ##### # # # # # # ##### # #
# #   # #         # # #.# # # # #     # #
# ################# ### # # # # # ##### #
#                   #. .#   # #         #
##################### ###################
