############### #########################
# #     #      .              #     #   #
# # # ### # ### ##### ##### # ##### ### #
# # #   # # #. .    #     # #       # # #
# # ### ### # ##### # # ### ######### # #
# #   # #   #. . .# # #   #       # #   #
# ### ### ### ### # ##### ### ### # ### #
#         #   #. .#   #     #   #   # # #
############### ##### # # # # ####### # #
# #   #  . . . .# #   # # # #         # #
# # ### # ##### # # ### # # ### ####### #
#       #.#     # # #   # #   #       # #
######### ####### # # # # ### ### ### # #
#      . .#       # # # #   #   #   #   #
# ##### # # ####### # # ### ### #########
#   #  .# #         # #   #   #         #
### # # ############# ### # # # ####### #
#   # #. . .#     #     # # # # #     # #
# ######### ##### # ##### # # ### ##### #
# #       #. .  #   #   # # #   # # #   #
# ####### ### ##### # # # # ### # # # ###
#       #   #. .  # # # # #   # #   #   #
##### # ### ### # # # # ##### ### # #####
#   # #     #. .# # # #     #     #     #
# # ######### # # ### ### # # ######### #
# # #    . . .# #     #   # #     #   # #
### # ### ### # # ##### # # ####### # # #
#. .#   #.#   # #     # # #   #     # # #
# # ##### ##### ##### # # # ### ##### # #
#.#. . . .#     #   # # # #     #   # # #
# ### ##### ### ### ### # # ##### ### # #
#.#   #     #   #       # # #   # #   # #
# ##### ### ##### ##### # ### # # # # # #
#. .  # # # #   # #     #     #   # # # #
# # ### # # # ### # ############### # # #
# #. .# #   #   # #   #   #         # # #
# ### # ####### # ### ### ############# #
# # #.#       # #   #   #       #       #
# # # ### ##### ### # # ####### # #######
#   #.  #       #   # #         #       #
##### ###################################
