####### #################################
#    . .      #   #             #       #
# ### # ##### ### # ######### ### ##### #
# # #.#     #     #. . .#   #   #   # # #
# # # ##### ####### ### # ##### ### # # #
# # #. .  #     # #.# #.#     #   #   # #
# # # # ####### # # # # ##### # # ##### #
#   # #. . .#   #. .  #.    #   #   #   #
# # # ### # # ### ##### ### ######### ###
# # #   # #.# #. .  #. .  # #           #
# ### # # # ### ##### ##### # ##### #####
#   # # # #. .#.# #. .#     #. .  # #   #
### # # ##### # # # ### ##### # # ### # #
#   # #     #.#.# #.#   #. . .#.# #   # #
# ######### # # # # ##### ##### # # ### #
# #         #.#. .#. . . .  #. .# #   # #
# # ######### ### ########### # # ### # #
# # #  . . . .  #.# #   #. . .# #     # #
# # # # ### ##### # # # # ##### ####### #
# # # #. .# #. . .# # # #.#     # #   # #
### ##### # # ##### # ### ####### # ### #
#   #. . .# #.#   # #   #. . . .  #     #
# ### # ### # ### # ### ####### #########
# # #.# #   #. .#  . . .#     #. . . . . 
# # # ### ##### ### ### ##### ###########
#   #.#   #   #. . .# #.#. . .# #       #
##### # # ### ####### # # ### # # ##### #
#    .# # #   #   #   #. .#. .#   #     #
# ### # ### ### # # ####### ####### #####
# #. .#   # #   # #. .  #. .#       #   #
# # ##### # # ##### # # # ### ##### # # #
# #. . .#   # #. . .#.# #.    #   # # # #
# # ### ##### # ##### ### ##### # ### # #
# #   #. .  #. .#   #. . .#   # #     # #
# ### ### ### ##### # # ### # ######### #
#   #   #.#. .      # # # # #         # #
### ### # # ######### # # # ### ####### #
# # # # #. .#   #     #   #   # #       #
# # # # # ##### # ############# # #######
#   #   #       #                       #
#########################################
