##################################### ###
#     #                     #  . . . .  #
# # # ##### ############### # # ##### # #
# # # #     #  . . . . . .#   #.#     # #
##### # ####### # ####### ##### # ##### #
#       #    . .# #. . .#.#. . .# #     #
# ####### ### # ### ### # # # ### ### # #
# #   #   #. .# #. .# #.#. .# #   #   # #
# # ### ### ### # ### # ####### ### #####
#   #   #  .#   #.#   #.#       #     # #
##### ##### # ### # ### ######### ### # #
#     #  . .# #. .  #  . . .  #   #   # #
# ##### # ### # ########### # # ### ### #
# #     #. .# #. .#       #.# # # # #   #
# ####### # ##### # ####### # # # # # ###
#     #   #. . . .  #  . . .# #   # #   #
##### ##### ########### # ### ##### ### #
#   #     #       #. . .# #   #         #
### # ### ######### # ##### ####### #####
#   # #   #    . . .# #     #     # #   #
# ##### ### ### ##### # ######### ### # #
# #     #   #. .# #   #         #   # # #
# ########### # # # ####### ### ### # # #
# #    . .#  .# # # #     #   #     # # #
# # ### # ### # # # ##### ########### ###
#   #. .#. . .# # # #   #       #  . . . 
##### ####### # # # # # ####### ### #####
# #  . .#     # #   # #       #    .#   #
# # # # ####### ##### ####### ##### # # #
#   # #. . . .# #     #     #     #.# # #
##### ##### # # # ##### ### ##### # ### #
#     #   # #.#   # #. . .# #. .# #.#   #
# ##### # # # ##### # ### ### # ### # ###
#   #   # # #. . . . .  #. . .#.#. .  # #
# # # ### # # ########### ##### # ##### #
# # # #   # # #   # #   # #   #. .#     #
# # # # ### ### # # # # # ### # ### ### #
# # # #   #   # # #   # #   # #   # #   #
# # ### ##### # # ##### ### # ### ### ###
# #         #   #         #     #       #
#########################################
