##### ###################################
#    .  #. . .        #             #   #
# ### ### ### ##### ### # ##### ##### # #
# #  . . .  #. . .#     #     #       # #
# ############# # ####### ### ####### # #
# #     #. . .# #. .    #   #       # # #
# # ##### ### ### # ### ##### ##### # # #
# # #. . .#  . .# #.  #   #   #   # # # #
# # # ######### ### ##### # ### # # ### #
# # #.#. . .#  . .#. .#   #     # #   # #
# # # # ### ##### ### # ### ##### ### # #
#   #.#.# #. . .#. . .#   # #   # #   # #
##### # # ##### # ### ### ##### ####### #
 . .#. .  #   #.# #   # #     #         #
### # ##### # # # # ### ##### ###########
# #.#       # #.# #   #. . .#           #
# # ########### ####### ### ### #########
# #.#  . . . .#. . . . .  #. .#         #
# # # # ##### ### ######### # ##### ### #
# #.# #. .#  . .#     #. .# #. .  # # # #
# # # ### ##### ####### # # ### # # # # #
# #.#   #. .#  . . . . .#.#   #.# #   # #
# # ### ### ############# ### # # ##### #
# #. .#   #. . .#   #   #. .# #.#   # # #
# ### ##### ### ### # ##### ### ### # # #
#    . . .#   #. .# #      . . .# # # # #
######### ##### # # ######### # # # # # #
#        . . .# #.#   #       #   # #   #
# ########### ### ### ### ######### #####
# #          . . .  # #   #             #
# # ############# # # # ####### ### #####
# # #   #       # # #   #       # #     #
# # # # # ##### # # ####### ### # ##### #
# # # # #   # # # #   #     # # #     # #
### # # # # # # # ### # # ### # ##### # #
# #   # # # # #     # # #   #   #   #   #
# ##### ### # # # # # ##### ##### #######
# #     #   # # # # #     #         #   #
# ####### # # # # ####### ####### # ### #
#         # #   #       #       # #     #
#########################################
