################# ### ###################
#   #     #      . .#.#       #   #   # #
# ### ### # ##### # # # ##### ### ### # #
#     # #   #     #.#.# #       #     # #
### ### ########### # # ####### ##### # #
#   #   #    . . . .#.#   #   # #   # # #
##### ### ### ### ### ### # ### # # # # #
#     #   #. .#   #. .# # # #   # # # # #
# ##### ### # ##### ### ### # ### # # # #
#   #   #  .# #. . .#   #   #   # #   # #
### ### # # ### ##### ### ##### ##### # #
#       # #. .#.#. . .#   # #   #   #   #
######### ### # # ### # ### # ### # ### #
#     # #   #.#. .# #. .#     #   #   # #
# ### # ##### ##### ### # ########### # #
#   #  . . . .  #   # #.  #   #     #   #
# # ### ##### # # ### # ##### # ### ### #
# # #. .#     #   #   #.#   # #   #   # #
# # # ############# ### # # # ####### # #
# # #. . . .      #  . .# #   #     #   #
# # ### ### ##### ### ### ### # ### ### #
# #   #   #. .  #   #. .#   # # # #   # #
# # # ### ### ##### ### ##### # # ### # #
# # #   #   #. . .# #. .      #   #   # #
# # # ##### # ### # # ########### # ### #
# # #     # #   #.# #.#     #   # # # # #
# # ##### # ### # ### ##### ### # # # # #
# #   #   #   # #. .#. . .#   #   # #   #
# ### # # # # # ### ##### ### # ##### ###
# # # # # # # #   #. .  #. . .# # #   # #
# # ### # ### ####### ####### # # # ### #
# #     #   #   #. . .#. . .#. .#   #   #
# # # ##### ### # # ### ### ### # ### ###
# # # #   # #   #.# #. .  #. . .  #   # #
# ### # ##### ### ### ### ######### ### #
#   # #   #   #  . . .  #   #   #       #
# # ##### # # ##### ### ### # ### ##### #
# #     # # # #   #   #   #   #   #   # #
# ### ### # ### # ### # ####### ### # # #
#   #     #     # #   #         #   #   #
#########################################
