##### ########### #######################
#. .#. . . . .  #.            # #   #   #
# # # ####### ### ############# # # ### #
#.#.# #. . .#.#. .    # #       # #   # #
# # ### ### # # ##### # # ########### # #
#.#. . .#  . .#.#   # #   #     #     # #
# ### ####### # ### ### ####### # ##### #
#. .# #     # #. . .#   #       # #     #
# # # # ##### ##### # ##### # ### # #####
# #.# #       #    .#       # #     #   #
# # ############### ######### # ##### # #
# #. . .  #. .    #. . .    # # #     # #
# ##### ### # ### ##### ##### # # #######
#   #. .#. .#. .# #   #.#       #       #
# # # ### ##### # # ### # ####### ##### #
# # #. .#. .# #.# #. . .          #   # #
# # ### ### # # ### ################# # #
# #   #. . .  #. . .                # # #
# # # ############# ##### ####### # # # #
# # #       #     #   # # #   #   # # # #
# # ### ### # ### ### # # ### # ### # # #
# #   #   #     #   #   #   #   #   # # #
# ### ### ##### # # ####### ######### # #
# # # #   #   # # #       #         # # #
# # # ##### # # ### ######### ##### # ###
# #   #     # #   #   # #         # #   #
# ##### ##### ### ### # # ### ##### ### #
#   #   # #     #   #   # #   #     #   #
# # # ### # ####### ##### # ### ##### ###
# #       # #       #     # #   #       #
# ########### ####### ##### # # # ##### #
#   #   #     #       #     # #       # #
##### # # # ### # ### # ##### # ##### ###
#     #   # #   #   # # #   # #     #   #
# ##### ### # ##### # # ### # ### # ### #
# # #   # # #     # # #   # #   # #   # #
### # ### ############### # # # # ##### #
#   # # #               # #   # #   #   #
# ### # ############### # ######### # ###
#     #                   #         #   #
#########################################
