##### ###################################
#  . .                              #   #
### # ####### ##################### # # #
#. .#       #   #               #   # # #
# # ########### # ######### ##### ### ###
#.# #           # #   #   #     # # #   #
# # # ########### ### ### # ### # # ### #
#.# #     #. . . . .  #   #   # # #   # #
# ######### ####### ### ##### # ### # # #
#. .    #. .#     #. .      # #   # # # #
# # ##### ### ### # # ####### ### ### # #
# #. .#. .#     # # #.      #   #     # #
# # # # ### ##### # # ##### ########### #
# # #. .  # # #   # #. . .#     #       #
# # # ##### # # ### ### # ##### # #######
# # # #     # #   #   # #. . .#   #. . . 
# # ### ##### ### ### ##### # ##### #####
# #         #   #   #     # #.    #.#   #
# ##### ####### ####### # # # ### # ### #
#     #         #     # # # #.#   #.#   #
### # ########### ### ### # # ##### # ###
# # # #   #       #       # #.#. . .    #
# # # ### # ### ### # ##### # # #########
#   #   #   #   #   # #   # #. .    #   #
# # ### ##### # # ### # ### # # ### ### #
# # # #   #   # # #   #     # #   #   # #
# # # # # # ### # ########### ####### # #
# # # # # # #   #     #     # #       # #
# # # # # # # # ### # # ##### # ####### #
# #   # # # # #   # # #   #   # #       #
# ##### # ####### # ##### # # ### ##### #
#     # #   # #   #       # # #     #   #
# ### # ### # # ########### ### ##### # #
#   # #   # # # #     #           #   # #
##### ### # # # # ##### ### ####### ### #
#     #   # #   # #   # # # #   #   # # #
# # # ##### ##### # ### # # ### # # # # #
# # # #   #       # #   # #     # # # # #
# # ### # ##### ### # ### ######### # # #
# #     #     #     #     #         #   #
#########################################
