##################### ###################
#     #        . . . .          #       #
##### # # ##### # ### # ### ### ####### #
#   #   #     #.# #   #   #   #         #
# # ######### # ### ### # ######### #####
# #     #     #.#   #   #   #     # #   #
# ##### # ##### # ### # ### # ### # # ###
# #   #   #    .# # # # # #     # # #   #
# # ########### # # # # # ##### # ##### #
# #    . . . . .# # # #   #   # #     # #
# ##### # ####### # # ####### # ### ### #
#   #  .# #   #   # #   #     #   #     #
# ##### # # ### # # # # # ###############
# #  . .# #     # # # # #       #       #
### # ############# # # ####### # ##### #
#   #.#. . . . .    # #     #   #   #   #
# ### # ####### ##### # ##### ##### # # #
# #  . .#     #.#     #           # # # #
# ##### # ##### # ################# # # #
#     # #     #.#       #           # # #
# ### # ##### # ##### ### ########### ###
# # # #     # #.    #   #     #     #   #
# # # ##### # # ### # # # ### ##### ### #
# # #     #   #.#   # #     # #     # # #
# # # ### ##### ######### # ### ### # # #
# # #   # # #  . .      # #   # #     # #
# # # ### # ### # ##### # ### # # ##### #
# # #   # #   # #. .  # #   # # # #   # #
# # ### ##### # # # ### ### # ### # # ###
# #   #   #   # # #. .#   # # #   # #   #
# ### # # # ### # ### ### # # # ####### #
#     # #   # # # #. .  # # #   #       #
# ### # ##### # ### ### # ####### #######
#   # # #     # #. .#   #     #         #
# # # # # ##### # ########### # # ### ###
# # # # #     # #. . . .    #   # # #   #
### ### ##### # ####### ### ##### # ### #
#   #       # # #     #.# # #   # # #   #
# ### ####### # ##### # # # # ### # # # #
#   #         #       #.#   #     #   # #
####################### #################
