############# ### #######################
#. . . .#  . .  #.# #                   #
# ##### ### # ### # # ########### ### ###
#.# #. .#. .# #. .  # #         #   #   #
# # # ### ### # ##### # # ##### ### ### #
#.#  . . .# # #.# #   # #     # #   #   #
# ####### # # # # # ### ##### ### #######
#.#. .#   #   #.  # # # #   #   #       #
# # # ######### ### # # # # ### #########
#. .#. . .  # #.    #     #   #   # #   #
# ####### # # # ##### ####### # # # # ###
# #     #.# #. .#     #     # # #   # # #
# ##### # # # ### ##### ### # # ##### # #
#   #   #.# #.#       #   # # #     # # #
### # ### ### # ####### ### # ##### # # #
#   #   #.#. .# #       #   #     #   # #
# # ### # # ### # ####### ##### ####### #
# # #   #.#.    #       #     #       # #
# ### ### # ##### ##### ### ######### # #
#     #  . .#     #       #         # # #
# # ### # ### ##### # # # # ##### ### # #
# # #   #     #   # # # # # #   # # #   #
# ### ####### # ### ### # ### # # # #####
#   # #     # #     #   #     # #       #
### # # ### # ### ### # # ### # #########
# # #     # #   # #   # #   # #   #     #
# ######### ### # # ### ### ### # ##### #
#         #   # # #   #   #   # #     # #
######### ### # # # # ####### ##### ### #
#       #     # # # #       # #   #     #
# ########### # # ######### # # # ### ###
# #           # #   #   #   # # #   #   #
# # # ######### ### # ### # # ##### ### #
# # # #           # #   # # #         # #
# ### ##### ##### # ### # # ##### ##### #
#     #     #   # #     # #     #   #   #
####### # ### # # ####### ##### ### # ###
#     # # #   # # #         # #   # # # #
# ### # # # ##### # ####### # ### # # # #
#   #   # #       # #       #     # #   #
#########################################
