####### #################################
# #  . .  #             # #     #       #
# # # # # ### ##### ### # # # # # #######
#   #.# #         #   #   # # # #       #
##### # ######### ### ##### # ### ##### #
#    .#     #   #   #       #     #   # #
# ### ##### # ### # ######### ### ### # #
# #  .  # # #     #   #     #   # #   # #
# # # # # # ########### ### ### ### ### #
# # #.#   # #         #   # # #       # #
# # # ##### # ### ### ### # # ######### #
# # #. . .#     # #   # # # #   #   #   #
# ### ### ####### ##### # # ### # # # ###
#   #   #. . .  #     # # # # # # # # # #
### ### # ### # # # ### ### # # # # # # #
#   # # #   #.# # # #   #   #   # #   # #
# ### # ##### # # # # ### ### ### # ### #
#   #   #. . .# # #       # # #   # #   #
### ##### # # # ### ####### # ####### ###
# # #  . .# # #   #         #   #   # # #
# # # # ##### # # ####### # ### # # # # #
# # # #.#     # #       # #   #   # #   #
# # ### ############# # # ### ### ##### #
# # #. .#. . .      # # #   #         # #
# # # # # ### ####### # ### ######### # #
#   #.# #.# #.#       #   #   #     # # #
##### ### # # # ##### # # ### # # # # # #
#. . .#. .# #.#   #   # # #   # # # #   #
# ##### ### # ### ####### ##### # #######
#. . . .    #.  #       #       # #     #
# ########### # ### ### ######### # ### #
# #     # #  .#   #   # #     #   #   # #
# ##### # # # ### # ### # ### # ##### # #
#         # #. .# #   #   #   #     # # #
####### ### # # # ### ############# # # #
#     # #   # #.#   # # #         # # # #
# ### ### ### # ### # # # ### ### # # # #
#   # #   # # #.  # #   # #   #   # # # #
### ### # # # # # # ##### # ########### #
#       # #   #.# #       #             #
############### #########################
