########### ########### #################
#         #.#       #  .    #   #. . . .#
# ####### # ####### # # ### # ### ##### #
# #     #  . . . .# # #. .#   #. .    #.#
### ### ######### # # # # ##### ####### #
#   # #   #   #  .#   # #. . . .  #. . .#
# ### ### ### ### ############### # # # #
#   #       #    . . . . . . . .# #.# # #
# # ####### ##### ############# # # # # #
# #   #   #   #   #       #. . .# #.# # #
### # # # ### # ### ####### ##### # # # #
#   # # # #     # # # #. . .#   # #.# # #
# # ### # ####### # # # ####### # # ### #
# # #   #       #   # #. .#  . .# #. .# #
### # ######### # ### ### ### # ### # # #
#   # #     #   #   #   #.#. .#. .# #.# #
# ### # ##### ##### ### # # ##### # # # #
#   # # #   #     #   #  . .#   #.# #.# #
##### # # # ##### ### ######### # # # # #
#     # # # #       #     #   #. .# #.# #
# ##### # # # ##### ##### ### # ### # # #
# #   #   # # #   #      . .  #.  # #.# #
# # # # ##### # ######### # ### ### # # #
# # #       # # #       #.#. . .#   #.# #
### ####### # # # ##### # ####### ### # #
#   #         # # #   # #.#  . .#   #.# #
# ### ######### # ### # # ### # ##### # #
# # # #         #     # #. . .#. . . .# #
### # # ############# ##### # ##### ### #
#   # #         #           # #   # #   #
# ### ######### ############# # ### # # #
# # # #                       #     # # #
# # # ##################### ##### ### # #
# # # #       #             #   # #   # #
# # # # ##### # ### ####### # # ### # ###
# # #   #     # #   #       # #   # #   #
# # ########### # ########### ### # ### #
#   #     #     #   #   #   # #   #   # #
### # ### ### ### # # # # # # ######### #
#     #       #   #   #   # #           #
#########################################
