################### #####################
# #         # #   #. .#. . .  #. .  #. .#
# # ##### # # # ### # # ### ### # ### # #
#   #     # # #     #. .  #. .#.#. . .#.#
# ##### ### # ### ### # ##### # ##### # #
# #     #   #     #   # #   #.#.#   # #.#
### # ##### ####### # # # # # # ### ### #
#   # #             # # # # #. .    #. .#
# ### ##### ### ##### # # # # ####### # #
# # #   #   #   #     #   # #   #. . .# #
# # ### # ### ### ######### ### # #######
#   # # #   # # # #     # #   # #. .#. . 
##### # ### # # # ### # # # # # # # # ###
#   # #   # #   #   # #   # # # # #.#.# #
# # # ##### # ### # # ##### # # # # # # #
# # # #     # #   # #       # # # #.#.# #
# ### # ####### ### ######### # # # # # #
#     # #   #   # # #       # # # #.#.# #
# ##### # # # ### # # ####### # # # # # #
# #     # # #     # # #       # # #. .  #
# # ##### # ####### # # ### ### # #######
#   #     #         # # #   #   #       #
########### ##### # # # ##### # ####### #
#   #       #     # #   #     #       # #
# # # ####### ##### ##### ##### # # ### #
# #   #           #   #   #     # #   # #
# ##################### # # # ### # # ###
# #   #     #         # # # # #   # #   #
# # ### ### # # ##### # # # ### ####### #
# #     # #   # #       # #   # #     # #
# ####### ##### # ####### ### ### ### # #
#     # #     # # #       # # #   #   # #
# # # # ##### # # # ####### # # ####### #
# # # # #       # #         # # #       #
# ### # # ####### ########### # ##### # #
#   # # # #     # #     # #     #   # # #
### # # # # ### # # # # # # # ### # # # #
# # # # # # # #   # # # #   # #   # # # #
# ### # # # # ####### # ####### ### ### #
#     #   #   #       #         #       #
#########################################
