########### ################# ###########
#          .  #. .  #. . .  #.#         #
# ### # ### ### # ### ### ### # ### ### #
# #   # #  . . .#. . .  #.#. .# # #   # #
# # ### # ### ##### ##### # ### # ### # #
# # #   #   # #   # #. . .#.# # #   # # #
# # # # ### ### # # # # ### # # ### # # #
# # # #   #   # # # #.# #. .  # #   # # #
# # # ### ### ### # # # # ##### # ### # #
# # # #   # # #   # #.# #.# #   # #   # #
# # ### # # # # ##### ### # # ### ##### #
# # #   #   #   #. . .#. .  # # #   # # #
### # ########### ##### ##### # ### # # #
#   #     #  . . .#. . .# #     # # #   #
# ### ### # # ### # ##### # ##### # #####
#   #   # # #. .# #. . .  #         #   #
# # ### # ##### # ##### ### ######### ###
# #   # # #   #.#     #.#           #   #
# # ### # # # # ####### # ######### # # #
# #   # #   # #.    #. .  #       #   # #
# # # ### # # # ##### ######### ##### # #
# # #   # # # #. . . .#             # # #
# # ### # ##### ####### ########### ### #
# #   # # #     #     #   #       # #   #
# ##### # # # ### ### ### # # ### ### # #
# #     # # # #     #       #   # #   # #
# # ##### # ### ######### ##### # # ### #
# # #   # #   #   #     #   # # # # #   #
# ### ### # # # ### ### ### # # ### #####
# #   #   # #       # #   # # #   #     #
# # ### # ########### # # # # ### ##### #
#   #   # #     #   # # # # #   #     # #
# # # # ### ### # ### # # # ### # ##### #
# # # #     # # # #   # # #   # #     # #
# # # ##### # # # # ### # # # # ### # ###
# # # #   # # # # # #   # # #   # # #   #
# ### ### # # # # # ### # # ##### ##### #
#   # #   # # #     #   # # #   #     # #
### # # ### # ####### # # ### # ##### # #
#   #   #   #         # #     #     #   #
#########################################
