####### ######### #######################
#      . .#. . . .#     #   #       #   #
# ##### # # ####### ### ### # # # ### # #
# #. .# #.#. .#   # # #     # # #     # #
### # ### ### ### # # # ##### # ####### #
#. .#. . .  #. .#   #   #     #       # #
# # ########### ##### ### ########### # #
#.# #. . . . . .  #   #   #         # # #
# ### ############# ### ### ####### ### #
#. .#. . . . .#     #     #       #   # #
# # ######### # ##### ##### ######### ###
# #. .  #. . .  #   # # #   #       #   #
# # # ### ######### # # # ### ##### ### #
# # #. . .  #       #   # #   # #   # # #
# ### ####### ### ##### # # ### # ### ###
#   #       # #   #     # # #     #     #
# # ####### ### ### ##### ### ######### #
# #       #   #     #     #   #   #   # #
# # # ####### ### ### ##### ### ### ### #
# # #       #                   #   #   #
# # ##### ############### ####### ### ###
# # #   #     #   #   # #     #   #     #
# # ### ### # # ### # # ### # # ### #####
# #     #   # #     #     # #   #       #
# ####### # # ########### # ##### ##### #
# #       # #       # #   #           # #
# # ### ####### ### # # ############# # #
# # #   #       #   #   #   #     # # # #
# # # ############### ##### # ### # # ###
# # #             #   #     # # #   #   #
# # # ######### # # ### ####### # ##### #
# # # #       # #       #     #       # #
# # ### ### # ### ########### # ####### #
# #     #   #   #           # # # #     #
# ####### ##### ####### # ### # # # ### #
#       #     #       # #   # # # # #   #
### ### ### ####### # # ### # # # # #####
# #   #   #     # # # # #   # # # # #   #
# ### ### ##### # # # # ##### # # # # # #
#     #   #     #   # #           #   # #
#########################################
