############################### #########
# #          . . . . .#  . . . .        #
# # # ####### ####### ### ### # ### ### #
#   # #      .#      . . .#   #   #   # #
##### # ##### # ####### ####### # ### ###
# #   # #  . .#   #. .# #   #   #   #   #
# # ### # # ##### # # ### # ##### # ### #
#   #   # #. . .# #.#. .# #   #   # #   #
##### ### # ### ### ### # ### # ##### # #
#   # #   #   #. . .  #.#   #   # #   # #
# # # ####### ######### ######### # #####
# # # #     # #. . . . .#. .  #   # #   #
# # # # ### # # # ##### # # # # ### ### #
# # #     # # #.# #     #.#.# #     #   #
# # ##### # # # # # ##### # ######### ###
# #   #   # # #.# # #   #.#. .        # #
# ### # ### # # ### # # # ### ######### #
# # # # #   # #. .#   # #. .#. .#. . .  #
# # # ### # # # # ######### ### # ### ###
# #       # # # #. . . . . .  #. .# #. .#
# ########### # ######### ##### ### # # #
#   #   #     #     #   #     # #   # #.#
### # # # ######### ### ##### ### ##### #
#   # # #   #   # # #       #     #  . .#
# ##### ### # # # # # ############### # #
#   #. .# # # # # #   #      . . . . .# #
##### # # # ### # ########### # ### ### #
 . . .#.# #     #      . . .#.# #   #   #
####### # # ########### ### # # # ### ###
#     #.# #   #    . . .# #. .# # #   # #
# ### # # ##### ### ##### # ##### # ### #
# #   #.#     # #. .#   #   #     #     #
# ##### ##### # # ### # ##### ##### # # #
#     #. . .#   #.# # # #     #     # # #
##### ##### ##### # # # # ########### # #
#   # #   #. . .#.#   #   #         # # #
# ### # ####### # ### ########### ### # #
# #   #      . .#.  # #       #   #   # #
# # ######### ### # ### ### ### ### ### #
#            . . .#       #     #   #   #
#########################################
