### #####################################
#  .          #   #   #     #     #     #
### ### ##### # # # ### ### ##### # #####
#. .  #     # # # #     #       # #. . .#
# # # ### ### ### ############# # # ### #
#.# #   #   #     #         # # #  .# #.#
# # ### ### ############### # # ### # # #
#.#   #   #               # # #    . .#.#
# ### ### ####### ##### ### # ####### # #
#. .#   # #   #   #   #   # # # #   #.#.#
# # ### # # # # ### ##### # # # # ### # #
# #. .# #   # #   #       #       #. .#.#
# ### # ### # ### ######### ####### ### #
#   #.#   # #   # #         #   #. .# #.#
##### ### ##### # # ######### ### ### # #
#. .#. .#   #   #   #   #   #. . .#   #.#
# # ### ### # ####### # ### # ##### ### #
#.#. .#.  # # #     # #   #. .# #   #. .#
# ### # # # # ##### ##### # ### # ### # #
#. .#. .# # #     #   #   #. . .# #  .# #
# # ##### # ##### ### # ####### # ### # #
# #. .#   #     #   # #. .  #. .# #. .# #
# ### ######### # ### # # # # ### # # # #
#   #. . . .#   #   # #.#.# #.    #.# # #
# # # ##### ####### # # # ### ##### ### #
# # # #   #. .  #   # #.#. . .#   #. .# #
# # ### # # # ### ### # ##### # # # # ###
# #   # # # #. .# #. . .    # # # # #. .#
# # # # # ##### ### ####### ### # # ### #
# # # # #   # #. . .#     #   # # #   #.#
# # # # ### # # ##### ### ### ### ### # #
# # # # # #   #     #   # # #     #   #.#
# # # # # ####### # ##### # ########### #
# # # #   #     # #   #   #  . . . . . .#
# ### ### # ### ##### # ##### ######### #
#   #     #   #       #   #  .#. .#   # #
### # ####### ####### ### # # # # # # # #
# # #   #   # #     # #   # #. .#.# # # #
# # ### ### # # ### ### ### # ### # ### #
#     #     #     #     #   # #. .#     #
############################### #########
