# ################# #####################
#.    #           #.#    . . . . . .#   #
# ### # ######### # ##### ######### ### #
#. .#   #. .  #   #. . .#.#    . .#.#   #
# # ##### # # # ####### # ##### # # # ###
# #. . . .#.# # #. . .#.#. . .#.#. .# # #
# ####### # # # # ### # ##### # ##### # #
# #     # #.# # #.# #.#. . .#.#.#   #   #
# ##### ### ### # # # ##### # # ### ### #
#     # #. .#   #. .#. . .#. .#. . .# # #
# # ### # # # ##### ##### ######### # # #
# #   # #.# #   #. .    #. . . .  #. .# #
##### # # # ##### ######### ### ##### # #
#   #   #.# #  . .#       #   #. .  #. .#
# ####### # ### ### ##### ####### ##### #
#    . . .#   #.# # #   #       #. .#. .#
##### ####### # # # ### ########### # ###
#. . .#. . .# #.  #   # #   #     #. .  #
# ### # ### ### ##### # # ### ### # #####
#.#   #. .#. . .    #   # #     # #     #
# # ##### ############# # # ##### ##### #
#.#     #. .            # # #     #   # #
# ######### ############# # # # # ### # #
#. . . .#. .              # # # # #   # #
# # # # # ####### ######### # ### # ### #
# # # #. .#     #         # #   #   #   #
# # ######### ######### # # ### ##### ###
# #                 #   # #   #     # # #
# ################# # # ### ##### # # # #
#           # #   # # # #   #     # #   #
####### ### # # # # # ### ### ### # # ###
#     #   # #   # # #       # #   # #   #
# ##### # # ##### # ######### # ### #####
# #     # #   #   # #   #     # #       #
# # ### # # # # ### # # # ### # # ##### #
# #   # # # #   #   # # # #   # # #   # #
# ### ### # ######### # # ##### # # ### #
# #   #   # #       # # # #     # # #   #
# # # # ##### ##### # ### # ####### # ###
#   # #       #     #     #         #   #
#########################################
