############# ############# #############
#. . . . . . .  #          .  #   #. . .#
# ############### # ####### # # ### ### #
#. . .        #   # #     #.#   #. .  #.#
##### ######### ##### ### # ##### ##### #
#. . .        # #     #   #. . . .# #. .#
# ########### # # ##### # ####### # # # #
#.#       #   #   #   # # #     #   #.# #
# # ##### ######### # # ### ### ##### # #
#.# #   #     # #   # #     #   #. . .# #
# # # # ##### # # ############### # ### #
#.# # # #   #   # #          . . .# #   #
# # # # ### ##### ### ####### # ##### # #
#.# # # #       #   # #     #.# #     # #
# # # ### ##### ### # # ##### # # #######
#.# #     #  . . . .# # #  . .# # #     #
# # ######### ##### # # # # ### # # ### #
#.#  . . . . .#   #.#   # #.#   #     # #
# ### # # ##### # # ##### # ########### #
#.#. .# # #   # # #.#. .# #.#. .  #     #
# # ##### # # # # # # # ### # # ### #####
#. .# #   # #   # #. .#. .#.#.#. .# #   #
# # # # ### ############# # # ### # # # #
# # # # #   #            .#. .#. .# # # #
# # # # ### ### ######### ### # # # # # #
# # #   #       # #     #. .# #.# # # # #
### ##### ### ### # ### ### # # ### ### #
#   #   # #   #   # # # # #.# #.#   #   #
# ### # ### ### ### # # # # # # # # # ###
# #   #     # #       # #. .# #.# # # # #
# ########### ####### # # ##### # # # # #
#           #       # # #.#  . .# # #   #
######### ### ####### # # # # # # ##### #
#       #   # # #     # #.# #.# #   #   #
# ####### # # # # ##### # # # ##### # ###
# #     # # # # # #     #.# #. .  #   # #
# # ### ### # # # ####### ### # # ##### #
#   #       # #   #     #. .# #.# #   # #
########### # # ### ### ### ### # # # # #
#           #       #      . . .#   #   #
#########################################
