# #######################################
#. . .  #. . . .              #       # #
# ### # # ##### ### ########### ##### # #
# #. .# #.    #. .#     #   #   # #   # #
# # ##### ####### # ##### # # ### # ### #
# #. . . .      #.# #   # # #. . .# #. .#
################# # # # # ### ### # # # #
#. . . . .#. . .#.# # # # #. .  #.# #.#.#
# ####### # ### # # ### # # ##### # # # #
#.#     #. .#  . .#   # #. .  #. .# #.#.#
# ##### ##### ####### # # ##### ##### # #
#. . .#       #. . .# #. .#. . .#. . .#.#
# ### ######### ### ### ### ### # ##### #
# #. .    #. . .  #. . .  #.#   #.# #. .#
# # # ##### ############# # ##### # # ###
# #.# #. . .  #     #   # #. . . .  #. .#
### # # ####### ### # # ############### #
#. .# #. .# #   #   # # #. . . .#. . . .#
# ####### # # ### ### ### ##### # # ### #
#. . .  #.  # # # #   #. .#    . .# #   #
# # # ### ### # # # ### # ########### # #
# # #. . .    #   # #  .# #           # #
# # ############### ### ### ####### #####
# #               #   #. .# #     # #   #
# ############### ### ### # ##### ### # #
#   #   #   #   # #   #. .# #     #   # #
# # # ### # # # # # ### # # # ##### ### #
# #   #   # # # #   #  .# #   #     #   #
# ##### ### # ######### # ##### ##### ###
# #     #   #  . . . . .#     # #       #
# # ##### ##### ####### # # # # # #######
#   #   # #    .#     # # # # # # # #   #
# ### ### # ### # ##### # ### # # # # # #
#   #     # #  .#       # #   # #   # # #
####### ### ### ########### ####### # # #
#     # #   #. .#         #   #     # # #
# ### # # ### # ######### ### # ####### #
# #   # #   #.#         #   # #     #   #
# ######### # ####### ##### # # ##### ###
#           #.      #       #           #
############# ###########################
