############### ######### ###############
#             #.#     #  . . . . .    # #
# ############# # ### ### # ##### ### # #
#. . .#. .  #. .# #       #     #.  #   #
# ### # # ### ### ############### # ### #
#.# #. .#. . .  #     #     #  . .#   # #
# # ######### ####### ##### ### ##### ###
#.#     #   #       #     # #. .#   #   #
# ##### # # ############# # # # # ##### #
#. . .# # # #           # # #.# #       #
##### # # ### ######### # # # # ##### # #
#. . .# #   #   #. .#   #   #.#   #   # #
# ##### ### ### # # # ####### ### ##### #
#.#  . . .# #   #.#.#        .  # #     #
# # # ### # # ### # ######### ### # #####
#.# #.# #.#   #. .#.#    . . .#   # #   #
# # # # # ##### ### ##### # ### # ### # #
#.# #.#  . . . .#  . . . .# #   # #   # #
# # # ##################### # ##### ### #
#.# #.  #             #     #   #     # #
# # # ### ########### ######### # ##### #
#.# #. .# #. . . . .#           # #   # #
# # ### # # ####### ########### # ### # #
#.# #. .# #.#. . . .  #       # #   # # #
# ### ##### # ### # ### ##### # ### # # #
#. .#. . . .#.#   #   #   # # #   # #   #
### # ##### # # ##### ### # # ##### #####
# #.# #   # #.#   #   #   # # #         #
# # # # # ### ### # ### ### # # #########
# #.#   #   #.#   #   #     #   #       #
# # ####### # # ### # ##### ##### ##### #
#  . . . .# #.# #   #     # #     #     #
######### ### # ####### # # ####### ### #
#     #  . .#.#       # # #         #   #
# ### ##### # ### ### # # ########### ###
#   #   #  . .  #   # # #   #       # # #
### ### # ### # ##### # ##### ### ### # #
# # # # #   # #   #   #       # #   #   #
# # # # ##### ### # ########### # # ### #
#   #         #   #             # #     #
#########################################
