####################################### #
#  . . .#. . .# #  . .#     #   #      .#
# # ### # ### # # # # # ##### # ### ### #
# #.# #. .# #. .# #.#.# #     #     #. .#
# # # ##### ### ### # # # ########### # #
# #.#   #. . . .#. .#. .# #. . .#    .# #
# # ### # ####### ##### ### ### ##### # #
# #.#  . .#      . .#  . . .# #. . .#.# #
# # ### ### ##### # ######### ##### # # #
# #. .#. .# #. .# #. . . .#. .    #.#.# #
##### ### ### # # ####### # # ##### # # #
#. . .#  . . .#.#     #. .#.#.#. . .#.# #
# # ########### ####### ### # # ##### ###
#.# #     #    . . . . .#  .#. .#    . .#
# ### ### ######### ####### ########### #
#. .#   #           #      .#    . . . .#
# # ### ############# ##### ##### # ### #
# #.  #         #     #    . . . .# #   #
# # ############# ##### ### ####### # # #
# #. . . .  #     #     #   #   #   # # #
# ### ### ### ##### ### # ### ### ### ###
#   #   #. .#     # #   # #       #     #
### ####### ##### # # ### ######### # # #
#   #. . . .#   # # # #   #     # # # # #
##### # ### # ### # # # # # ### # # ### #
 . . .# #   #     # # # # # #   # # #   #
### ### # # ####### # # ### ##### # # ###
#   #   # # #     # # #     #     # #   #
# ### ### ### ### # # ####### ### # ### #
# # #   #   # #   # #     # # #   # #   #
# # ### ### ### ####### # # # # ##### # #
# #   #   #   # #     # # # # #   #   # #
# ### # # ### # # ### ### # # ##### #####
#     # # # # # # # # #   #         #   #
# ### # # # # # # # # # ######### ##### #
#   # # # # # #   # # #     #     #   # #
### # # # # # ##### # # ### # ##### # # #
# # # # #   #     #   # # # #     # #   #
# # # # ##### ### # ### # # ####### #####
#   # #     #   #     #   #             #
#########################################
