################### #####################
#     #            .    # #. . . .      #
# ### # ### ####### ### # # ##### ##### #
# #   #   # #  . . .  # # #.    #.  # # #
# ####### ### # ####### # # ##### # # # #
# #     #   # #. . .#   #. .#   #.#   # #
# # ### ### # ##### # ### ### # # ##### #
#   #       # #   #.#   #. .# # #.  #   #
##### ##### # # ### ####### ### # # # # #
#     #     # #   #.#. . .#. .# #.# # # #
####### ##### ### # # ### ### # # # # ###
#     # #   #     #. .  #. . .# #.# #   #
# ### # # # ####### ### ####### # ##### #
#   #   # # #     #   #       # #. .#   #
######### # # ####### ######### ### # ###
#   #     #   #     #   #     # #. .#   #
# # ### ######### # # ### ### # # # #####
# #   # #         # #       #   #.# #. .#
##### # ##### ##### ############# ### # #
#   # # #     #   #           #  . . .#.#
# # # # # ### ### ########### # # ##### #
# #   #   #   #  . . . .#   # # # #   #.#
# ############# # ##### # ### # # # ### #
#       #       #.#   #.  #   # #   #. .#
####### # ####### # ### ### ### # ### ###
#     # #       #.# #. .    #   # #  . .#
# ### # ####### # # # ####### # ### # # #
# #. . . .#     #.# #.# #   # # #   # #.#
# # ##### ####### # # # # # ### # ### # #
# #.#   #. . . . .#. .#   #     # #   #.#
### # # ########### ############# # ### #
 . .# #         #. .        #     # #. .#
# ### ######### # ########### ##### # ###
# #   #         #.# #         # #   #. .#
### ### ######### # # ######### # ### # #
#   #   #     #. .#   #  . .# #   # # #.#
# ######### # # ######### # # ##### # # #
# #       # # #.#    . . .#. .#   #   #.#
# ### ### # # # ##### ####### ### ##### #
#     #     #  . . . .#      . . . . . .#
#########################################
