########### #############################
#   #    . .#. . . .                    #
# # # # # ### ##### ######### ######### #
# # # # #. . .#. .#. .  #   # #         #
### # # ####### # ### ### # ### #########
#   # #   #   #.#. .#. .# # #   # #. .  #
# ### # # # # # ### ### # ### ### # # # #
# #   # # # # #.#  .#. .#     # #. .#.# #
# ####### ### # ### # # ####### # ### ###
#       #     #. .#. .#       #. .# #. . 
####### ######### # ######### # ### #####
#. .#  . . .#  . .# #. . .#   #.#   #   #
# # ### ### # # # ### ### # ### # ### # #
#.#. . .#  .# #.# #. .# #.# #. .# #   # #
# ######### ### # # ### # # # ### # #####
#.#   #    . . .# #. .# #.# #. .# # #   #
# # ### ######### ### # # # ### # # # # #
#.#     # #       # #.# #.#   #. . .# # #
# ####### # ####### # # # ### ##### # # #
#. .  #. .# #. .  #. .# #. .#     #.# # #
# # ### # ### # ### ### # # ####### # ###
# #.#. .#. . .#. .#.#   # #. . . . .#   #
# # # ########### # # ### ############# #
# #.#.#         #. .  # #         #     #
# # # # ####### ####### ########### #####
# #.#. .  #   #       #         #   #   #
### ### ### # ##### ### ####### # ### ###
#. .  #.#   #     #   #       #     #   #
# # ### # ####### ### # ############### #
#.# #. .# #   # #   #   #           #   #
# ### ### # # # ### ##### ######### # ###
#. . .# # # # #   # #   # #       # # # #
# # ### # # # ### # # ### # ### ### # # #
# #     #   #   # #   #   # # #   # # # #
# ######### # ### ### # ### # ### # # # #
#         # #     #     #   #   # # #   #
### ##### ######### ##### ##### # ##### #
#   #   #     #     #   #     # #   #   #
# ### # ####### ##### # ### ### # # # ###
#     #               #         # #     #
#########################################
