##################################### ###
#   #      . . .#  . . .#. . . . .#  .  #
# # # ##### ### ### ### # ####### # # # #
# # # #. . .#  . .#.# #.#.# #. .#.# #.# #
# ### # ######### # # # # # # # # ### # #
#   # #.#       #.#.# #. .# #.#. .#. .# #
### # # ####### # # # ##### # ##### # # #
#   # #. .    #  . .#    . . .#. . .# # #
# ### # # ### ########### ##### ####### #
# #   # #. .#   #. . . .#.#  . .#       #
# # ### # # ##### ##### # ### ### ##### #
#   #   # #. . .#.  #. .#. . .#   #     #
### # ### # ### # ### ####### # # #######
#   # # # # #. .#.#. .#       # # #     #
##### # # # # ### # ### ####### ### ### #
#     #   # #.#. .#.#   #       #   # # #
# ########### # ### # ### ####### ### # #
# #   #  . . .#.# #.# #   # #. . . .# # #
# ### # # ### # # # ### ### # ##### # # #
#     # #. .# #.# #. .#     #.#   #.#   #
# ##### ### # # # ### ####### # # # #####
# #     # #.# #.#   #. . .#. .  # #. .  #
### # ### # # # ### # ### # ######### # #
#   # #   #.# #. .  #   #. .  #. . . .# #
# ##### ### # ### ####### ##### ##### # #
# #     #. .# # #.      # #   #.#     # #
# # ##### ### # # ##### ### # # ####### #
#   #   #. .# #. .#   #     # #. . .  # #
##### ### # ### ### # ####### # ### ### #
#     #   #. . .#   #   # #   #   #. .# #
# ##### # # # ### ##### # # ##### ### ###
# #     # # # #   #   # # #     # # #. . 
# # ####### # # ##### # # ### # # # #####
#   #   #   # # #     #   # # # # #     #
##### # # # # # # ####### # # ### ##### #
#     # # # # # #       # # #   #       #
# ####### # # # # ### # # # ### #########
#         # # # # # # # # #   #         #
########### # ### # # ### ### ######### #
#           #       #       #           #
#########################################
