######### ###############################
#        .          #         #         #
# ####### ### ### ### ######### ####### #
#   #. . .  #   #     #       #. .    # #
### # ##### ### ######### ### # # ### # #
#   #.#   # # #     #     #   #.#. .# # #
##### # # # # # ### ### ##### # ### ### #
#. . .# #   # #   # #   #   # #.# #. .# #
# ### ####### ### # # ##### # # # # # ###
#. .# #. . . .  # # #     # # #.# # #. . 
# # ### ##### # # # ##### # # # # # #####
# #. . .    #.# # #   #   # #  .# #   # #
# # ######### # # ##### ### ### # ### # #
# #   #. . .#.# #   #   #     #.  # #   #
# ##### ### # # ### # ### ### # ### #####
# #  . .#. .#.# #   #   # #   #.#       #
# ### ### ### ### # ##### ##### # ##### #
# #. .#. .#. .#   #   #   #. . .# #     #
### ### ### # # # ##### ### ##### #######
#. .#  . . .# # # #   # # #.#   #     # #
# ############# # # # # # # # ####### # #
#. . .#     #   # # # #. . .#  . .# # # #
# ### # ##### # # # # # ####### # # # # #
#   #.#       # # # # #. . . . .#.# # # #
### # ########### # ############# # # # #
#   #.    #       # #. .  #. . .#.# #   #
##### ### ######### # # # # ### # # ### #
#. .#.  #       #   #.#.# #.  #.#. .# # #
# # # # # ### ### ### # ### ### ### # # #
#.#. .# #   #     # #.#. .#.#. .  #.  # #
# ##### ########### # ### # # ##### ### #
#.#   #         # #. .  #.#.#. . . .#   #
# # # ####### # # # ##### # ####### # ###
#.# #       # # # #.# #. .#. .#   # # # #
# ######### ### # # # # # ### ### # # # #
#. .#. . .#     # #. .#.# # #. .# # #   #
# # # ### ####### ### # # # ### # ##### #
# #. .  #. .      #. .#.#   # #.  #     #
# ######### ####### ### ##### # ### #####
#         #. . . . .  #. . . . .        #
#########################################
