####################################### #
#          . .#. . . .#       #      . .#
########### # # ##### # ##### # # ### # #
#. . . . . .#. .#  . .# #   # # # #  .# #
# ####### # ####### ### ### # ### # # ###
#. .#     # #     #. .#     # #   # #. .#
# # ####### # ### ### ####### # ##### # #
# #. .  #   # # #   #. . . . .# #. .# #.#
# ### ### ### # ############# ### # # # #
# # #. .# #   #         #    . . .#.# #.#
# # # # ### ##### ##### ########### ### #
# # # #. .# #     #       #        . .#.#
# # ##### # ### ### ##### # ######### # #
# # #. . .#     #   #   #   # #     #.#.#
# # # ### ########### ####### # ### # # #
#   #.#   #. . .      #. . .  # # #  . .#
##### ##### ### ####### ### ### # ##### #
#    . . . .  #.  #. . .  #. .# #       #
# ############# # # ######### # ##### # #
# # #. . . . . .# #.#   #. . .# #     # #
# # # # ####### # # ### # ####### #######
#   #.# #. .#   # #. . .#. . . .# # #   #
##### ### # # ### ##### ####### # # # # #
#. . .#. .#.# #   #   #. .    #.# #   # #
# ### # ### # # ### ##### ### # # ##### #
#.# # #. .#.# #     #. . .  # #.#       #
# # # ### # # ####### ##### ### ####### #
#.#   #. .#.# #. . . .    # #. .      # #
# ##### ### ### ######### ### # ##### ###
#. . . .# #. . .#     #   #. .#     #   #
# ### ### # ##### ### ##### ##### # ### #
#   # #   # #   #   #   #  .#     # #   #
# # ### ### # # ####### # # ######### ###
# #       #   #         # #. .    #   # #
##### ################# # ### ##### ### #
#   #         #       # #   #. . .#     #
# # ########### ##### ##### # ### #######
# #             #   #     # # # #. . . . 
# ############### # ##### # # # # #######
#                 #     #   #   #       #
#########################################
