####################################### #
#         #     #   #       # #   #    .#
# ######### ### # # # ##### # # ### ### #
#   #       # # # #     #   #     # #  .#
### # ####### # ####### ######### # # # #
# # #         #               # # # # #.#
# # ######################### # # # # # #
#     #   #       #   #   # # #     # #.#
# ### ### # ### # ### # # # # ### ##### #
#   #   #   #   #     # #   # #   #  . .#
# # ### ##### ####### # ##### ##### # ###
# #   #       #     # #       #     #. .#
##### ############# # ####### # ####### #
#     #        . . .# #     # #   #  . .#
# ##### ####### ### # # ### # ### ### # #
# #   # #    . .# #.# # # #. .#   #. .# #
# ### # ##### # # # # # # # # ##### ### #
# #   # #. . .# # #.# # # #.#. .#. .#   #
# # ### # ##### # # # # # # ### # # # ###
#   #   #.#     #  .# #   #.# #.#.# # # #
# # # ### ######### # ##### # # # ### # #
# # # # #. .  #. .#. . . . .# #.#. .#   #
# # # # ### # # # ########### # # # #####
# # # # #. .# #.#. .#       #. .# #. . .#
# ### # # ### # ### # ####### ### # ### #
# #   # #.# # #. .#.#. . . . .#   # # #.#
# # # # # # # ### # # ######### # # # # #
# # # # #.#   #. .#.#.#       # # #   #.#
### # # # ##### ### # # ####### ####### #
#   # # #. . . .  #.#.# #       #      .#
# # ### # ######### # # # ####### ##### #
# # #   #       #. .#.# # #  . .# #  . .#
# # # ########### ### # # ### # # ### # #
# # # # #  . . . .#  . .# #. .#.#   #.# #
# ### # # # ### ####### # # ### ### # # #
#     #   #.#   #. .# #.# #.# #.#   #.# #
########### ##### # # # ### # # # ### ###
#   #     #. . . .#.# #. .#.# #.#   #. .#
# # # ### # # ##### # ### # # # ####### #
# #   #     #     #.#    . .#  . . . . .#
################### #####################
