########### #############################
#     #  . .    #     #     #   #   #   #
# ### # # ##### # # ### ### ### # # # # #
# #   # #. .# # # #     # #     # # # # #
# # ### # # # # # # ##### ####### # ### #
# # #   # #.# # # # #           # #   # #
# # ### ### # # # # # ### ##### # ### # #
# #     #. .#   # # #. .#     # # # #   #
# ####### # ####### # # ##### ### # #####
# #. . .#.# #. . .  #.#. . .#   #   #. . 
# # ### # # # ### ### ### # ### ### # ###
# #.# #. .# #. .#. . .  # #.#   #   #.# #
# # # ##### ### ####### ### # ### ### # #
# #.#   #   #  . .#. .# #. .# #   #. .  #
### ### # ####### # # ### ### # ### #####
#. .# # # #     #.#.#. . .#   #. . .    #
# # # # # # ### # # ### ####### ####### #
#.# # # # # #   #.#. .# #. . . .#     # #
# # # # # ### ### ### ### ##### ##### # #
#.#   #   #   #. .  #. .#.#   #       # #
# ######### ### ####### # ### ######### #
#.  #. . . . . .#     #.#.#. .#     #   #
# ### ########### ##### # # # # ### #####
#. . .  #         #  . .#. .#.#   #     #
# ##### # ########### # ##### # ####### #
# #   #   #  . . . . .# # #. .# #       #
# # # ##### # ######### # # ### # #######
#   #     # #.#         #. .# # # #     #
####### # ### ########### ### # ### ### #
#     # #   #. .  #. . .#. . .# #     # #
# ### ##### # # ### ### ##### # # ##### #
# # # #     # #. . .#. .    #.  # #   # #
# # # # # # # ####### # ##### ### # # # #
# # # # # # #       #.# #. . .      # # #
# # # # ### ####### # # # ############# #
# #   #   #       # #.# #.#   # #       #
# ##### # ######### # ### # # # # #######
#     # #   #   #   #.#. .# #   # #     #
##### ##### # # # ### # ####### # ##### #
#           # #   #  . .        #       #
#########################################
