### ############### #####################
#  . .      #. .  #.#. . .#  . . . .#   #
# ### ##### # # ### # ### ### ##### # # #
# # #. .#   #.#. .#.#. .#. . .#. . .  # #
# # # # ##### ### # ### ####### #########
#   # #. .  #.# #.#. . .# #. . .# #     #
# # # # # ### # # ####### # ##### # ### #
# # # # #. .#.# #. . . .  #.#   #   # # #
# # # ##### # # ####### ### # ####### # #
# # #   #. .#. . .    #.  #.#    . . .# #
# # ### # # ##### ##### # # ##### ### # #
# # #   #.# # #. .#   #.# #. .#. .# #.# #
# ### ### # # # ### # # ##### # ### # # #
# #   # #.#   #.#   # #. .  #. .#   #. .#
### # # # ##### ##### # # ####### ##### #
#   # # #. . . .      # #. .    #. . .#.#
# ##### # ##### ########### ##### ### # #
#       # #   #   #. . . . .  #. .# #.#.#
# ####### # # ### # ####### ### ### # # #
# #     # # #   # #.#. . .# #. .  # #. .#
# # ### # ##### # # # ### ### ##### #####
# # #   #     # # #. .  #. . .    #     #
# # # ##### ### # ####### ####### ##### #
# # # #   # #   #   #   #       # #     #
# # ### # # # ##### ### ####### ### #####
#   #   #   #   # #   #       #         #
##### # ### ### # # # ####### ###########
#     # #   #     # # #         #   #   #
# # ##### ### ####### # ##### # # ### # #
# # #     # # #     #   #   # # #     # #
# ### ##### # # ### ####### ### ####### #
#   #     #   #   # #     #   #       # #
# # ####### ##### # # ### ### ##### ### #
# #     #   #   # #   # #     #   #     #
# ### # # ### # # ##### ####### # #######
# # # # #     # #           #   #   #   #
# # # ### ############# ##### ####### # #
# # #   # #           #       #   #   # #
# # # # # # ### ####### ####### # # ### #
#   # #       #                 #   #   #
#########################################
