################# ############# #########
#. . .#       #  .    #        .# #     #
# ### ####### # # ### ######### # # ### #
#.#  . . . .#   #.  #         #. .# #   #
# ### ##### ##### ########### ### # # ###
#. .# #   #. .#  . . .#       # #.# #   #
# # ### ##### ##### # # ####### # # ### #
# #. .#     #. . .# #.# #. . . . .#   # #
# ### ##### # ### ### # # ########### ###
#   #. . .# # #  . . .# #.#       #     #
### ### # # ### ####### # # ##### ##### #
# #   # #.# #   #. .#   #.# #     #   # #
# # # # # # # ### # ##### # # ##### ### #
# # # # #.#   # #.#. . . .# # #   #     #
# ### # # ##### # ########### ### # #####
# #   # #.      #.#  . . . .#   # # #   #
# # ### # ####### ### ##### ### # # # # #
# #   # #.  #   #.#. .#   #. .# #   # # #
# ### ### # # ### # ##### ### # # ### # #
#. .# #. .# #. . .#.#     # #.# # #   # #
# # # # ### # ##### # ##### # # # # ### #
#.#.# #.#   #. . . .# #  . . .# # # #   #
# # ### # ########### ### ##### # # #####
#.#.#. .# #         #    . . .# # #     #
# # # # # # ####### ######### # # # ### #
#.#. .# #   # #. .#   # #   #. .# # # # #
# ##### ##### # # # # # # # ### # # # # #
#.#   #     #. .#.# # #   #   #.# # #   #
# # ### ### # ### # ### ####### # # #####
#.#   #   # #.# #.#   #    . . .  #     #
# ### ##### # # # ### ##### ####### #####
#.  #       #.# #.  #     #.# #     #   #
# ########### # # ####### # # # ##### # #
#. .  #. . . .  #.#     # #. .#   # # # #
# # # # ######### # ### # ### ### # # # #
# #.# #. .#. . . .#   #   # #.# # #   # #
# # ##### # ############### # # # ##### #
# #. .  #.#. . . .#. . . . . .  #   #   #
# ### ### ####### # ############# ### ###
#   #. . .      #. .                    #
#########################################
