# #######################################
#. . . .  #     #   #             #     #
# ##### # # # ### # # ### ####### # # # #
# #   #.#   #     # #. .#     #   # # # #
# ### # ############# # ##### ##### # ###
#     #. . .      #. .#.#     #     #   #
########### ####### ### ####### ####### #
#    . . .#. . .#. .  #. . .#. .    #   #
##### ### ##### # ### ##### # # ##### ###
 . . .# #. . .#. .  # #. .#. .#. . .#   #
####### ##### ##### ### # ### ##### ### #
#     #. . .#.#. .# #. .#. .#     #.# # #
# ##### ### # # # # # ##### ##### # # # #
# #. . .  #.#.#.#.# #.#  . .#     #.# # #
# # ####### # # # ### ### ######### # # #
#  . .#. .#.#.#.#. .#. .#.#  . . . .# # #
##### # # # # # ### ### # ### ### # # # #
#   #.#.#. .#.#. .#. . .#. .#.#   # #   #
# # # # ##### # # ######### # # ### #####
# # #.#.#. . .# #.# #. . . .#.# # # #   #
# # # # # ##### # # # ####### # # # ### #
# # #.#. .#   # #.# #.#   #  .#   #     #
# ### ####### # # # # ### # # ######### #
#   #. . . . .# #.#  . . .# #. . . .  # #
### ######### # # ####### # ####### # ###
#   #       #.# #. .#   #.#     #. .#   #
# ######### # # ### # ### ####### # ### #
# # #     # #.# #. .# #. .#. . . .#   # #
# # # ### # # ### ### # ### # ####### # #
# # # # #   #. . .#   #.#  .# #     # # #
# # # # ########### ### ### # # ### ### #
#   # #. . . . .#. . .#.#. .# # #       #
### # # ####### # ### # # # # # #########
#   #  . .#   #. .# #.#.#.# # #     #   #
# ####### ### ##### # # # ### # ### ### #
# #      . . .#   # #. .#.#   #   #   # #
# ########### ### # ##### # ####### # # #
# #     #    . . .#    . .# #     # #   #
# # ### ######### ##### # # ##### # #####
#   #            . . . .# #       #     #
#########################################
