### #####################################
#. .    #         #     #. . .        # #
# # ### # ####### # ##### ### ####### # #
#.#   #   #       #. . . .  #. . . .#   #
# ################# ####### ##### # #####
#.#. . . . . .#. . .  #. .#     # #. .  #
# # ######### # ####### # ##### ### # ###
#. .        #. .    #. .#. . .#   # #. .#
# ################### ####### ### ### # #
# # #. . . . .#. . .#.#      .# #   # #.#
# # # ####### # ### # ####### # ### ### #
#   #.#   #  .#.# #.#. . . .#. .# #   #.#
##### # # ### # # # ####### ### # ### # #
 . . .# #   #.#.# #. . .#. .# #.#     #.#
####### ### # # # ##### # # # # ####### #
#       # #  . .#. .#. .#.# # #. .#    .#
# ####### ####### # # ### # # ### ##### #
# #       #     #.#.#.#. .# #    . . . .#
# ##### # ### # # # # # ########### ### #
#   #   #     # #.#. .#. . . . .# # #   #
### # ######### # ##### ####### # # # # #
#   # #   #   #  . . .#   #. . .#   # # #
##### # ### # ####### ##### # ####### # #
#     # #   #     #  . . . .# #       # #
# ##### # # ##### ########### # # ##### #
# #     # # #           #     # # #     #
# # ##### ### ######### # ##### # # ### #
# # #     #   #           #     # #   # #
# # # ##### ### ########### # ### # # ###
#   #   #   # #     #     # # #   # #   #
####### # # # ####### ### # # ######### #
# #   # # # #         #     #         # #
# # ### # ######### ##### ### # ##### # #
# # #   #   #         #   #   #     # # #
# # # ##### # ####### # ### ####### ### #
# #   #     # # #   # # #   #     #   # #
# ########### # # # # # # ### ### ### # #
#   #   #   #   # #   # #   #   # #   # #
### # # ### ##### ######### ### ### ### #
#     #           #         #       #   #
#########################################
