####################### #################
#    . . .#          . .  #   #   #     #
# ### ### ########### # # # ### # ##### #
# #. .#  . . .#  . . .# #   #   #       #
### ### ##### ### ##### ##### ###########
#. .#   #. .#. . .#     #     #     #   #
# # ##### # ##### # ##### ##### ### # # #
#.# #. . .#. . .# #         # # # #   # #
# ### ######### ##### ##### # # # ##### #
#. . .        #. .  # #   #   #   #     #
############# ### # # # # ####### #######
 . . . .#   #   #.# # # #       #       #
####### ### ##### # ### ####### ##### ###
#. .  #. . .#. . .#           #         #
# # ####### # # # # ########### ####### #
#.#. .  #. .#.# # # #         #       # #
# ### # # ### ### # # ####### ##### # ###
#.# #.# #.#  . .# # # #     #     # #   #
# # # ### ##### # ### # ##### # # # ### #
#.# #. . .#. . .#     # #   # # # # #   #
# # ####### # # # ##### # # ### # # # # #
#. .#  . . .# # #   #   # #     # # # # #
### # # ####### ### # ### ####### ### # #
#. .# #. .#     #   #   # #     # #   # #
# ####### # ##### ##### # # ### ### ### #
#.#. . .#.#     # #     # # #   #   # # #
# # ### # ##### ### ##### ### ### ### # #
#.#.#. .#. .  #     #           #   # # #
# # # ### # # ################# # # # # #
#. .#.# # #.#   #       #     # # # # # #
##### # # # ### # ##### # ### # ### # # #
#   #.# # #.  #       # # #   # #   #   #
# ### # # # ########### # ### ### # #####
#. .#.#   #. .  # #     #   #   # #   # #
# # # ####### # # # # # ### ### # ### # #
#.#. .#. . . .#   # # # # #   # #   # # #
# ##### ########### # # # ##### # # # # #
#.#    .#   #   #   # # # #     # # #   #
# ##### # # # # ### # # # # ####### #####
#. . . .# #   #     # #   #             #
#########################################
