############# ###########################
#            .  #. . . . .    #. . . .  #
##### ####### ### ####### ##### ### # # #
#     #      . . .#     #. . . .  # #.# #
# ##### ######### ##### # ####### # # ###
#     # #. . . .#     # # #. . .# # #. .#
##### # # ##### ##### # ### ### # ##### #
#   # # #.#. .#. . .#   #. .# #.#     #.#
# ### ### # # ##### ##### ### # ####### #
#     #. .#.#. .#  . .#. .# #. .  #  . .#
####### ### ### ##### # ### # ##### # # #
#     #. . .  #. .#  . .# #. .#     #.# #
# ##### # ####### # ##### # ######### ###
#       # #. . . .# #   #  . . . .#  . .#
########### ####### # # ######### ##### #
#  . . . . .#       # #       # #.#. . .#
# # # ####### ####### ####### # # # ### #
# #.# #       #       # #   #. . .#. .# #
# # # # ####### ####### # # # ####### # #
# #.# #   # #   #     #   # #.#    . .# #
### # # # # # ### ##### ##### ##### # # #
 . .# # # # # # #   #   #. .#.#. . .# # #
### # # # # # # # # # ### # # # ####### #
#   # # #   # # # #   #. .#.#.#.#   #   #
##### ####### # # ##### ### # # # ### ###
#   #   #     # # # #. .  #. .#.#     # #
# # ### ##### # # # # ##### ### ####### #
# #     #     #   #  .#   # #  . . .    #
######### ##### ##### ### ### # # # #####
#     #     # # #   #. .#   # # # #. . .#
# ### ##### # # # # ### ### # # ####### #
# #       # #   # #   #.  # # #       #.#
# ####### # # ####### # ### # ######### #
#     #   # #   #   #  .#   # #. . . . .#
####### ### # ### # ### # ### # ####### #
# #     #   # #   #    .#     #.#     # #
# # ####### # # ####### ####### # ##### #
# #     #   # #   #   #. . . . .# #   # #
# ##### # ### ##### # ######### # # # # #
#         #         #           #   #   #
#########################################
