##################################### ###
#         #   #           #    . . .#. .#
# ####### # # # ##### ### ### # ### # # #
# #       # #   #     #       #.# #.# #.#
# ### ########### ### ######### # # # # #
#   # #       #   #   #        .#  .# #.#
# # # # ### # ##### ### ####### ### ### #
# # # # #   #     # #   #   #  . .#. . .#
### # # # ####### # # # ### # # # ##### #
#   # # #   # #   # # # #   # # #.#     #
# ### # ### # # ### # ### ##### # #######
# #   # #   # #     # #   #     #. .    #
### ##### ### ####### # ### ####### #####
#   #     #. . .#   #   #   #. . .#. . .#
# ### # ### ### ### ######### ### # ### #
#     # #  .#  . .#      . . .# #.#   #.#
# ##### # # ##### ####### ##### # ##### #
# #   # # #.#. .#. . . .#. . .# #. . . .#
### # ### # # # ####### ##### # ### ### #
#   #     #.#.#. . .# #. . .#.#     #   #
# ######### # ##### # ##### # ####### ###
# #   #  . .#.#. .#.#   #. .#. . .  # # #
# ### # # # # # # # ### # ####### # # # #
#   # # #.# #. .#.#. .#  . . . .#.# # # #
# # # # # ####### ### ######### # # # # #
# #   # #. .  #. .# #.#. .#    . .# #   #
# ##### # # ### ### # # # # ########### #
# # #   # #. . .# # #. .#.# #. . . .  # #
# # # # # ##### # # # # # # # ##### # ###
# # # # # #   #   # # # #.# #.  #. .#   #
# # # ### # # ##### # ### ### ### ##### #
# # #   #   #     # #   #.#. .#. .#     #
# # # # ####### ### ### # # ### # # #####
#   # #       #     # # #. .  #.# # #   #
# ### ### ### ####### # ##### # # # ### #
# # # # # #   #   #   # #   # #.# #   # #
# # # # # ##### # # ### ### ### ##### # #
# # # # #     # # #   #   # #. .#     # #
# # # # # ### ### ### # # # # # # ##### #
#   #   #   #         # #   #.# #       #
############################# ###########
