### ########### #########################
#  . .      # #.#   #                   #
# # # ##### # # # ### # ############### #
# # #. .# # # #. .#   #         #   # # #
# # ### # # # ### # ####### ### # # # # #
# # #. .# # #    .#       #   # # #   # #
# # # ### # ##### ####### ### ### ### ###
# # #.#   # #   #. . .# # # #   # # #   #
# ### # ### # # ##### # # # ### # # ### #
# #. .#     # #     #. .# #     #   #   #
### # # ##### ##### ### # ########### ###
#. .# # #     #   # # #. .      #     # #
# # # ### ##### ### # ### ##### # ##### #
#.# #   #   # #     # # #.#   #   #   # #
# # # # ### # ####### # # # # ##### ### #
#.# # #   #   #   # #. . .# # #   # #   #
# # ### ##### ### # # ####### # # # # ###
#.#   #       #   # #. . . .# # # # #   #
# ### ####### # ### ####### # # # # ### #
#.  #       # # # # #   # #.# # #     # #
# ######### # # # # # # # # # ##### ### #
#. . . .#   # #   #   # # #.# #     #   #
# ##### # ####### ##### # # # # ##### ###
# #. . .#         #   # #  . .  #   #   #
# # # ########### # # # ##### ##### ### #
# #.# #. . . .  #   # #   # #.#   #     #
### ### ##### # ##### ### # # # # ### # #
#. .#. .    #.#     #   # #  .# #     # #
# ### ##### # ##### ### # ### ######### #
#. .#.#. .# #. .  # #   #   #. .      # #
# # # # # # ### # # ####### ### ####### #
# #. .#.#.#   #.# #     #   # #.      # #
# ##### # ##### # ##### # ### # ##### # #
#     #.#. . . .# #   #     # #.#   #   #
####### ######### # ######### # # # #####
#. . . .#. . . .# #. . . .  # #.# #     #
# ##### # ##### # # ##### # # # # ##### #
#.#. .# #. .# #.# #.#   #.#   #.#     # #
# # # ##### # # ### ### # ##### ####### #
#. .#. . . .  #. . .    #. . . .        #
#########################################
