##################################### ###
#           # #   # #     #          .  #
# ######### # # # # # ### ##### ##### # #
# #   #     # # #   # # #       #  . .# #
# # # ##### # # ##### # ##### # # # ### #
# # #     # #     #   #     # # # #. .# #
# # ##### # ##### # # ##### ### # # # # #
#   # #   #   # # # #     #   # # # #.# #
##### # ##### # # # ### # ### # # ### ###
#   #   #. .# #   # # # # #   # #   #. .#
# ####### # # # ### # # # # ####### # # #
#    . .#.#. .# # #   # # #         # #.#
##### # # ### # # ##### # ########### # #
#  . .#. .# #.# #       #           # #.#
# # ####### # # # # ################# # #
# #.#     #. .# # # #     #   #       #.#
# # # ##### ### # ### # ### # # # ##### #
# #.#      .#   # #   #   # # # # #   #.#
# # ####### # ### # ### # # # # # # # # #
# #. .#   #. .  #     # # # # # #   # #.#
# # # # # ### ####### ### # # ######### #
# # #.# #   #.#   #   #   # #   #  . . .#
# # # # ### # # # ##### ####### # # # # #
# # #.#   #. .# # #   # #. .# #   #.# # #
# ### ##### ### ### # # # # # ##### ### #
# #. .#. .#. .#   # #   #.#. . . . .#   #
# # ### # ### ### # ##### ####### # # ###
# #.#. .#. .#. .# # #    .#. .#   # # # #
# # # ##### ### # # ##### # # ##### # # #
# #. .  #. .#. .#   #. .#. .#. . .# #   #
# ####### ### ####### # # # ##### #######
# # #. . .#. .#  . . .#.# #     #. . .  #
# # # ##### ### # ##### # ##### ##### ###
# # #.# #. .#   #.#   #.# #. .#     #. .#
# # # # # ### ### # ### ### # ######### #
# # #.#. .# #   #.#    . . .#. . . . . .#
# # # # ### ### # ##################### #
# # #.#. . . .# #. . . .# #             #
# # # ####### ######### # # ########### #
#   #.#      . . . . . .#   #           #
##### ###################################
