##################### ###################
#        . .#    . .#.    #       #     #
### ##### # ##### # # # ### ##### # ### #
#   #. . .#. . . .#.#.#   #     # #   # #
# ### ############# # ### ##### # ### ###
# #. .#     #      . .  #   #   # # #   #
### ### ### ######### # ### ##### # ### #
#. .# # #     #       #   #     #     # #
# ### # ##### # ############### ### ### #
#.#   #   # # #   #     #       #   #   #
# # ##### # # ### # ### # ####### ### ###
#.#   #   #   #   #   #   #. . . . . .  #
# ### # ##### ####### ##### ### ##### # #
#.  # #     #   #     #. . .  #     #.# #
# # # ### # ### # ##### ##### ##### # # #
#.# #   # #   #   # #. .#   #     # #.# #
# # ### ##### # ### # ##### ##### # # ###
#.#   # #     # #   #.      #   # # #. . 
# ### # # ####### ### ######### # # #####
#. .# #   #       #. .#   # #   # #     #
# # # ##### ####### ### # # # ### ##### #
# #.#     #. . .  #.#   #   # #   #   # #
### ####### ### ### # ##### # ### # # # #
#. .#. . . .# #. . .# #   # #   #   # # #
# # # ####### ####### ### # ### ##### ###
#.# #. .#  . . .#     #   #     #   #   #
# ##### ### ### ####### ####### # ##### #
#. .  #. .#. .#. . . . .  #   #   #     #
# # ##### ### ### ##### ### # ### # #####
# #. . .#. . .#   #   #.#   # #   # #   #
# ### # ########### ### # ##### ### ### #
#   # #.      #     #. .# # #     #   # #
# # ### ##### # ##### ### # # ####### # #
# #   #. . .#   #   #.# # #     #   #   #
# ### ##### ##### ### # # # ##### # #####
# #   #   #.    #. .#.#. .# # #   #     #
### # # ### ##### # # # # # # # #########
#   # # #. .#. . .#.#. .#.#       #     #
# ##### # ### ##### ##### ##### ### ### #
#       #. . .    #. . . .          #   #
#########################################
