############################### #########
#    . . . .#     #     #      .        #
# ### ##### ##### # ### ### ### ##### ###
#   #.#    . .# # #   #   # # #.    #   #
##### ####### # # ####### # # # ### # # #
#. . .#   #  .#. . . .#   #   #. .# # # #
# ##### # ### # ##### # ####### # # ### #
#. .#   #    . .#   #.#     #   #.# #   #
# # ############# ### ##### # ### ### ###
# #. . . .#. . .# #. .#   # # #  . .#   #
# # ##### # ### # # ##### # # ### # ### #
# #     #. .  #.#  . . . .#   #   #.  # #
# ########### # ######### ##### ### ### #
#   #     # # #. .#     #. .#   # #. .# #
### # ### # # # # ##### ### ##### # # ###
# # #   # # # # #. . .#   #. . .#   #. .#
# # ##### # # # ##### ### ##### ####### #
# #       #   # # #. .  #      . . . .#.#
# ############# # # ### ############# # #
#        . . .#   #. .# #            . .#
######### ### ####### # # ########### # #
# #  . . .#  . . . .#.# #   #         # #
# # # # ########### # # ### # ######### #
#   #.# #   #   #. .#.#   # #     #   # #
##### # # # # # # ### ##### # ##### # # #
#  . .# # # # #. .#. .#     # #     # # #
# # ### # # ### ### ### ####### # ### # #
# #.#   # #    . . .#   #     # # # #   #
### # ### ##### ##### ####### ### # #####
#. .# #   #     #     #       #   #     #
# ##### ### ##### ### # ####### # ##### #
#.#     #   #     #   # # #     # #     #
# ######### ### # ##### # # ### # # #####
#. .    #   #   # #       # #   # # #   #
# # ##### ### ### # ####### ### # # ### #
# #.  #   #   #   # #   #     # # #     #
# # ### ##### ##### # # ### # # ####### #
# #. .# #   #       # #   # # #       # #
# ### # ### # ####### ### # # ### ##### #
#   #.#     #         #   # #   #       #
##### ###################################
