##################### ###################
#              . . . .#       #. . .    #
# ########### # ### # # ####### ### ### #
#     #       #.#   #   # #. . .#. .  # #
##### # ####### ######### # ##### ##### #
#   # #   #   #. .  #. . . .    #.#   # #
# # ### # # # # # ### ########### ### # #
# #   # # # #   #. .#. .  #. . . .#   # #
##### ### ######### ### ### ##### # ### #
 . .#     #. . . .#.  #.#. .# #   #     #
### ####### ##### # # # # # # # #########
#  . . .#  . .#  . .# #.#.# #   #  . . .#
####### ##### ####### # # ######### ### #
#      . . .#. . .#   #.#. . .    #. .#.#
# ######### ### # ##### ##### ### ### # #
# #   #   #. .# #.#. . .#   #.# # #. .#.#
# # # # # ### ### # ##### ### # # # ### #
# # # # # #  . .#.#.      #. .#   #.  #.#
# # # ### ##### # # ####### # ##### ### #
# # #   #     #.#. .    #  .#   #. .#. .#
# # ### ##### # ### ### ### ##### ### # #
# # # # #   # #. .#   #   #. . . .  #.# #
# # # # ### # ### ####### # ####### # # #
# # #       #    . . .# # # #. . .# #.# #
# # ####### ######### # # ### ### # # ###
# #   #   #          . .# #. .# #.# #. .#
### # # ############### ### # # # ##### #
#   # #     #   #     #. . .# #  . . . .#
# ### ##### # ### ######### # ####### # #
#   #     # #   #   #       # #   #   # #
# # ##### # ### ### # ####### # ### ### #
# # #   # #   #       #   #   # #   #   #
### # ### ### ####### # # # ### # ### ###
#   #     # #   #     # # # #   # #   # #
# # ####### ### ### ### ### # ### # # # #
# # #         #     #   #   #   # # #   #
# ### ##### ######### ### ##### # # # ###
#     #   # #       #   # #   #   # # # #
# ##### # # # ### ##### # ### ##### # # #
#       # #     #       #     #     #   #
#########################################
