####### #################################
#     #. . .    #       #. . .    # #   #
# ##### ### # ### ##### # ### ### # # # #
#       #. .#     #. .# #.#. .  # #   # #
######### ######### # ### # ##### ##### #
#       #. .  #. . .#. . .#. . .#     # #
####### # # ### ####### ####### # ##### #
#       # #. . .  #   #       #.#       #
# ####### ##### # # # ######### #########
# #   #       # # # # #  . . .#. .      #
# # # ####### # # ### # # ### ### #######
#   #       # # #     # #. .#. .#. .#. .#
# # ####### # # ######### # ### # # # # #
# # #   #   # # #. . . .# #.#. .# #. .#.#
### # # # ### # # ##### ### # ### ### # #
#   # # #     # #. .# #. . .#.# #   # #.#
# ### # ##### # # # # ####### # ### ### #
# # # # #     # # #.#     #  . .#   #. .#
# # # ### ##### # # ##### ##### ##### # #
#   #     #     # #. . .#   #  .#. . .# #
# ############# # ##### ### ### # ### # #
# #           # #   #. .  #    . .#   # #
### ##### ### # ##### # ####### ### ### #
#   #     #   #   #. .#     #   #   # # #
# ### ####### ### # ######### ### # # # #
# #   #     #     #.#. . . .#   # # # # #
# # # # ### ####### # ##### ### # ### # #
# # #   # # #    . .#. .# #.  # #     # #
# # ##### # ##### # ### # # ### ####### #
# #       #   #  .#   #. .#. .# #       #
# ########### # # ### ### ### # ### #####
#       #     # #. .#   #. .#.#   # #   #
####### # ####### # ####### # ### # # # #
# #     # #     # #. . .  #.#. .# # # # #
# # ##### # ### ### ### ### ### # # # ###
#   #     # # #   #   #. . .  #.# # #   #
##### ### # # ### ######### ### # # ### #
#     #   #   # # #       # #. .# #     #
# ########### # # # ##### # # # # #######
#               #   #     # #.# #       #
############################# ###########
