######################### ###############
#   #   #   #   #   #    . . .        # #
# # # ### ### # # # # # # ### ####### # #
# # #   #     # # # # # #   #. .    # # #
# # ### ####### # ### # # # ### ##### # #
# # # #     #   # #   # # #   #. . .#   #
# # # ### # # ### # ### ########### ### #
# #     # # # #     #   #    . .#. .  # #
####### # # # ####### ### ### # # # # # #
#     #   # #         #   #  .#. .# # # #
# ### ##### ########### ### # ####### ###
# # #       #     #     #   #.#     #   #
# # ######### ### ##### ##### # ### ### #
# #   #       #       #     #.#   #     #
# ### # ##### ####### ##### # ###########
#   # #   #   #  . . . .#   #. . . . .  #
### # # # # # # # ##### ######### # # ###
#   # # # # # # #.#   #. .#. . .# # #. .#
# ### # # ### # # ### ### # ### # ##### #
# #   # # #   # #. .#    . .#. .# #. . .#
# # ##### # ### ### ######### ### # ### #
# # #     #   #   #. .#     #.#   #.#   #
# # # ##### # ####### # ### # ##### #####
#   # #     # #. . .#.#   # #. . .#. . .#
# ### ####### # ### # ### # ##### # # # #
# #   #       #.#. .#. .# # #. . .# # #.#
# # ### ####### # ##### ### # ##### ### #
# #   #   #. . .#.#  . .#   #.# #   #. .#
# ######### ##### # # ### ### # # ### ###
#   #    . .#   #.# #. .# #. .  #   #. .#
### # ### # # # # ##### # # ########### #
#     #  .# # # #. . . .#. .#    . . . .#
####### # # # ########### ### ### ##### #
#     # #.# #   #   #. . .#   #  .#     #
# ##### # ##### # ### ##### # # # #######
# #     #. .  # #. . .#     # # #. .  # #
# # # ### # ### # ############# ### # # #
# # # #   #. .# #.#    . .#     #. .#   #
# ### # ##### # # ##### # ####### # #####
#     #     #.#  . . . .#. . . . .#     #
############# ###########################
