################################### #####
#       # #              . . .#    . . .#
# ##### # # ####### ##### ### ##### ### #
#     #   #   #     # #  .#  . .# #   #.#
##### ####### # ##### # # ##### # ##### #
#     #   #   # #   # # #.#   #. .#. . .#
# ##### # # ### # # # # # # # ### # ### #
# #   # # # #   # # # # #.# # # #.#.#   #
# # ### # # # # ### # # # ### # # # #####
#       # # # # #   # # #. .# #. .#. .  #
# ####### # # ### ### # # # # # ##### ###
#     # # # #     #   # # #.#  . . .#. .#
##### # # ######### ### # # ####### ### #
#   # # # #       # #   # #. . .#  . . .#
# # # # # # ##### # ### # # ### ####### #
# # # # # # #   # #     # #   #. . .#   #
# ### # # ### # # ### # # ####### # #####
# #   # #     #   #   # #   #   # #.#. .#
# # ### ########### ### ### # # ### # # #
#       #         # #     #   #   #.#.#.#
####### # ######### # ########### # # # #
#     # #         # # #           #. .#.#
# ##### ######### # ### # ######### ### #
#     # #       # #   # # #    . .# #. .#
##### # ##### # # ### ### ##### # ### # #
#   # #       # # #   #   #. . .#. . .# #
### # ######### # # ### ### # ####### # #
#   #       #     #   # #  .# #       # #
# ######### ##### ##### # # ### ####### #
#         #   #         # #.#   #       #
# ####### ### # ######### # # ### # #####
# #    . .# # # #       # #.# #   # #   #
# # ### # # # ### ##### # # # ### # # # #
# # #  .#. . .#   #. .# # #.# #   # # # #
# # # # ##### # ### # # # # ### ### # # #
# # # #.# #. .# #. .#.#   #. .# #   # # #
### # # # # ##### ### ##### # # ##### # #
#   # #.#. .#  . .#  .#. .# #.# #     # #
# ##### # ##### ##### # # ### # # ##### #
# #. . .#. . . .#    . .#. . .#   #     #
### #####################################
