####### #################################
#      .  #. . .        #     # #     # #
# ##### ### ### ### # ### ### # # ### # #
#     #. .#.# #.  # #     #   # #   #   #
##### # # # # # # # ########### ### ### #
#     # #. .  #.# #       #     #   #   #
# ############# # ### ##### ### ##### ###
#           #. .#   #     # # # #     # #
############# # ### ##### # # # # ##### #
#. .#. . . . .# # #     # # #   #   #   #
# # # ####### # # ##### # ### ### ### ###
#.#. .#   #   #   #. .# #   # #   #   # #
# ##### # # ####### # ##### # # ### ### #
#. . .# #   # #. . .#. . .#     #   #   #
# # # ####### # ####### # ### ### ### # #
# # #. .      #.  #. .# #.  #   #     # #
# # ### ####### ### # ### # ##### ##### #
# #   #. . . . .#. .#. .#.#     # #     #
# ############### ##### # ##### # # #####
#   #         #. .#. . .#. .  #   # #   #
### # ######### ### ##### # # ##### # # #
#   # #  . . .#.# #.#     #.#   # # # # #
# # # ### ### # # # # ##### ### # # # ###
# # #   #.# #.#.# #.# #. . .  #   # #   #
# # ### # # # # # # ### ### # ##### ### #
# # #   #.#  . .#  . . .#   #     #   # #
# ### ### ############# # ### # # # # # #
#     #. .#. .# #       # #   # # # #   #
####### # # # # # ####### ##### # # # ###
#    . .# #.#.#   # #   #   #   # # #   #
# ### ### # # ##### # # # # # ### # ### #
#   #.#   #.#. .    # # # # # #   # #   #
### # # ### ### ##### # ### # # # # #####
#   #.# #. .# #. . .# #     # # # # #   #
##### ### ### # # # # ### ##### ### # # #
#. . .#. .# # # # #.#   # #     #   # # #
# ### # ### # # ### ### ### # ### ### # #
#.#   #.    # # #. .  # #   # #   #   # #
# ##### ##### # # ##### # ### ##### ### #
#. . . .      # #.#     #   #       #   #
################# #######################
