##### ###################################
#   #. . .              #           #. .#
# # # # # ##### ######### ########### # #
# #   # #. .#   #         #    . . . .#.#
########### # ### ############# ####### #
#. . .#. . .#             #   #.# #   #.#
# ### # ### ############### # # # # ### #
#. .#. .#   #. . .      #   # #. . .#. .#
# # ### ##### ### ##### # ### ##### # # #
# #.#   #. . .  #.#     # # #     #.#.# #
# # # ### ####### ####### # ####### # # #
# #.# #. .  #   #. .  #   #. . . . .#.# #
# # ### ##### # ### # # ### ######### ###
# #. . .      # #. .# # # #.#       #. .#
################# ### # # # # ##### ### #
 . . . .#  . . . .#   # #. .  #. .#   #.#
####### # # ####### ### # ##### # ### # #
#   #  .# #.#. . .#   #. .  #. .#. .# #.#
# # ### # # # ### ##### ##### ##### ### #
# #   #.# #. .  #. . . .  #. .#. . .#. .#
# ### # # ################# ### ##### ###
# #   #.#     #. . . . . .#.#  . .#  . .#
# # ### ####### ######### # ##### ### # #
# # # #.#. . . .#   #. . .#. .# #. .# #.#
# # # # # ##### ### # ##### # # ### ### #
# # #. .#.#   # #   #.#   # #.# #  . .#.#
# ### ### # # # # ### ### # # # ##### # #
#   #.#. .# #   #   #. .# # #.#   # #.#.#
### # # # # # ##### ### # # # ### # # # #
#   #.#.# # # #   #   #.#   #.  # #. .#.#
# ### # # # ### # ### # ##### # # # ### #
# #  . .# #   # #   #  .#  . .# #  .#  .#
# ### ### # # # ####### ### # ##### # # #
#     #   # # # # #   #. . .# #   #.# #.#
####### ##### # # # # ######### # # ### #
#       #     # #   #   #       #  . . .#
##### ### ### # ### ##### ############# #
#     #     # #           #     #   #   #
# ######### ############### ### # ### # #
#         #                 #   #     # #
#########################################
