############### #########################
#         #    .      #                 #
# ####### # ### ### ### ### ########### #
#     # #   #  .  #       #         #   #
##### # ####### # ### ############# # # #
#   # #    . . .#   # # #         # # # #
# ### ##### ####### # # # ######### # ###
#   #     #.#     # #   #     #     #   #
### ##### # ##### # ######### # ### ### #
#. . . .# #. .  # #         #   #   #   #
# ##### ##### ### ####### # ### ##### ###
#.#   #. . .#. .#       # # #   #   #   #
# ### ##### # # ####### ### # ### # ### #
#. .# #. . .# #. . . .#     #   # # #   #
### # # ##### ####### ########### # #####
#. .#. .#     #     #. .          #     #
# ### ### ##### ####### ############### #
#.#  . .#       #. . .#.  #         #   #
# ##### ######### ### # # # ######### # #
#. .#  . . . . . .#  . .# # #         # #
### ##### ############# # # # ######### #
#. .#     #       #     #   # #         #
# # # ##### ##### # ######### # #########
#.# # #     #       #       # # #   #   #
# # # ##### ######### ##### # # # # # # #
#.# #   #         #   #     # # # # # # #
# ##### ########### ##### ### ### # # # #
#. .# #     #       #         #   #   # #
### # ##### # # ############### ####### #
#. .#     # # #   #                   # #
# ####### # ##### # ################### #
#. . . .# #   # #   # #. . .        #   #
# ### # # ### # ##### # ### ####### # ###
#   # #.#   # #. .#. . .#. .#. . .# # # #
# # ### ### # # # # ##### # # ### # # # #
# #   #. .#   #.#. .#   #.# #.  #.# #   #
# ### # # ##### ####### # ### ### # #####
# # # # #. . .#.    #   #.#. .#. .#   # #
# # # ####### # ##### ### # ### ##### # #
#   #       #. .      #  . .  #. . .#   #
################################### #####
