############### # #######################
#     #     # #.#.  #. . . . .          #
### # ##### # # # ### ##### # ##### ### #
#   #     # #. .#. . .#. .# #. .#   #   #
# ####### # # ######### # # # # #########
# #     # #  . . .#. . .#.# # #. .      #
# # ##### ####### # ##### # # ### ##### #
# #     # #      . .#. . .# #   #.#     #
# # ### # # ######### ##### ### # #######
# # # #   # #       #.# #   #   #. . . .#
# # # ##### ### ##### # # ####### ##### #
# # #     #   #   #. .  # # #. .#   #. .#
### ##### ### ### # ##### # # # ### # # #
#   #       # # # #.#     # #.#. .# #.# #
# ### # ### # # # # # ##### # ### # # # #
# #   # # # # #   #.#   #   #.# #.# #.# #
# ##### # # # # ### ### # ### # # # # # #
#       # # # #   #.# #   #  .#. .# #.# #
######### # # ### # # ####### # ### # # #
# #     #   # #   #. .#  . . .#.#   #.# #
# # # # # ### # ##### ### ##### # ### ###
# # # # # #   #   # #. . .#. . .# #  . .#
# # # # # # ##### # ####### ##### # ### #
# # # # # #   #   # #. . .#.#     # #. .#
# # # ### ##### ### # ### # # ####### # #
#   # #   #     # #. .# #. .# #. . . .# #
# ### # ### ##### # ### ####### ### ### #
# # #   # # # #. . .#  . . . .#. .# #   #
# # ##### # # # ##### # ##### # # # # # #
#         # # #.#     #.# #. .# #.# # # #
######### # # # ####### # # ### # ### ###
#   #   # #. .#. .#. . .#. .  # #. .#   #
# # ### # # # ### # ##### ##### # # ### #
# #     #. .#.#. .#. .# #.#     # #.#   #
# ##### # ### # ##### # # ######### #####
#     # #.# #.#.#  . .# #. .#  . .#. . .#
##### # # # # # # # ### ### ### # # ### #
#   # #  . .#. .# #. .# #  .#. .#.#   #.#
# # ####### ######### # ### # ### ##### #
# #        . . . . . .#    . .#  . . . .#
#########################################
