############################# ###########
#           #    . .#. . . .#. . .      #
# ####### ### ### # # ##### # ### ##### #
# #   #       #  .#. .#  . .#   #. . .# #
### # # ####### # ####### ########### # #
#   # # #   #   #. .#   #.#    . . .#.# #
# ### ### # # ##### # # # # ### ### # # #
#   #     # # #  . .# # #.#   #.# #. .# #
### ######### ### ##### # ##### # ### # #
# #     #     #. .#     #.#  . .#     # #
# ##### ### ### ### ##### # # # ####### #
#   #       #  .#   #  . .# #.# #. . .# #
### # ####### # # ##### ### # ### ### ###
# # # #   #   #.#      . .# #. . .# #. .#
# # # # # # ### ######### # ####### ### #
#   # # #   #  .  #. . .#.#     #   #. .#
# ##### ##### # ### ### # ##### # ### # #
#     # #   # #. . .# #.#. . .#   #  .# #
##### # ### # # ##### # ##### ####### # #
#     #   #   #       #.#   #.#  . . .# #
# ####### ############# ### # ### ### # #
#         #. . . . . . .#   #.#. .#   # #
########### ##### ####### ### # # ##### #
#     # #  . .#   #     # # #.#.# #     #
# ### # # # # # ### ### # # # # ### #####
#   #   # # #.#   #   # #. . .#. .# #   #
### ##### # # ######### # ##### # # ### #
#   #     # #. . . .#   #. . .# #.#     #
# ### ### # # ##### # ####### ### #######
#   # #   # #     #.#       #. . .      #
### # # ### ####### ####### ### # ##### #
# # # #   #   #. . .      #     #     # #
# # ##### ### # ################# ##### #
# # #     #   #. . . . .#. .    #     # #
# # # ########### ##### # # ####### # # #
#   # #         # #   #. .#.#     # # # #
# ### # ####### # ### ##### # ### # # ###
# #           # #   #     #.#   # # #   #
# ############# ### ##### # ### # ##### #
#                 #       #.#   #       #
########################### #############
