############# ###########################
#   #        . .    #   #     #   #     #
# # ######### # # ### # ##### ### ### # #
# #           #.#     #     #   #     # #
# ############# ######### # ### ####### #
# #         #  .        # # # #   #   # #
# # ####### # # ######### # # ### ### # #
# # #. . . .# #.  #     # # #   #       #
# ### ##### ### # # ### # # ### ####### #
# #. .#    . .#.# # # # # #     #   #   #
### ### ##### # # # # # # ####### ### ###
#. .#   #. .#. .# # #           #       #
# ####### # ### ### ########### # #######
#. . .  #.#.# # #   #       #   # #     #
##### ### # # # # # # ##### # ### ##### #
 . .#. . .#.#   # # #   # # #   #     # #
### # ##### ##### ##### # # ######### # #
#. .# #. . .  #   #     # # #       # # #
# ### # ### # # ### ##### # # # ##### # #
#.#   #. .# # #   # #   # # # #     #   #
# # ##### ### ### # # ### # # ##### # ###
#.#     #. .# #   #. . .# # #     #     #
# ##### ### ### ### ### # # # ######### #
#. .# #   #.#   # #.# #.#   # #     # # #
### # ### # # ### # # # ##### # ### # # #
# #. . .# #.# #   #.  #. .      #   #   #
# ##### # # # # ### ##### ############# #
# #   #.# #.#   #. .#   #.          #   #
# # # # # # ##### ### # # ####### # #####
# # # #.# #. . . .    # #. . .  # #     #
# # ### # # ############# ### # # ##### #
# #. . .# # # #. .#  . .#   #.# #     # #
# # ##### # # # # ### # ##### ##### # ###
# #.    # #   #.#. . .#. .#. .#   # #   #
# # ##### ##### ######### # ### # ##### #
# #.#   # #. . .#        . .# # # #     #
# # # # # # # ### ########### # # # ### #
# #.# #   #.# #   # #         # #   # # #
# # ####### # # ### # ######### ### # # #
#  . . . . .# #     #           #   #   #
#########################################
