####################################### #
#    . .#   #                . .#  . . .#
##### # # # ############# ### # # # ### #
#. .#.#.# #   #           #. .#.# #. .# #
# # # # ##### # ########### ### ##### # #
#.#. .#. . .# #         #. .# #. . . .# #
# ### ##### # ######### # ### ##### ### #
#. .# #. .#.#. . . .#   #.#   #     #   #
# # ### # # # ##### ##### # ######### # #
# #. . .#.#. .#   #. .#  .#     #     # #
# ##### # ##### # ### ### ##### # # ### #
# #   # #. . .# #    . . .  # # # #   # #
# ### ####### # ######### # # # ##### # #
#   # #. . . .# #       # # # # #     # #
### # # ####### ### ### # # # # # #######
#   # #.#       #   # # # # #     #     #
# ### # ######### ### # ### ##### # ### #
# #   #. . .    #   #         #   # #   #
# # ### # # ### # # ####### ### ### # ###
# #   # # #. .# # #   #   #   # # # #   #
# ### # ### # # ##### # # ### # # # ### #
#     #   # #.#     #   # #   # # #   # #
# ####### # # ####### ### ##### # ### # #
#     #   # #.#     #   #     # #     # #
####### ##### # ### ### ##### # # ##### #
#       #  . .#   #   # #     # # #   # #
# # ##### # ##### ### ### ### ### ### # #
# # #     #.#     # #     #   #   #   # #
# ### ##### ####### ####### ### ### ### #
# #   #   #. .#. . . .    # #   # # #   #
# # ##### # # # ##### ### # # ### # # # #
# #     #   #.#. .# #.  # # #     # # # #
# ##### ##### ### # # ### ### ##### # # #
# #   # #. .#.  #.  #. .#     #     # # #
# # # ### # # # # ##### ####### ####### #
# # # #. .#. .# #.    #. .      # #   # #
# ### # ####### # ####### ##### # # # # #
#     #. . . .# #.#     #. .  # # # # # #
####### # ### ### # ### # # # ### # ### #
#       #   #. . .  #   # #.#     #     #
########################### #############
