################################### #####
#           # #   #      . .#    . .    #
# ######### # # # ### ### # ##### # ### #
# # #     # #   # #   #  .#. . .#.#   # #
# # # ### # # ### # ##### ##### # ### # #
#   # # # # # # # # # #. .#    . .#   # #
##### # # # # # # # # # ### ##### # ### #
#     # # #   # # # # #.#   #   # # # # #
# ##### # # ### # # # # ##### # ### # # #
#       # # # #   #   #.#     #     # # #
######### # # ##### ### # # ####### # # #
#   #   # #       # #  .# # #     # # # #
# ### # # # ##### ### # # ### ### ### # #
# #   #   # #         #.#       #   # # #
# # ######### ######### ##### ##### # # #
# # #       # # #      . .  #   # # # # #
# # ##### # # # # ####### # ### # # # # #
 .#       # #   # #  . . .#   #   # # # #
# ######### ##### # # ### # # ##### # # #
#.#  . . .  #   # # #. .# # # #     #   #
# ### ### ### # # ### # # # ### # #######
#.#. .#. .#   # #   # #.# #   # # #     #
# # ### ### ### ### # # ##### # # # ### #
#. .# #.#   # #     # #. .# # # # # #   #
##### # ##### ####### # # # # # # ### ###
#     #. . . .#. .# # # #.#   # #   # # #
# ########### # # # # # # ####### # # # #
# #   #. . .#. .#.# # # #. .    # # # # #
# # ### ### ##### # # # ### ### ### # # #
# #. .#.#. .  #. .# # #   #. .#   # #   #
# # # # # ### # ### # ### ### ### # ### #
# #.#. .#.#   #.  # #   #   #. .# #   # #
# # ##### ##### ### # ##### # # # # # # #
# #.#   #. . .#.#   #   # # # #.# # #   #
# # ### ##### # # ##### # # ### # #######
#  . . .#   #. .#     # #   #. .#     # #
####### # # ######### # ##### # ##### # #
#     #.# #  . . . .#   #. . .# #   # # #
# ### # ##### ##### ##### ### # # # # # #
#   #  . . . .#    . . . .#   #   # #   #
#########################################
