##################################### ###
# #       #     #   #          . . .#.  #
# # # ### # ### # # # ##### ### ### # # #
#   # #   # #   # # # #     #  .#  . .# #
# ### ##### # ### # # # # ##### # ##### #
# # #     # #   # #   # # #   #.# #     #
# # ### ### ### # ####### ### # # # #####
# #   #       # # #     #     #.# #   # #
# ### ######### # # ### # ##### ##### # #
# #   #   #     # # #   # #  . .#     # #
# # ### # ####### ### ##### # ### # ### #
#       #       # #   #     #.#   # #   #
# ##### ##### # # # ### # ### # ### # ###
# #   #   #   # #   #   # #  .#   # #   #
# # # ##### ########### ### # ### ##### #
# # # #     #   # #   #   # #. .#     # #
# ### # ####### # # # ### # ### ##### # #
# #   #         # # #   # #   #. . .#   #
# # # ########### # ##### ##### ### #####
#   #     #     #         #. .# #. .    #
######### # ### ########### # # # # ### #
#. . . . .#   #    . . . . .#.# #.#   # #
# # ##### ### ##### ######### # # ### ###
 .# #   #. .#     #.#     #. .# #.  #   #
### # ##### ####### # ### # ### # ##### #
#   #   #  . .#. . .# # # #.# # #. .#   #
# ##### ##### # ##### # # # # # # # # ###
# #   #      . .#     # # #.#   # #.# # #
### # ########### ##### # # ####### # # #
#   # #     #   #. . . .# #.#. . . .#   #
# ### ### # # # # ##### ### # # #########
# #       # # # #.#   #. .#.#.# #. . . .#
# ######### ### # ### ### # # ### ##### #
# #       #   #  . . .# #. .#. .#. .# #.#
# # ######### ####### # ##### # ### # # #
# # # #   # #   #    . . .# # #. . .  #.#
# # # # # # ### # ####### # # ######### #
# # #   # #   #   #     #. .#   #. . .#.#
# # # ##### # ##### ### ### ##### ### # #
#   #       #       #      . . . .#  . .#
#########################################
