##### ###################################
#  . .          #       # #       #     #
# # # ######### ####### # # ##### # #####
# #.#   #     #           #     # #     #
# # ### ##### # ################# ##### #
# #.  #     # #               #   # #   #
# # # ##### # ########### ##### ### # ###
# #.# #     # #         #       #       #
# # ### ##### # ##### ########### ##### #
# #. .#     #. . . .#             #   # #
# # # ####### ##### ##### ########### # #
# # #. . . . .    #. .  #             # #
# ############### # # # #################
# #   #. . . . .# # #.#     #           #
# # ### ####### # ### ### # # ######### #
# # #. .#     #.# #. .  # # #       # # #
# # # ### ### # ### ##### # # ##### # # #
#   #.#. . .# #.#. .#     # # #   # # # #
##### # ### ### # ### ### # ### # # # # #
#  . .#.# #. . .#. .#   # #   # # # # # #
### ### # ######### ### # ### # ### # # #
#. .#  . . . . .#. .  # #   #   #   # # #
# # # ######### # # ### ######### ### # #
#.# # #. . .#  . .# #     #           # #
# ### # ### ####### # # ### ########### #
#. .# #.# #. . .# # # # #   #         # #
# # ### # ### # # # # # # ### ####### # #
# #.#. .#   # #.#   # # #   # #   #   # #
# # # ##### ### ##### ### ### # # ##### #
# #. .      #. .    #         # #   #   #
# # # ####### # ############### ### # # #
# # # #   #  .# #. .          #   # # # #
# # ### # ### # # # ######### ### ### ###
# # #   # #. .# #.#. . . . .# # #   #   #
# # # ##### ##### ######### # # ### ### #
# # #   #. .#. . .      #. .# #         #
# # ### # # # ########### # # ###########
# #   # #.# #.#   #. . . .# #   #     # #
# ##### # ### ### # ##### # ### # ### # #
#       #. . .    #.#     #   #     #   #
################### #####################
