################################# #######
#     #                     #    .#. .  #
# ### # ################### ### # # # ###
# #   # #       #       #   #   #. .#. .#
# # ### ### ### # # ### ##### ### ##### #
# #         #   # #   #   #   # #   #. .#
# ############# ### # ### ### # ##### # #
# #     #         # # #       #    . .# #
# ### # ######### ### ##### ####### ### #
#   # #         #   # #   # #     #.# # #
### # ######### ### # # # ### ### # # # #
# # #     #   #   # #   #   # #   #.# # #
# # ##### # ##### # # ##### # ##### # # #
# # #   # #       # #     #   #. . .#   #
# # # ### ######### ########### ### #####
#   #     #         #        . .#   #. .#
##### ########### ##### ##### ####### # #
#     #   #             #  . .#. . . .#.#
# ####### # ############### # # ####### #
# #       #   #    . .#  . .# #. .#. . .#
# # # ### ### # ### # # # ####### # # # #
# # #   # #   # #  .#.# #.#. . . .#.# # #
# ##### # ##### # # # ### # ####### # # #
#   #   #   #   # #.#. . .#. . .# #.# # #
### # ##### # ### # ########### # # ### #
#     #   #   #   #.#. . . .  #.# #. .# #
# # ### # ### # ### # ##### # # # ### ###
# # #   #   # # #  . .    #.# #. .# #. .#
# # # ##### # # ### ##### # # ### # # # #
# # # #     # #   # #. .# #.#   #.# # #.#
# # # ##### ##### ### # ### ##### # ### #
# # #     #       #. .#. .#. . . .  #. .#
# ##### # # ####### ##### # # ####### # #
# #   # # # #   #  . .# #.# # #   #. .# #
# # # # # # # # ##### # # # ### # # ### #
# # # # # # # #     #.#  .#     # #.#   #
# # # ### # # ##### # ### ######### # ###
# # #   # # #   # # #. .#. .#. . . .# # #
# ##### # ##### # # # # ### # ##### # # #
#       #       #   # #.#  . .#     #   #
####################### #################
