####################### #################
#         #            . .        #   # #
# ####### # # ########### ####### ### # #
# #   #     # #         #. .    #   # # #
# # # ### ##### ####### # # ####### # # #
# # #   # #   #       # # #. . .# # # # #
# # ### ### # ##### ### # ##### # # # # #
#     #     #     # #   # #   #.# # # # #
# ######### ### ### # ### ### # # # # # #
# # #     #   #     # # #     #.# # #   #
# # # ### ########### # ####### # # ### #
#   # #   #         # #. . . .#.#   #   #
##### # ### # # ### # # ##### # ##### ###
#   # # #   # # #     #.#   #.#. . .  # #
# ### ### ##### # # ### ### # ### # ### #
#       # #   # # # #  .#   #. .# #.    #
####### # # # ### # # # # ##### ### #####
#   #     # #     # # #.# #    . .#.#. .#
# # ### ########### # # # # ##### # # # #
# #   # #     #     # #.#   #. .#. .#.#.#
# ### ### ### ####### # ##### # ##### # #
# #       # # #   #   #. . .#.#.#. . .#.#
# ######### # # # # # # ### # # # ##### #
#   #    . . .# # # # #   #. .#. .#   #.#
### # ### ### ### ### ######### ### ### #
# # #   #.# #. .#     #. . . .#     #. .#
# # ##### # ### ####### ##### ####### # #
#   #. . .#    . . . . .#   #. . . . .# #
##### ################# # ########### # #
#    . . . . .#     #   # #     #     # #
# ### ####### ##### # ### # ### # ##### #
#   #       #. .  # # #   # #     #     #
### ####### ### # # # # ### ####### #####
 .#       #   #.# # # #     #       #   #
# ####### ### # # # # # ##### ##### # # #
#.#. .# #   # #.# #   # #     #     # # #
# # # # ### ### # ##### # ##### ##### ###
#.#.#. . .# #. .# # #   # #   #     #   #
# # ##### ### ### # # ### ### # ### ### #
#. .#    . . .#   #   #       #   #     #
#########################################
