######################### ###############
#   #     #          . . .      #     # #
# # # ##### ##### ### ####### ### ### # #
# # #       #   # #  . . .  #     # #   #
# ############# # # # # # ######### #####
# #         #   # # # # #. . . .#. . . .#
# # ####### # ##### # ######### # ##### #
#. .#       #   #   #     #   #. .#. . .#
# # ########### # # # # # ### ##### # # #
#.#.#         #   # # # #   #     #.# # #
# # # ####### ### # # ##### ##### # ### #
#.#.#     #   # # # # #   # #     #. .# #
# # ##### # ### # # # # # # # ####### ###
#.#.#   # #   #   # # # # # # #     #. .#
# # ### # ### ##### ### # # # # ### # # #
#.#. .#   #     # #     # # #   # # # #.#
# ### ######### # ####### # ##### # # # #
#.#  . .# #   # #       # #     #   # #.#
# ##### # # ### # ##### # # ##### ### # #
#. . .#.# # #   # #   # # #       #   #.#
# ### # # # # ### # ### # # ########### #
# #. .#. . .#     # #   # #   #    . . .#
# # ####### ####### # ### ##### ### ### #
# #. . .# #. .#   # # #   #   # #. .# # #
# # # # # ### # # # # ##### # # # ### # #
# # # #.#    .# # # #       # # #. .# # #
# # # # ##### ### # ######### # ### # # #
# # # #. . .#. .#  . .#     # # # #.#   #
# # ##### # ### ### # # ##### # # # #####
# #     # #. .#. . .#.#   #   # # #. . .#
# ##### # # # ####### ### # ### # # ### #
#     # # # #. .# #. .# # # #   # # #. .#
# ### # # # ### # # ### # # ### # ### # #
#   # # # # #. .#. .#. . .# #   # #. .# #
### ### # # # ### ### ### # # ### # ### #
# # #   # # #.#  .#  .#  . .#   # #.# # #
# # # ### # # ### ### ##### ### # # # # #
# # # #   # #. .#. .#.#   #. .#   #.# # #
# # # ######### ### # # # ### ##### # # #
#   #         #.#  . .# #    . . . .#   #
############### #########################
