##################################### ###
#   # #           # #   #     #  . . .# #
# # # # ######### # # # # ### # # # # # #
# # #         # #   # # #   # # #.# #   #
# # ######### # ##### # ### ### # #######
# #         # # #     #   #     #. . .  #
# ######### # # # ############### ### # #
#     #     # # # #             # # #.# #
##### # ### # # # # ### ####### # # # # #
#     #   # # #   #   # #   #   #   #.# #
########### # # ####### # ### ####### # #
#         # #   #       #   #        .# #
# ##### # # ### # ######### ######### # #
#   #   # #     #   # #   #      . .#.# #
### # ### ##### ### # # ######### # # # #
#   #   #           # #    . .#. .#. .# #
####### ############# ##### # # ####### #
#     #     #    . . .#  . .#.#. .#   # #
# ### ####### ### ### ### ### # # # # # #
# #     #     #  .#  . . .#  .# #.# # # #
# # ### # # ##### # ######### # # # # # #
# #   # # # #. .#.# #. . . .#.# #.# #   #
# ### # ### # # # # # ##### # # # # #####
#   # #     #.#. .# #.# #. .#.# #.# #. .#
##### ####### ##### # # # ### # # ### # #
#     #      .#     #.  #.#. .# #. . .#.#
# # ######### ####### ### # ######### # #
# # #     #  . .  #. .#. .#. . . . .# #.#
# # # ### # # # # # ### ### ####### ### #
# # # # # # # #.# #.# #. .# #     #. .#.#
# # # # # # # # # # # ### ### ### ### # #
# # # # # # # #.# #. .# #. .#   #   #.#.#
### # # # # ### ##### # ### ####### # # #
#   # #   #   #. .  #.#   #. . . .#. .#.#
# ### # ##### ### ### ### # ##### # ### #
#   # # #   #   #. . .    # #   #.#. . .#
### ### # ### # ########### # # # ##### #
#   #   #   # # #     #   #   # #. .# # #
# ### ##### # # ##### # # ##### # # # # #
#           # #       # #       # #.#   #
################################### #####
