##################################### ###
#. . . . . .#  . . . . . . .  #    . .  #
# # ####### # # # ######### ### ### # ###
#.# #     #.# #.# #   #   #.#   #. .#   #
# ### ### # # # ### # # ### # ### # # # #
#. .#   # #.# #. .# # #. . .# #. .# # # #
# # ### # # ##### ### # ##### # ### ### #
# #. .# # #. . .#. .#  . . .# #.#   #   #
# ### # ####### # # ####### # # ##### # #
# # #.#        .# #. .#   #.# #. . .# # #
# # # ######### ##### # ### # ##### # ###
# # #.  #      . . .#.#. . .# #. . .#   #
# # # # # ######### # # ####### ### ### #
#   #.# #   #. .#. .#.#. . . . .#   #   #
##### ####### # # ### ##### # ####### # #
#    . . . . .#.#. . .#   # # #       # #
# ####### ##### ####### # ### # ####### #
# #. . .#   #. .#. . .# #     #   #     #
# # ### ##### ### ### ########### #######
# #.#  . . . .#. .# #. .        #       #
# # ####### # # ### # # ####### ##### # #
# #. .#     # #.# # # #. . . .#   #   # #
# ### ####### # # # # ### ### ##### ### #
#   #. .#     #.  # #   # # #.  #   # # #
### # # # ##### ### ### # # # # # # # # #
# # # #.# #   #.#   #   #   #.# # # #   #
# # # # # # ### # ########### # # #######
# # # #.# #. . .  #  . . . . .# #       #
# # # # ### ######### ####### # ### ### #
#   # #. . .  #. . . .#     # #   #   # #
##### ######### ####### ### ##### # # # #
#     #. . . . .#       # #       # # # #
# ##### ####### ######### ######### # # #
# #  . .#   #   #           # #     # # #
# ### ##### ##### ######### # # ### # # #
# #. .#     #     #   #   # #   #   # # #
# # ### ##### ##### # # # # ##### ##### #
# #. .# #     #   # #   #     #   #   # #
# ### # ### ### # ########### ### # # # #
#   #.#     #   #                 # #   #
##### ###################################
