################# #######################
#   #            .              #   #   #
# ### ########### ####### ##### ### # # #
#   # #  . . . .#.      #     #     # # #
### # # # ##### # ##### ##### ######### #
#     # #.#. .#. .#. .#     #   #     # #
# ####### # # ##### # ##### ##### ### # #
# #    . .#.#. . . .#. .  #       # #   #
# # ### ### ########### ########### #####
# # # #.#. .#     #   #. .  #     # #   #
# # # # # ### ##### # # # # # ### # ### #
# #   #.#.#. .#     # # #.#     #   #   #
####### # # # # ##### ### ### # ##### ###
#      .#. .#.  #     #. .  # #     # # #
# ##### ##### ######### # # ######### # #
#   #. .  #. .#. . . . .# #   #   #   # #
### # # ### ### ####### # ### ### # ### #
#   #.# #. .  #.# #     #   #   #       #
# ### # # ##### # # ### # # ### ####### #
# # #.# #.# #. .#   #   # #   #   # #   #
# # # ### # # ########### # ##### # # ###
#   #. .#.# #.#. .      # #     # #   # #
##### # # # # # # ##### ### ### # # ### #
 . .# #. .  #. .#. .  #   # #   # #     #
### ############# # ##### # # ######### #
#  . . . . . . .# #. .  # # #       #   #
# ############# # ### # # # # ### ### ###
# #   #. . . .#.# #. .# # # #   #   # # #
### ### ##### # # # ### # # ####### # # #
#   #. .#   #. .# #.#   # # #     #   # #
# ### ### # ####### # ### # # ### ##### #
# #. .  # #      . .# #   #   # #     # #
# # ##### ####### ### # ####### ####### #
#. .#   #     #. .# # #       #         #
# ##### ##### # # # # # ### # ### #######
#. . . . . .# #.# # # # # # #   #     # #
########### ### # # # # # # ### ##### # #
#       #  . .#.# # # # # #   #     # # #
# ##### ##### # # # # # # # # ####### # #
#     #      . .# #   #   # #           #
#########################################
