##################################### ###
#         # #           #    . . . . .  #
# # ##### # # ########### ### ##### # ###
# # #   # # # #           #. .#     #   #
### # ### # # # # ######### ### ####### #
#   #   # #   # #   #      .# # #       #
# ### # # # ### # # # ##### # # # #######
# # # # #   #   # # # # #. .#   #   #   #
# # # # # ######### # # # ######### # # #
#   # # #     #     #   #. . .#   #   # #
##### # ##### # # ####### ### # # ##### #
#     # #   # # #   #. .#   #.# #     # #
# ##### ### # ####### # ##### # ##### # #
# #   #   #        . .#. . .#.# #. .#   #
# # ##### ##### ### ####### # # # # #####
# #       #     #  . . . .#. .# #.#. . .#
# ######### ##### # ### # ####### ##### #
#       # # #   # #   # #. . . . .#. . .#
####### # # # # ##### # ####### # # # # #
#   # # # # # #     # # #     # # #.# # #
# # # # # # # ####### # ##### # # # ### #
# # #   # # #         # #     # # #. .# #
### # ### # ######### # # ##### # ### # #
#. . .#   # #     #   #   #     #   #.# #
# ### # # ### ### # ####### ######### # #
#.#. .# #     #   # # #   # #  . . . .# #
# # ### ####### ### # # # # # # ### ### #
#.#.#   # #   # #   # # #   # #.#   #   #
# # ##### # # # # ### # # ### # # ### # #
#.#. . . .# # # #     # # #   #.# #   # #
# ####### ### # ####### ### ### ### #####
#.#   #  . .# # #       #   #  . .#     #
# ### ##### # # # # ##### # ### # ##### #
#. .#      . .#   # #     # #   #. .#   #
# # ######### ####### ####### ##### # # #
# #. . .#   #.#   #   #   #   #. . .# # #
# ##### # ### ### # ##### # ### ##### ###
# # #. .#   #. .#   #  . .# #. .#   #   #
# # # # ### ### ####### # ### # # ##### #
#   #.#   #    . . . . .#. . .# #       #
##### ###################################
