##### ###################################
#   #. .      #. . . .    #     #       #
# ### # ####### ##### ### ### ### # #####
#     #.  # #. .#   #.  #         #     #
####### # # # ##### # # ############### #
#      .#   #.#     #.#               # #
# ##### ##### # ##### ######### ##### # #
# #    . .#. .# #. . .        #     # # #
# ####### # ### # # ######### ##### # # #
# #     #.#. .# #.# #     # #   #   # # #
# # ### # ### # # ### ### # ##### # ### #
# # #   #. . .  #. .# #   #       # #   #
# # ##### ####### # # ### ##### ### # ###
# # #. .# #. . .# #.#   #       #   # # #
# # # # ### ### ### ### # ####### ### # #
#   #.#. .#.#  . .#. .# # #     # #   # #
##### ### # ##### ### # # # ### ### ### #
#  . .#  . .#   #. .#.# # #   #   #   # #
### ######### ##### # # # ### ### ### # #
 . .#     # #. . .#.#.# # #     #   #   #
##### ### # # ### # # # ### ####### #####
#   #   #. . .# #. .#.# #   # #   #     #
# # ##### ##### ##### # # ### # # ### # #
# #     #.#. . . . . .# #   # # #   # # #
# ##### # # ### ##### # ### # # ##### ###
# #     #.#. .# #. .# #       #     #   #
# ####### # # ### # ############### # # #
#. . .#. .# #. . .#. .      #   #   # # #
# ### # ### # ####### ####### # # ##### #
#.# #. .# # # #     #.#       #   #     #
# # ### # # # # ##### # ########### # # #
#.#   # #   #   #  . .# #           # # #
# ### ############# # # # ##### ####### #
#.# # #    . . . . .# # #     #   # #   #
# # # # ### # # ##### # ##### ### # # ###
#. .# #   #.# # #     #     # #   # #   #
### # ### # ### # # ####### ### # # ### #
#. .#. .# #. .# # # #     #   # # #     #
# ### # ##### # # ### ### ### # # #######
#. . .#. . . .# #       #   #   #       #
#########################################
