####### #################################
#    . .    #           #     #         #
##### # # # # ####### # # ### ######### #
#. . .# # # #   #   # # # # #         # #
# ### # # # ### # # # ### # ##### ##### #
#.#   # # # #   # # #   #       #       #
# ##### # ### ### # ### ### ##### #######
#. . .# #       # #   #     #   # #     #
##### ####### # # ### ####### # ### ### #
 . .#. .    # #   # #       # #   # #   #
### # # ### ####### ######### ### # #####
# #.# #. .#                   # # #     #
# # ##### ######### ##### # ### # ##### #
#  . . .#. . .    #     # #     #     # #
####### ##### ### ##### # ####### # ### #
#     #. . .#.#       # #       # # #   #
# ######### # ######### ####### ### # ###
# # #. . .#.#. .      # #     #   # #   #
# # # ### # # # ##### # # ### ### # ### #
# #. .# #. .# #.    # # # # #   # #   # #
# # ### ####### ### # ### # # # ### ### #
#. .  #  . . .#. .# #   # # # #   #   # #
# ####### ### # # ##### # # ##### ### # #
#.#   #  . .#.# #. . .# #   #   # # #   #
# # # # ### # # ##### # ### # ### # #####
#.# #   #. .#.# #   #.#     #     #     #
# # ##### ### # ### # ################# #
#.# #. . .# #.#     #. .  #     # #   # #
# ### ##### # ######### # ##### # # # # #
#. .#.#. .# #. .# #  . .#     # #   # # #
### # # # # ### # # # # # ### # ##### # #
#. .#. .#.#   #.#   #.# #   #   #     # #
# ####### ### # ##### # ######### ##### #
#. . . .#. .# #. . .#.#   #         #   #
####### # # # ##### # ### # ######### ###
#     #.# #.# # #. .#.  # # #     #   # #
# ##### # # # # # ### # # # # ##### ### #
#     #.# #.#. . .#  .# #     # #   #   #
##### # ### # ####### # ####### # ### ###
#      . . .#. . . . .#                 #
#########################################
