################### ######### ###########
#     #         # #.#   #    .      #   #
# ##### ####### # # ### # ### ##### # ###
#   #   #     # #  . . .#   #.#   # #   #
# # # ### ##### ####### ##### ### # ### #
# # #. . .  #   #     #. . .#. .#   # # #
# ### ### ### ### ### ##### ### ##### # #
#   #.# #. .#   #. .#     #. .#. . . .  #
### # # ### ##### # ######### ####### ###
# #  .#   #. . . .#. . . .  #. . . .#. .#
# ### ### ############# # ######### ### #
#   #. .# #       #. .# #. . . .  #. .#.#
# # ### # # ####### # # ####### ##### # #
# #   #.# # #    . .#.#       #.#. . .#.#
# ### # # # ##### ### ######### # ##### #
#. .# #. .# #. . .#  . . . . . .#.#    .#
# # ##### # # ### ### ######### # # ### #
#.#. .#. .  #.#   #   #. .#   # #.# #. .#
# ### # ##### ##### ### # # # # # # # # #
#.# #. .#. .#. .  #   #.#.# #   #.# #.# #
# # ##### # ### # ### # # ####### # # # #
#.#   #. .#. . .# #   #.#. . .  #.# #.# #
# ### # ##### ##### ### ##### ### # # # #
#.#. .#. . .# #     # #.# #. .#. .# #.# #
# # # ##### ### ##### # # # # # ### # # #
#. .#. .# #. .#     # #.  #.# #. .# #.# #
####### # ### ##### # # ### # ### # # # #
#     #. .# #. . .# #. .#. .#   #.# #.# #
# ### ### # ##### # # ### ####### # # # #
#   # # #.#     #.# #.# #. . . .#.# #.# #
##### # # ##### # ### # ####### # # # # #
#     # #.#. .# #. . .  #  . .#. .# #.# #
# ##### # # # # ######### # # ##### # ###
#   # #. .#.#. .#         #.#. . .# #. .#
### # # ### ### ########### ##### ##### #
# # #. .#  .# #. . . .#    .#   #. . .#.#
# # # ##### # ####### # ### # # ##### # #
#   #. . .#.#   #  . .# #. .# # #    .#.#
# ####### # ### ### ##### ### # ##### # #
#        . .  #    . . . .#   #      . .#
#########################################
