####### #################################
#. .#  .#. .                      #     #
# # # # # # ############# ######### ### #
#.#.# #. .#. .          # #       # # # #
# # ##### ### ######### # # ##### # # # #
#.#. . .#   #. . . . .# #       # #   # #
# ##### ######### ### ######### # ### # #
#. .#. .#. . . .#   #. . .    # #   # # #
# # # ### ##### ### # # # # # # # # # ###
# #.#.#. .#   #.# # # # #.# # # # # #   #
# # # # # # ### # # # ### # # # # # ### #
# #.#. .# # #. .#   # #. .# # # # #     #
# # ####### # ######### # # # # # #######
# #. . . .#  . . . . . .# # # # # #     #
# # # ### ### # ########### ### # ##### #
# # #   #. .# # #     #     #   #       #
# # ##### # ### # ##### # ### ###########
# #     # #. .# #       # #   #         #
# ##### # ### # ########### ### ### #####
# #     #   #.#     #     #     # #     #
# ######### # ##### # ### ####### ##### #
# #. . .#   #. . .#     #       #       #
# # ### ######### ######### ### #########
# #.#  . . .#. . .#       #   #         #
### # ##### # # # # ##### ############# #
#. .# #    . .# # #     #     # #   # # #
# ##### ##### # # ########### # # # # # #
#.#     #. .# # #   #         # # # # # #
# ####### # ### # ### ######### # # # # #
#. . .#. .#. .# #     #. . .    # #   # #
# ### # ##### # ####### ### ##### ##### #
#   #.#.# #. .#   #. . .  #. . .#       #
# # # # # # ####### ####### # # #########
# # #.#. .#. . . . .#     # # #.    #. . 
# # # ### ############### # # # ### # ###
# # #.  #. . . .          # # #. .# #.# #
### # # ####### ########### ### # ### # #
#   #.#   #. . .#       # #   # #. . .# #
# ### ##### ##### ##### # ### # ####### #
#   #. . . .      #     #     #         #
#########################################
