############# ###########################
#    . . . .#.            #             #
##### ##### # ####### ### # # ######### #
#. . .#  . .#.      #   #   #       #   #
# ####### ### ##### ### ##### # ##### ###
#.#   #  . . .    #   #     # #     #   #
# # ### ##### ### # # # # # ### ### ### #
#.# #   #     #   # # # # #   #   #   # #
# # # ### ########### # # ### ####### # #
#.# #   # #   #       # #   #       # # #
# # ### # # # # ######### ########### # #
#.#     # # # #   # #   #       # #   # #
# ####### ### ### # # # ### ### # # #####
#.    #   #   # # # # # #     #   # #   #
# ##### ### ### # # # # # # # ##### # # #
#. .#   #   #   # # # # # # #     #   # #
### # ### ### ### # # # # ############# #
#. .# #   #. .  # # # # #     #         #
# ### # ### # ### # # ##### # # #########
#.# # # #. .#. .# #         # #   #     #
# # # # # ##### # ################# ### #
#.#   #. .  #. .#   #       #       #   #
# ##### ##### ##### # ##### # ####### # #
#. . . .  #. .#     #   # # # #   #   # #
# ### ##### ### # ##### # # # ### # #####
#   # #   #. .# # #     #   #. .# #     #
# # # ### # # # ### ######### # # # ### #
# # #     # #.#   # # #. .#. .#.# # #   #
### ######### ### # # # # # ### # ### ###
#   #    . . .#   # #. .#. .  #.# #   # #
# ####### ##### ### # ####### # # # ### #
# #. . . .#     #. . .#   # # #.#   #. . 
# # ### ######### ##### # # # # ##### ###
# #.#   #. . . . .    # # #   #.#. . .# #
### # ### ############# # ##### # ##### #
#. .# #. .#           # # #. . .#.#     #
# ### # ### ######### ### # ##### # #####
#. .# #.  #         #   # #.#. .#.#     #
# # ### ####### ####### # # # # # ##### #
# #. . .              #   #. .#. .      #
#########################################
