##################################### ###
#                . . .#   #  . . . .#.  #
# ####### ####### ### # # # # ##### # # #
#   #     #      . .#.# # # #.#    . .# #
##### ##### ##### # # ### # # # ####### #
#     #     #. .# #.#. . .# #.# #     # #
# ##### ##### # ### ##### ### # # ### # #
#   #   #  . .#. . .#   #. .#.# #   #   #
# # # ##### # ##### # ##### # # # # ### #
# # # #   #.# #     #     #. .# # # #   #
### ### # # # # # ####### ### # ### #####
#   #   # #.# # # #     # # # #   # #   #
# ### ### # ### ### ### # # # # # # # # #
#     #   #. .#   # #   # #   # # #   # #
############# ### ### ### ##### # ### # #
#. .#. . . .#. .#     # # #     #   # # #
# # # ##### # # ####### # ######### # # #
#.#. .#. . .# #. .  # # #   #       # # #
# ##### ####### # # # # ### ### ##### # #
#. .# #. . . .# #.# #   # #     #     # #
### # ####### ### ### # # ############# #
#. .#     #  . . .#   # #   #           #
# # ##### # ####### ### ### # ### ##### #
#.#   #   #   #   # #     # #   #     # #
# ### ### ##### # # ##### # ### ##### # #
#. .#   #       # #     #   # #     # # #
# # ### ######### ### # ### # ####### # #
# #. .#         #   # #   #         # # #
# ### ######### ### # ### # ####### # ###
# # #. . . . .# # # #   # # #   # # #   #
# # # ##### # # # # ### # ### # # # ### #
# # #     # #.# # #   # # #   #   # #   #
# # ##### # # # # ### ### # ####### # # #
#       # # #.# #         # #. .  #   # #
######### ### # ########### # # # #######
#     #   #. .#           #. .#.# #     #
# ### # ### # ############# ### # ##### #
# #     # #.#   #. . . . .#.#. .#       #
# ####### # ##### ####### # # ###########
#         #. . . .      #. .#. . .      #
################################# #######
