####### #################################
# #    .    #   #. . .              #. .#
# # ### ### # ### ### ############# # # #
#   #. .  # #  . .  #. . .#         #.#.#
##### # # # ### ######### ########### # #
#. . .# # #   #. .#     #. . .      #.#.#
# ##### ##### ### # ### ##### ##### # # #
#. . .#   # #   #. .  #     #. . .# #.#.#
##### ### # ####### ########### # ### # #
#. .#.# # #. . . . .  #       # #. . .#.#
# # # # # # ######### # ##### # # ### # #
#.#. .#   #.      #   # #   # # #   # #.#
# # ####### ##### ##### # # # # ### ### #
#.# #. . . .    #   #   # #   # #   #. .#
# ### ######### ### # ######### # ### ###
#. . .  #   # #   #   #. .  #   #   #. .#
# ####### # # # ####### # ### # ### ### #
# #       # #   #  . . .#.#   # #   #. .#
# ######### ##### # ##### # ##### ### # #
#           #     #.#   #.#     # #. .# #
################### # # # ##### ### #####
 . .#  . . . . . . .# # #. .  #   #. . .#
### # # ####### # # # ##### ##### ##### #
# #.# #.#       # # #      .#   # # #. .#
# # # # # ####### # ####### # ### # # # #
# #.# #.#     #   # # #   #.# #   # #.# #
# # ### ####### ### # # # # # # ### # ###
# #.#. .#       #   # # # #. .#     #. .#
# # # ### ######### # # ##### ######### #
#  . .#   #     #   #        . . .#. . .#
##### # ### ### # ############### # ### #
#     # # # # # #       # #     #. .#   #
# ##### # # # # # # ### # # ######### # #
# #   #   # #   # # #   #           # # #
# # # ##### # ### ### # ########### # # #
# # #   #   #   #   # # #       #     # #
# # ### # ##### ### # # # ##### ####### #
# # #   # #   #   # # # #   # #     #   #
# # ##### # ##### ### # ### # ####### # #
# #       #           #   #           # #
#########################################
