##################### ###################
#  . . . .#   #      .                  #
# # ##### ### # ##### # ##### ######### #
# #.#   #. .#   #. . .#   #   #   #     #
# # # ##### ##### # ### ### ### # # #####
# #.#   # #.# #  .# #   #   #   # # #   #
### ### # # # # # ### ### ####### ### # #
#. .#   #  .#   #. .# #   #       #   # #
# # # ##### ####### # ##### ####### ### #
#.# # #   #.#. . . .#                 # #
# ### # # # # # ####### ####### # ##### #
#. .# # # #.#.# #     #       # #   #   #
# # # # # # # ### ### ####### # # ### ###
# #.# # #. .#. .# #   #       # #   #   #
# # # ### ##### # # ############# # #####
# #.#   #. . .#.# # #           # #     #
# # ### ##### # # # # # ####### # ##### #
# #.  #   # #. .# # # # #   #   #   #   #
# # ##### # ### # # ### # # ### ##### ###
# #. .#   #     # #     # #   #     # # #
# ### # ######### ####### ### ##### # # #
# # #.#     #     #       # #         # #
# # # ##### # ##### ####### ####### ### #
#   #.    #   #     #           #   #   #
##### ### ########### ####### ### ### ###
#  . .  #         #   #     #   # #   #. 
# # ############# # ### ####### ### ### #
# #.#. . . .# #   # #. . . .  #   # #. .#
### # ##### # # ### # ##### ##### # # ###
#. .#. .# #.# # # #. .    #. .  #   #.# #
# ##### # # # # # # ####### # ####### # #
#. . . .# #.#   #. .  #   # #. .  # #. .#
# # ##### # ##### ##### # ### # # # ### #
# # #   # #. .#. .#     #   # #.#   #. .#
# # # # # ### # ### ####### # # ##### ###
# # # # # #. .#.# # #     # # #. . . .# #
# ### # # # ### # # # ##### # ### ##### #
#     # # #.#. .  # #   #   #   #     # #
# ##### # # # ##### ### # # ### ####### #
#     #   #. .        #   #   #         #
#########################################
