############################### #########
#   #  . . .#. . .#    . .#    .        #
# ### # ### # ### # ### # ##### ##### ###
#     #.#  . .#  .# #. .#. . .#. .  #   #
####### # # ##### ### ####### ### ##### #
#. . . .# # #   #. .#.#     #. . .#     #
# ####### # # # ### # # ### # ### # # # #
#.#       # # #   #. .# #   # #   # # # #
# ########### ### ### ### ##### ### # # #
#. . . . . .# # #   # #   #     #   # # #
# ### ### # # # ##### # ########### ### #
#   #   # #.#     #   #       #     #   #
### ### # # ##### # ######### # # # # # #
#   #   # #.    # # #   #     # # # # # #
########### ##### # # ### ##### # ### ###
#. . . . .#.#     # #   # #   # #   #   #
# ####### # # ##### ### # # # # ### ### #
#. . .#. .#.#         # # # # #   # #   #
# ### # ### ### ####### # # # ### # #####
#   #.#.#  .  # #     #   # # # # #     #
##### # ### # # # ### # ### # # # ### ###
#. . .#. . .# # # #   #   # #   #   #   #
# ### ##### # # # # ##### # ########### #
#.#   #     # # # # #   # # #           #
# ##### ##### ### # ### # # # ### ##### #
#. . .# #     #   #     # #   #   #     #
##### # # ### # ######### ##### #########
#. .#.# # #   # #   #   #       #       #
# # # # ### # # ### ### ########### #####
#.#. .# #   # #   #. .  #               #
# # ### # ####### # # ### ############# #
#.# #   #         #.#. . .  #. .    #   #
# # # ############# ##### ### # ### # ###
#.# #         # #. .#   #. . .#.  # #   #
# # ######### # # ### # # ##### ### #####
#.# # #. . .#   #.#   # #     #. .#     #
# # # # ### ##### # ### ##### ### ##### #
#.#   #.# #.  #. .#   #     #   #. .# # #
# ##### # # ### ### ####### ####### # # #
#. . . .  #. . .          #       #.#   #
################################### #####
