########################### # ###########
#       #     #         # #.#. . .      #
# ##### ##### # ####### # # ##### ### # #
#   # # #   #   #       # #. . .#.  # # #
### # # # # # ########### ##### # # ### #
# # # # # # # # #. . . .#. .#. .#.# #   #
# # # # ### # # # ##### # # # ### # # # #
# # #   #   # #  . .# #.#.#. .#. .# # # #
# # ##### ### ##### # # # ##### ### # # #
#       # # #   # #.# #. .#    .#   # # #
# ####### # ### # # # ######### ##### # #
# #     # #     #. .#    . . . .#     # #
# # ### # # ##### ####### # ##### #######
#   #   #   #   #.# #    .# #. .#       #
# # ##### ##### # # # ### ### # ####### #
# #     # #   #. .#   #  . .#.#. . . .# #
# ##### # # # # ######### # # ####### # #
# #   #   # # #.#   #     #.#.#   #. .# #
# # ####### ### # ### # ### # ### # # # #
#. . .    # #. .#   # # #  .#. .# #.# # #
# ### ### # # ##### # ### # ### # # ### #
#.# #. .#   #.#     #   # #.  #.  #. .# #
# # ### ##### # ####### # # # # ##### ###
#. .# #. . . .# #       # #.# #.    #. .#
### # ######### # # ##### # ### ##### # #
# #.  #         # # #   # #. . .    # #.#
# # ### ########### # ### # ####### # # #
#. .#   #     #     # #   #     # # # #.#
# ### ### ### # # ### # ####### # # # # #
#. .# #   # # # # # #   #     # # # # #.#
### # ### # # # # # ##### ### # # # ### #
# #.#     # # # # #     #   #   #   #. .#
# # ####### # ### ##### ############# # #
# #.#   # # #     #  . . . .#      . .# #
# # # # # # ######### ##### # ##### ### #
#. .# #  . .# #    . .# #. .# #  . .#   #
# ### ### # # # ### ### # ### ### ### # #
#. .#   #.#.# #   #.#   #.#   #. .#   # #
### ##### # # ##### # ### ##### ### ### #
#  . . . .#. . . . .#    . . . .#   #   #
#########################################
