##### ###################################
#    . .#. . . . .                #   # #
##### # # ####### ##### ######### # # # #
#. .# #.#.#. .# #.    #     #     # # # #
# # ### # # # # # ######### # ##### # # #
#.#. . .#. .#. .#. . . .  # # #     # # #
# ############# ####### ### # # ##### # #
#. . . . . .  #.# #   #. .# # # #   # # #
# ######### ### # # # ### # ### # ### # #
#         #. .#. .# # #. .#   #   #   # #
######### # # ### # ### # # # ##### ### #
#. . . .# # #. . .#   #.# # #     #   # #
# ##### # ####### ### # # ### ####### # #
#.#. .#.# #. . .#     #.#   #   #       #
# # # # ### ### ####### ### # ### #######
#.#.#.#. . .# #.#      . .# # #   #     #
# # # ####### # ######### # # # ####### #
#. .#.#      . .#. .#. .#.# # #   #     #
# ### ####### ### # # # # # # # ### #####
# # #. .#. .#. . .#. .#. .# #       #   #
# # ### # # ############### # ######### #
#   #. .#.#. . .#           # #   # #   #
##### ### ##### ######### # # ### # # ###
# #  .#. .#   #. . .    # # #   #   #   #
# # # # ### ### ### ### ### ### ### ### #
# # #. .  #   # # #.  #   #   #       # #
# # # # ##### # # # # # # ### # ##### # #
# # # #     # #   #.# # #   # # #   # # #
# # # ##### # ##### # ##### # ### # ### #
#   #     # # #  . .#     # #     # #   #
### # ### # # ### ####### # ####### # ###
#   #   # # #   #. . .  # # #       #   #
# ##### ### ### # ### ### # ######### # #
# #   #   #     #   #.#   #           # #
# # ##### ######### # # ##### ######### #
# #   #           # #.#     #         # #
# ### # # ####### # # ##### ######### # #
# #   # # #     # # #. . .# #       # # #
# # ### # # ### ### # ### # # ##### ### #
# #     # #   #     #   #.# #     #     #
######################### ###############
