##################### ###################
# #      . . . .#. . .  #     #       # #
# # ##### ##### # ### # # ### # ##### # #
#   #  . .# #. .#. .# # # # # # #     # #
####### # # # ##### ### # # # # # ##### #
#. . . .# #  .#  . .#   # #   # # #     #
# ##### ##### ### ### ##### ##### # ### #
#. .#   #. .#. . .#   #           # #   #
# # ##### # ### ####### ########### # ###
# #. .#. .#.#   #. . . . . .        #   #
# # # # ### ##### ######### ########### #
# # #. .  #. . . .        #.    #   #   #
# # ####### ############# # ##### ### ###
# #       #       #   #   #. . .# #   # #
# ####### ######### # # # # ### # # ### #
#       #     #     # # # #   #.# # #   #
##### ####### # ##### # ####### # # # ###
#   #       #       # #   #. . .#   #. .#
# # # # ### ######### ### # ######### # #
# # # #   #         #   # #. . . . . .#.#
# # ### # ######### # ### ############# #
# # #   #   #   # # #   #             #.#
### # # ##### # # # ### ############### #
#   # # #     # # # #   #  . . . .#  . .#
# ### # ### ### # # # ##### ##### ### # #
# #   # #   # # # # #     #.#   #.#. .# #
# # # # # ### # # # ##### # ### # # ### #
# # # # #   # #   #     # #. .# #.#.#   #
# ### # ### # ### ####### ### # # # # ###
#     #   # # # #       #   #.#  . .#   #
# ####### # # # ####### ### # ######### #
# #     # # #     #   #   # #. .#. . .# #
# # ### ### ### # # # ### # # # # ### ###
# # #       #   #   #   # # # #. .# #. .#
### ########### ####### # # ####### # # #
#   #           # #     # #       # # #.#
# ### ####### ### # ##### ####### # # # #
# #   #   #   #   # #    . .#   #   # #.#
# ##### # # ### ### ### # # ### ####### #
#       # #     #       #.#. . . . . . .#
######################### ###############
