############### ####### #################
#       #     #.#    . .    #   #   #   #
# ##### # ### # # ### # # # # # # # # ###
#     # #   # #.# #. .# # # # #   # #   #
# ### # ### ### # # ### # ### ##### ### #
# # # #   #   #.# #. .# #   #     #   # #
# # # ####### # ### # ##### ####### ### #
# # #       #  . .# #. .  #             #
# # ##### ####### ### # # ###############
# #       #     #. .# #.#               #
# ######### ####### # # ############### #
# #. . . . .  #. .#.# #. . . . . .#   # #
# # ####### # # # # # # ######### # ### #
# #.#     #.# #.#. .# #         #.#     #
# # ##### # ### ##### ######### # ### # #
#. .#     #.#. .#     #. . .#   #.  # # #
# ### ##### # ######### ### # ### # # # #
#.# # #. . .#. . . .#  .# #.# # #.# # # #
# # # # ########### ### # # # # # # ### #
#.# # #. . . . . .#. .#.# #.#   #.#   # #
# # # ##### ##### ### # # # ##### ### ###
#.# #     # #   #.  #. .# #.#    .  #   #
# # ##### ### ### ####### # ##### ##### #
#.#. . .#   #   #. . .    #. . .#. .# # #
# # ### ### ### ##### ######### ### # # #
#.#.# #.#  . . .# #. .  #. . .#. .#.#   #
# # # # ### ### # # # ### ### ### # #####
#. .# #. . .# #.# #.# #. .  #. . .#.#. .#
##### ##### # # # # ### ########### # # #
#   #       #  .# #. . .#          . .#.#
# # ########### # ####### ######### ### #
# #           #. . . .#   #  . . .# # #.#
# ########### ####### # ##### ### # # # #
#         #   #      .#   #. .#. .#   #.#
######### ########### ##### ### ####### #
#       #     #     #. .#. .#  .#  . . .#
####### ##### # ### ### # ##### ### ### #
#   # #       #   #    . .#    .#. .#   #
# # # ####### ################# # # # ###
# #                            . .# #   #
#########################################
