### # ###################################
#  .#.#   #     #     #     #           #
# # # # ### # # # ### ### ### ####### # #
# #.#.#   # # # #   #   #     #       # #
# # # ### # # ######### ####### ####### #
# #.#. . .# #   #   # # #       #   #   #
# # ##### # ### # # # # # ##### # # # ###
# #.  #. .# #   # # # # #     #   # #   #
### # # ### ##### # # # ##### ##### ### #
#. .# #. . .#     #         #     #   # #
# ######### # ####### ##### ######### # #
#. . . .  #.#     #   #               # #
# ##### ### ##### ##### ##### ######### #
#     #. .#. . .#   #   #     #      . .#
# ### ### ##### ### # ### ##### ##### # #
#   #   #.    #.#   #   # #     #  . .#.#
######### ### # # # ##### ### ##### ### #
#    . . .#   #.# # #   # #   #  . .#  .#
# ### ### # ### # ### # ### ##### ##### #
# #  .#   # #. .#     #   #   #. .#   #.#
# ### # ### # ########### ##### ### # # #
#   #.# #   #.#         #   #. .#   #  .#
### # ### ### # ####### ### # ######### #
#   #.#   #  .#       # #   #.#       #.#
# ### # ##### ####### ### ### # ##### # #
# #  .#     #. . .# #     #. .#     # #.#
# # # ##### ##### # ####### ######### # #
# # #. .#   #. .#. . .#   #. . . . .# #.#
# ##### ##### # ##### # ### # ##### # # #
#     #.#. . .#. .  #.#     # #. . .# #.#
####### # ####### ### ######### ##### # #
#. . . .#. .#   #. .#. . . . . .#. . . .#
# ### # ### ### # # ############# #######
#.#   # #. .    # #. .      # #. .#     #
# ##### # ########### ##### # # ### ### #
#. . .# #.#         #. . .# #. .# #   # #
# ### ### # ####### ##### ### ### # ### #
#   #. . .  #     #     #. . .    # #   #
# # ######### ##################### # ###
# #                                 #   #
#########################################
