######################### ###############
#     #     #     #      .              #
# ##### ### ##### # ##### ########### ###
#     # # # #     # #    . . . . .  #   #
##### # # # # ##### ##### ### ### # ### #
#   #     #   #     #   #   # #. .#   # #
### ##### ##### ### # # ### ### ####### #
#       #   # #   # # #   # #. .#. . .# #
# ##### ### # # # ### ### # # # # ### # #
# #     #   #   #     # # # #.# #.  #.# #
# ### ##### ####### ### # # # # # ### # #
#   #     #       # #   # # #.# #.#. .# #
### ##### ####### # # ### # # ### # # # #
# #   #. . . .# # # #     # #. . .#.# # #
# ### # ##### # # ################# ### #
#. .# #.#   #. .#    . .#  . . . .#. .# #
# # ### # # ### ##### # ### ##### # # # #
#.#. .#.# #   #.#    .#. . .#    .# #.# #
# ### # # ##### ##### # ######### # # # #
#. .#.#.#      . . .#.# #        .# #.# #
# # # # ########### # ### ####### ### # #
# #.#. .    #. .# #.#.#   #     #. . .# #
### ######### # # # # # ### # # ####### #
#. .#. . . .#.#.#  .#.# #   # #     #   #
# ### ##### # # ### # # ##### ##### # # #
#. .#. .  #. .#. .#. .# #     #   # # # #
# # ### ####### # ### ### ##### ### # # #
# #.  #.#. . .# #.#   #   #   #     # # #
### # # # ### ### ##### # # # # ##### # #
#. .# #.#.#  . .#. .#   # # # #   #   # #
# ### # # ##### ### # # ### # ### # ### #
#.#   #.#. .#  . . .# # #   # # # #   # #
# ##### ### ####### # # # ### # # ### # #
#. . . .  #.#   #   # # # # # #       # #
# ### ##### # # # ### # # # # ######### #
#   #     #.# # # #   # # # #         # #
# # ##### # ### ### ### # # ######### # #
# #   #   #. .# #   # # # #             #
# ### ####### # # # # # # ###############
#   #       #.#   # #   #               #
############# ###########################
