############################### #########
#   #   #       #    . .#    . .        #
# # # # # ##### # ### # ##### ### ##### #
# # # #   #. . .# #. .#. . .#. .#     # #
# # # ##### ### # # ####### # # ### ### #
# # # #    . .#.# #.#      .# #.  # #   #
# ### # ##### # ### # ##### ### # # # ###
#     #     #.#. . .#   #  . . .# # #   #
############# ########### ######### #####
# #        . .#           #       # #   #
# # ####### ############### ##### # # # #
# #   #. . .#. . . .  #   #   # # #   # #
# ### # # ### ##### # ### ### # # ##### #
#     #.# #. .#   #.#     # # #         #
# ##### # # ### ### ##### # # ###########
# #    .# #.  #   #. .  # # # #   # #. . 
# # ### ### ##### ### # ### # # # # # ###
# # # #.#. .      #. .# #   # # # #. .# #
# # # # # ######### # # # ### # ### ### #
# #   #. .      #. .# #   #   # #. .  # #
####### ####### # # # ####### # # ##### #
#       #. .#   #.# #     #   # #.  #   #
# ####### # ##### # ####### ### # ### ###
# # #. . .#. . . .# #   #   #   #.    # #
# # # ##### ##### # ### # ### ### ##### #
# # #.#     #     #     #   #. . .      #
# # # # ##### ############# # ######### #
# # #.# #. .# #. . . .  #   #.# #   # # #
# # # ### # ### ##### ### ### # # # # # #
#   #. . .#. . .#   #. .#   #.#   #   # #
# ### ########### # # # ##### ##### ### #
# # #   #         # # #.#. . .    # #   #
# # # # # ######### # # # ######### # # #
#   # # # #         # #.#.# #       # # #
# ### # ### ######### # # # # ####### ###
# # # #   # #         #.#.# #   #   #   #
# # # ### # # ######### # # ### # ##### #
#   # # # # #     #   #. .  #   # #     #
##### # # # ##### # # ####### ### # #####
#       #       #   #             #     #
#########################################
