########### ######################### ###
# #. . .  #.#   #              . .#  .  #
# # ### ### # # ##### ######### # # # ###
#. .  #. . .# # #     #  . . .#.#.# #. .#
# ########### ### ####### ### # # # ### #
#.#       #   #   #  . . .#  . .#.# #. .#
# ####### # ### ##### ##### ##### ### # #
#. .#  . . .#   #  . .#   # #    . . .# #
### # # ### # ### # ### # ### ######### #
#. .# #.# #.# #   #.# # #   # #   # #   #
# ### # # # # ##### # # ### # # # # # # #
#.#   #.# #.# #. . .# # # #   # # # # # #
# ##### # # # # ##### # # ##### # # # # #
#. . . .#. .# #. .#   # # #   # # # # # #
######### ### # # # ### # ### # # # # ###
#       #.# # # #.#     #   # # #   #   #
# ##### # # # ### ######### # # ####### #
# # #   #.  #   #. .        # #         #
# # # ### ##### ### ####### # ### #######
# #   #  .#   # # #.  #   # #     #     #
# ####### # # # # # # ### ######### ### #
#. . .  #.# #   # #.#   #         # #   #
# ### # # # ### # # ### ######### # # ###
#.# #.# #.# #   # #.#       #   # # # # #
# # # ### # ##### # ####### # ### # # # #
#. .#. . .#       #. .  #   #   #   # # #
### ################# # ##### # ##### # #
#  . . . . . .#  . . .#       #   #   # #
############# # # # # ##### ### # # ### #
#       #   #.# #.# #     # #   # #   # #
# ##### # ### ### ####### # # # # ### # #
#   #   #    . .#. . .  # # # # #   # # #
##### ######### # ### # # ### ####### # #
# #   #       #.# #. .# #   #       # # #
# # ##### ### # ### # # # # ####### # # #
# # #     #    . . .# # # # #     #   # #
# # # # ############### ### # ### # ### #
# #   # #   #       #   #   # # # #   # #
# ####### # ### ##### ### ### # # ##### #
#         #           #         #       #
#########################################
