# #######################################
#.            #                 #       #
# ######### ### ######### ##### # ##### #
#.  # #   #             # #     #     # #
# # # # # ############### ########### ###
#.#   # #     #   #       #         #   #
# ##### ##### # # ### # ### ##### ##### #
#. . .#   #   # #   # # #       # #     #
# # # ### ##### ### # ### ##### # # #####
# # #. .# #     # # # #   #   # # # #   #
# ##### # # ##### # # # ##### ### # ### #
#     #.#   #. . .#   #. . .  #   #     #
##### # ##### ### ##### ### ### ####### #
# #   #.  # #.# #. .#. .# #.  # #       #
# # ### # # # # ### # ### # # # # #######
# # #  .#   #.  #. .#.# # #.# #   #     #
# # ### ##### ### # # # # # # ######### #
# #   #.  #. .#. .# #. .# #.#           #
# ### # ### ### ### ### # # #############
#   # #. . .#. .# # # #.  #. . . .  #. .#
### # ##### # # # # # # ######### ### # #
#   #     # #.# #   #. .        #. . .#.#
# ### ### # # ####### ######### ####### #
# # #   # # #.#. . . .#. . . .#       #.#
# # ### # # # # ####### ##### ######### #
#     # # # #. .#     #.#    .#    . . .#
##### ### # # # ##### # ##### ##### ### #
#         # # #       #. .#  . . . .#   #
# ### ##### # ########### # ####### #####
# #   #   # #   #  . . .#.# #       #. . 
### ### # # ### ### ### # ### ####### ###
#   #   # # #   #. .# #. .#   #. . . .# #
# ### ##### ##### ### ### # ### ####### #
#   # #   #   #  . .#     # # #.# #   # #
### # # # # # # # # ####### # # # # # # #
#   #   # # # # # #. . . .#   #. . .#   #
######### ### # # # ##### ######### #####
#   #         # # # #   #. .      #.#   #
# # ############# # ### # # ####### # # #
# #               #     # #. . . . .  # #
#########################################
