##### ###################################
#. .#.#. . . .        #     #           #
# # # # ##### ##### ### ### # ######### #
#.#. .#. . .#.    #   #   # #     #     #
# ######### # ####### ##### ##### # #####
#. . .  # #.#.#. . .#       #   # # #. .#
# # # # # # # # ### ######### # ### # # #
# # #.# #. .#. .# #. .        #   #. .#.#
# ### # # ####### # # ########### # ### #
#   #.# #.      # # #. . . . .  # #.# #.#
# # # ### ####### # ######### ### # # # #
# # #. . .    #   #         #.#   #. .#.#
### # ####### # ############# # ##### # #
#   #       # # #   #  . . .#.# # #. .#.#
# ####### ### # ### # # ### # # # # ### #
# #       #   #     # #.# #.#.#   #.# #.#
# ######### # ##### ### # # # ##### # # #
#       # # # #     #. .#  .#. . . .  #.#
# ### # # # ### ##### ##### ### ####### #
#   # # # #     #    . . .#. .#   #. . .#
### ### # ########### ### ### ##### # # #
#   #   #     #       #. .#. .#  . .# # #
##### ####### # ####### ### ### # ##### #
#     #. . .# #   #. . .#  .# # #. . .# #
# ##### ### # # # # ####### # # ##### # #
# #  . .# #.# # # #.# #   #.# #   # #.# #
# ### # # # # ### # # # # # # # # # # ###
# #. .# #  .#   # #.#   #  .# # # # #. .#
# # ####### ### # # ####### # ### # ### #
# #.#     #. .#   #. . . .#.#   #   #. .#
# # ##### ### ######### # # ### ##### # #
# #. . .#   #.#. . . .# #.#. . . . . .# #
# ##### ### # # ##### ### ### ### ##### #
#     #. .#  . .#    . . .#   #   #   # #
# ### # # ##### ########### ### ### ### #
# #   # #. . .# #   # #   #   # #     # #
# # # ####### ### # # # # ### # ##### # #
# # # #   # #.#   #   # # #   # #   #   #
# # ### # # # # ####### # ##### # ##### #
# #     #   #.#         #       #       #
############# ###########################
