################################### #####
#  . . .#  . . . . . .#  . . .#    .#. .#
# # ### ### # ####### ### ### ##### # # #
# #.#  . . .# #   #  .#. .#  . . . .#.#.#
# # ########### # ### # ######### ### # #
# #. . . . . .# #    . .#         #. .#.#
# ####### ### # ################### ### #
#       #   #.#   #. . . . .  #. . .#. .#
# # ### ### # ### # ####### ### ##### # #
# #   # # # #.#   #. .#   #. . .#   #.# #
# ### # # # # ####### # # ### ##### # ###
#   # # #   #. . . .#.  #   #   #   #. .#
### ### ########### # ##### ##### ##### #
# #   # #   #     #. .#. .#       #  . .#
# ### # # # ##### ### # # ######### # # #
#     #   #     #   # #.#. .#       #.# #
####### ##### # ### ### ### ######### ###
#     # #   # #     #. .#  . . . . .#. .#
# ### # ### # ####### # ########### ### #
# #   #     # #   #  .# #   #   # #. .#.#
# # ########### ### # # # # ### # ### # #
# #         #   #   #.# # #     # #. .#.#
# ##### ##### ### ### ### ####### # ### #
# #   #   #   #   #  . .# #   #. . .#. .#
# ### ### # ### ##### # # ### # ##### # #
#   #   #   #   #     #.#   # #. .#  .# #
### ### ##### # # ##### ### # ### # # ###
# #     #     # # #. . .#   #   #.# #. .#
# # ### ####### # # ##### ##### # ##### #
#   #           # #. .# #. . .  #.#. . .#
##### # ####### # # # # # ### ### # ### #
#     # #     # # # #.#  . .#.  #.#.#   #
# ####### ### # # # # ##### # ### # #####
#   #     #   # # # #. . .#.#. .#.#. . .#
##### ##### ### # ### ### # ### # # ### #
#     #     # # #   # #. .#.# #.#.#   #.#
# # ####### # # ### # # ### # # # ##### #
# # #     #   #   # # #.# #. .#. .#. .#.#
# ### ### ### ##### # # # ### ##### # # #
#     #   #         # #.#    . . . .#. .#
####################### #################
