######### ###############################
#        . .              #             #
######### # ##### ### ##### # ######### #
#. . . .# #. .  #   #     # #         # #
# ##### ### # # ######### # ##### ##### #
#.#   #. .# #.#     #   # #     #     # #
# ### ### ### ##### # # # ##### ##### ###
#. .# #  .#. .    # # # #     #   # #   #
### # ### # # ##### # ####### ### # ### #
#. .#   #. .# #     #       #   # # #   #
# # ### ##### # ########### # # # # # # #
#.#   #       # #         # # # #   # # #
# ############# # ####### # # # ### # # #
#. . . .    #   #       # # # # #   # # #
# ### # ### # ####### ### # # # # ### # #
#   # #.#   #       # #   # # # # #   # #
### # # ######### ### # # # # ### # #####
#   # #. . .#     #   # # # #     # #   #
# ### # ### ####### ### ### ##### # # # #
# #   #   #. . . . .  #     #   # #   # #
# # ######### ##### # ####### # ####### #
# # #. . . .#     #.#   #     # #     # #
# ### ##### ####### ### # ##### # ##### #
# #. .# #. .#  . .#.  #   #   # #   #   #
# # ### # ### # # # # ####### # ### # ###
# #.#  . .#   #.#.#.#   # #   #     #   #
# # ### ### ### # # ### # # # ####### # #
# #. .#.# # # #.#. .#   # # #   # #   # #
# ### # # # # # ### ##### # ### # # ### #
#   #.#.# # # #.#   #. . .# #   #   #   #
##### # # # # # # ### ### ### ####### # #
#. . .#.# # # #.# # #.# #. .#         # #
# ##### # # # # # # # # # # ########### #
#.#  . .# #   #.# #. .  # #.    #     # #
# ### ### ##### ### ####### ### # ##### #
#. .#. .#    . .#. .  #. . .  # #     # #
# # ### ##### # # ##### ####### ##### # #
# #.#  . . . .# #.#   #.#     #     # # #
# # ############# # # # # ### # ### # # #
# #. . . . . . . .  # #.#   #   #   #   #
####################### #################
