### #####################################
#  . . .  #. .        #. .      #   #   #
### ### # # # ######### # ##### ### ### #
#   #. .# #.#. .  #. . .#. .  #     #   #
# ### ##### ### ### ####### # # ##### ###
# #  . . . .  #. . .#   # #.# #     #   #
# ### # ############# # # # # ######### #
#   # #     #         #   #.#         # #
### # ##### # ############# ######### # #
#   #     #   #. . . . . .#. . .# #   # #
# ####### ##### # ####### # ### # # ### #
# #       #. . .# #. . .#.# #. .# # # # #
# ######### ####### ### # ### # # # # # #
#   #      . . .#. .  #.#. . .# #   # # #
# # # ##### # # # ##### ####### ##### # #
# # # #     # #.#.#   #. . . .#   #. .  #
# # # # ##### # # ### # ##### ##### # ###
# # # # #     #. .    #     #. . . .#. .#
# # # # ######### ################### # #
# # # #         #   #       #       # #.#
# # # # ####### ##### ##### ####### # # #
# # # #   #   #     # #   #     #   # #.#
# # # ### # ####### # ### ##### # ### # #
# # #   # #   #   # # #. . . .#   # # #.#
# # ### ##### ### # # # ##### ##### # # #
# #   #     # #   # # #.#    . .# # # #.#
# ### ##### # # ### # # ####### # # # # #
# # #     #   # #   # #. . .# #. .# # #.#
# # # ### ##### ### # # ### # ### # # # #
#   #   #   #     #   # #. .#   #. .# #.#
####### ##### # # # ##### # ### ### ### #
#     #       # # # #  . .#   #    . .#.#
# ### ######### # ### # ############# # #
# # #     #   # # #   #. . .#. . .#  . .#
# # ##### ### # # # ####### # ### ##### #
#     # #     # # # #     #. .  #. .#   #
##### # ####### # # # ### # ####### # ###
#   #   #       # # # #   # #     #.#   #
# # ### ### ##### # ### ### ##### # ### #
# #         #     #       #       #.#   #
################################### #####
