############################# ###########
#   #     #   #       #    . .      #   #
# # # ##### # # ##### # ### # # ### ### #
# # # #   # # #   #   #   #.# #   #   # #
# # # # # # # # ### ##### # # ##### # # #
# #   # # # # # #   #     #.#     # #   #
# ##### # # # # # ### ##### ##### #######
# #     # # # # #   # #    .    # #     #
# ### ### # ### ##### ##### ##### # #####
#   #   # #   #     #   #  .#   # #     #
### ### # ### ##### ### # # # # # ##### #
# # #   #   # #         # #.# #       # #
# # ### ##### ############# # ####### # #
# #   # #     #          . .#       # # #
# ### # # ##### ######### ######### ### #
#. . .# #   #   #  . .#  . . . . .#     #
# ### # ### # ##### # ########### #######
#.# #.#. .#   #  . .#. . . .#. . .    # #
# # # # # ####### # ####### # ### # # # #
#.#  . .#.#  . . .# #      . .#   # # # #
# ####### # # ####### ######### ##### # #
#. .#   #.# #.#   #   #         #     # #
# # ### # ### # ### ##### ####### # ### #
# #. .#  . . .# #   # #   #       #     #
# # # ####### # # ### # # ###############
# # #. .#     # #   # # # #       #     #
# # # # # ##### # # # # ### ##### ##### #
# # # #.# # #   # # # # #       #     # #
# # ### # # # ##### # # # ########### # #
# # #. .#   # #     # #   #     #   #   #
# # # ####### ### # # ##### ### # # ### #
# # #.#. . .#     # # #. . .  # # #   # #
# ### # ### ######### # ### ### ##### ###
# #. .#.# #. . .    # #.  #. .#     #   #
# # # # # ##### ### # # ##### ##### ### #
# #.# #. . .# #. .#   #.#. . .    #     #
### # ##### # ### ##### # # # ###########
#. .#     #. .  #. .#. .#.# #     #     #
# ########### ##### # ### # ##### ##### #
#. . . . . . .    #. .  #.#     #       #
######################### ###############
