### #####################################
#  .#. . .#. . . . . . .    #           #
# # # ### # ### ####### ### ########### #
# #. .  #. .  # #. . .#.  #         #   #
# ####### ### ### ### # # ##### ##### ###
# # #. .#   # #. .#  . .# #   #         #
# # # # ### ### # ####### # ########### #
#   #.#. .# #. .# #       #. .        # #
##### ### ### ### # ####### # ####### ###
#. . .#  . . .#   # # #. . .#. .#   #   #
# ########### # ### # # ####### # ##### #
#.#. . . . .# # #     #.# #. . .#     # #
# # ####### # # ####### # # ### ##### # #
#. .    #. .# #     #. .# #.#   #. .#   #
# ##### # ########### ### # # ### # #####
# #. .# #. . .  # #. .    #.# #. .#. . . 
### # ### ### # # # ####### ### #########
#. .#. .#   #.# # #.#   #. .#. .        #
# ##### ##### # # # # # # ### ###########
#. . .#. . . .#   #.  # #. . .          #
# ### # ########### ################### #
#   #.# #. . . .  #.#           # #     #
##### ### ##### ### # ### ##### # # #####
#. .#. .#.#. .#. . .#   # #   # #   #   #
# # ### # # # ######### ### # # ##### ###
#.#. . .#.#.#. .#     # #   # #     #   #
# ##### # # ### # ### # # ##### ####### #
#.#   # #. .# #.#   # # # # #   #       #
# # # # ##### # ### ### # # # ### #######
#.# #   #     #. .#   # # #   # #       #
# # ##### ####### ### # # # ### # ##### #
#.#       #. .  #. . .# #   # #   #     #
# ######### # ####### ### ### # ### ### #
#. . .    #.#. .    #. .# # #   # # #   #
# ### ##### ### ####### # # # ### # #####
# # #. . . .# #. . .  #.# # #     #     #
# # ### ##### # # # ### # # # ####### # #
# #   # #     # # #. . .  #   #     # # #
# ### # # ##### ########### ### ### ### #
#     #       #             #   #       #
#########################################
