####################################### #
# #      . . . . . . . . .#            .#
# # ##### ############### # ########### #
# #     #. . .#  . . . . .# #. . . . . .#
# ####### ### ### ########### ### ##### #
#  . . .#   #. .#.#   #  . . .#   #   # #
### ### ### ### # ### # # ######### ### #
#. .# #. .#   #.#. .#   #.#. . . .#   # #
# # # ### ### # ### ##### # ##### ### # #
#.# #   #. .# #.# #.#. . .#. .#. .  #   #
# ##### ### ### # # # ### ### # #########
#. .  #    . .#.#. .#.#   # #.#. . .    #
# # ######### # # ### # # # # ##### ### #
# #. . . .#  . .#. .#.# # #  . .# #.#   #
# ####### ######### # # ####### # # #####
# #     #. .#      . .#   #   #.# #. . . 
# # ##### # ############# # # # # # #####
# # #   # #. . . .#       # # #.# #     #
# # # # # ####### # ####### ### # ##### #
# #   # #     #. .# #. . . . . .#   # # #
# ##### ##### # ##### ############# # # #
#     #     # #. . . .      #       # # #
# ######### ####### ######### ####### # #
#         #       #           #   #   # #
# # ### ######### ######### ### # # ### #
# # # #   #     #     #   #   # # #     #
# # # # # # # ##### ### # ##### # ### # #
# #   # #   #       #   #       #   # # #
# ########### ####### ############# # # #
# #     #   #         #     #       # # #
# # ### # # ########### ### ########### #
#   # #   #             # #           # #
# ### # ############### # # ######### ###
#   # #   #           #   # #       #   #
# # # ### ########### ##### # ##### # # #
# #     #           #   #   # #     # # #
# ######### ####### ### # ### ##### ### #
# #       #   #   #   # # #   #   #     #
# ####### ### # # # ### # # ### # #######
#           #   # #     # #     #       #
#########################################
