################### #####################
#. . . . . . . .#  . . .#. . . .      # #
# ##### ####### ####### # ##### ##### # #
#.#     #. .# #. . . .#.#.#. .#.    #   #
# ####### # # ####### # # # # # ### #####
#. . . . .#.#   #. .#.#. .#.#. .  # #   #
# ### ##### ### # # # # ### # # # # ### #
#   # #. .#.#   #.#. .#   #.# # # #     #
### ### # # # ### ######### # # # #######
#   #. .#.#.# # #.#. . .#. .# # #       #
# ### ### # # # # # ### # ### # ####### #
# #  .#  . .#. .#.#.#  . .#   #       # #
# ### ####### # # # ############# ##### #
#   #. . .# #.#. .#. . .#   #     #     #
### ##### # # ####### # # # # ##### ### #
# #     #.# #.#. . .# #.# # # #   #   # #
# ##### # # # # ### ### ### # # ### # # #
#. . .# #.# #. .#  . . .#   # #   # # # #
# ### # # # ######### # # ### ### ### # #
#.#  .# #.#   #       # #       # #   # #
# ### ### ### ######### # ####### # # # #
#. .#. . .  #       #   # #   #   # # # #
# # ### # # ####### # ##### # # ### ### #
# #. .# # #       #   #     # #     #   #
# # # ### ####### ##### ##### ####### ###
# # #. .#   #   # #   #   # # #     #   #
# # ### ### # # ### # ### # # ##### ### #
# # # #.  #   #   # # #   # #     # #   #
# # # # # ####### ### # ### ### ### #####
# #   #.#       #     #     # # #   #   #
# ##### ################### # # # ### # #
#     #. . . . . .            # # #   # #
##### # ######### ############# # # ### #
#     # #       #. . . .    #   #   #   #
# ### # # ##### ####### ### # ####### ###
# #   # #   # #   #. . .  # #       # # #
# ##### ### # ### # ####### # ### ### # #
#     # #   # #   #.#   #   # # #   #   #
# ### ### ### # ### # ### # # # # # ### #
#   #       #   #  .#     # #   # #     #
################### #####################
