################# #######################
#    . .#  . .#  .    #   #             #
### # # ### # # # ### ### ##### ### #####
#   #.#. . .#.# #. .#   #       #   #   #
# ### ####### ##### ### ########### # # #
#   #.#   #  . . . .  #   #        . .# #
### # # # ##### ### ##### # ####### # ###
#   #.# #       #   #     # #     #.#. . 
##### # ######### ### # ### # ### # #####
#. . .# #         #   # #   #   # #. .# #
# ##### # ######### ##### ####### ### # #
#. . .# # #         #     # #   # # #.# #
# ### ### ####### ### ##### # # # # # # #
#   #. .# #   #     # #   #   # # #. .# #
### # # # # # # ### # # # # ### # # ### #
# # # #.#   # # #   # # # # #   # #.    #
# # ### ##### ### ##### # # ##### # #####
# #   #. .  # #   #     # #. . . . .    #
# ### ### ### # ### ##### # ########### #
#. .#   #.#   # #   #   # #.#         # #
# # ##### # ### ##### # # # # ####### ###
#.#. .#. .# #       # #   #.# #. .# #   #
# ### # # # # # # # # ##### # # # # ### #
#.# #.#.# # # # # # # #. . .# #.#.#   # #
# # # # # # # ### # # # ##### # # ### # #
#.# #. .# # # #   # #  . .#   #.#. . . .#
# # ####### # # ######### ##### ####### #
#.#         # #   #   #  . . . .#     #.#
# ############### # # ########### ### # #
#. .#. . . .    # # # #           #   #.#
# # # ##### ##### ### # ############### #
# #. .    #. . .#   #. . .  #. .  #. . .#
# # # ### ##### ### # ### ### # ### #####
# # #   #     #. .# #.# #. . .#.#. .    #
# # ########### # ### # ##### # # #######
# # #         # #. .#. .#   # #. .      #
# ### ####### # ### ### ### # ### ##### #
#           # #   #.  #.#   #   #   # # #
############# ### # ### # ##### ### # # #
#             #   #. . .  #     #   #   #
#########################################
