############################### #########
#   #              . . . . . .#. .      #
# ### ############# ######### ### ### # #
#   #   #    . . .#.# #. . . .#. .# # # #
### ### # ### ### # # # ####### # # # ###
#       # #  .# #. .#  . . .#  .# # #   #
# ####### # # # ### ####### ### # # ### #
# #   #   # #.#     #. . .#. . .# #     #
# # ### ### # ####### ### ###############
# #     #   #. .#. . .  #.#. . . .      #
# ####### ##### # ####### # ##### ##### #
#     # # #. .#. .      #. .    #. . .# #
##### # # # # # ####### ####### # ### # #
#   #   # #.#.# #. .# #       # # #. .# #
# # ##### # # ### # # ####### # ### # # #
# # #     #.#. . .#.#   #     # #. .# # #
# # # ##### ####### ### # ####### ##### #
# #   #   #.# #    . .#   #. . . .#     #
# ##### # # # # ##### ##### # ###########
# #     # #.#   #. .#. . . .# #. . . . . 
# ####### # ##### # ##### ### # ####### #
#         #. .  #.#.#   # #   #. .#   # #
########### # ### # # # ### ##### # # ###
#   #   #   #. . .#.# #     #    .# #   #
# # # ### ### # ### ############# # ### #
# # #     #   #   #. .          #.# #   #
# # ####### # ### # # ######### # ### ###
# #       # #   # # #. . .#     #.#     #
# ####### # ### # # ##### ####### # #####
# #     # #   # # #     #. . . . .# #   #
# # ### # ### # # ##### ####### ### # # #
#   # # # # # # #     #       #   # # # #
##### # # # # # ### ######### ##### ### #
#       #   # #   #         #     #   # #
# ########### ### ####### ####### ### # #
# #           # #       # #     #   # # #
# ####### # # # ### ### # # ### ### # # #
# #       # # #   #   # #   # #   # #   #
# # ####### # ### ### # ##### # # # ### #
#   #       #     #   #     #   # #     #
#########################################
