############################### #########
#   #    . . . . .#     #      . .      #
# ### ### ####### # ### # ### # # ##### #
# #   #  .#      .#   # # #   # #. . .# #
# # ##### ####### ##### # ##### ##### ###
#   #. . .#     #. . .# #     # #   #. .#
##### # ### ### ##### # ##### ### # ### #
#. . .# #   #     # #.#     # #   #   #.#
# ##### # ####### # # ##### # # ####### #
#.#. .# #     # # #. .  #   #   #. . . .#
# # # # ##### # # # ##### ####### #######
#.#.#.#     # # # #.# #   #      . . . .#
# # # ####### # # # # # ### ##### ### # #
#. .#.  #     # #  . .# #   #   #   # #.#
# ### # # ##### ##### # # ##### ### ### #
# #. .# #   # #     #.# # # #. .#   #. .#
### ####### # # ### # # # # # # ##### # #
#. .#   #   # #   # #. .#   #.#. . . .# #
# # # # ##### ##### ### ##### ##### ### #
#.# # #           #    . .#  .#   # #   #
# ### ##### ##### ####### ### # # ### ###
#. .#     # #   #     #  . . .# #     # #
# # ##### ### # ##### ####### # # ##### #
# #. .  #     # #   #   #     # # #   # #
# # # ######### ### ### ####### # # # # #
# # #. .      #   #       #     # # #   #
# # ### ##### ### ####### # ####### #####
# #   #.#   # #   #         #       #   #
# ### # # # ### ### ##### ### ####### # #
# #   #.# #     #   #   # #   #       # #
# ##### ############# # ### ### ####### #
# #   #. . .          #   #     #     # #
# # # ##### ##### ####### ####### # ### #
#   # #. .#. .  # #     #       # #     #
# ##### # # # # # # ##### ##### # #######
# #  . .#.# #.# #   #   #   #   #   #   #
### # ### # # # ##### # # # ##### ### # #
#   #. .#.# #.#       # # #   #   #   # #
# ##### # ### ######### # ### # ### ### #
# #. . .#. . .#         #   #       #   #
### #####################################
