######################### ###############
#       # #        . . .#.              #
# ##### # # ####### ### # ####### # ### #
# #   #   # #   #. .#  . .      # #   # #
# ### ##### ### # # # ######### ##### # #
#         #     #.# # #       #   #   # #
######### ####### # # # ##### ### # ### #
#. . . . . .#  . .# # # #     #   # #   #
# ######### ### ##### # # ##### ### #####
#. .#   #  . . .#   # # # #     #   #   #
# # ### ##### ### # # # # ####### ### # #
# #. .#       #   # # # #   #     #   # #
# # # ######### ### ### ### # ### # ### #
# # #.  #. . .# # #     #   # #   #   # #
# ### ### ### # # ######### ### ##### # #
# #. .#. .#. .# #. .  #         #   # # #
# # ### ### # ### # # ##### # ### # # # #
# #.#. .  #.# #. .#.#     # # #   # # # #
# # # ##### ### ### ##### ### # ##### # #
# #. .# #. .#. .  #. .#   #   #     # # #
# ##### # ### ####### # # # ####### # # #
#       #. . .      #.# # #       #   # #
######### ########### # ############### #
#. . . .#   #. .#. . .#               # #
# ##### ##### # # # # ####### ##### ### #
#.# #. .#. . .#. .# # #     #     #     #
# # # ### ##### ##### # ### ########### #
#.#  . . .#   # #   #     #           # #
# ### ##### # ### # ######### ####### # #
#. .# #   # #     #         #       # # #
# # # # ### ############### ######### # #
# #.# #     # #. .        #   #       # #
# # ######### # # ########### ### ##### #
# #. .  #     #.#.#. . . . .#     #     #
# # # # # ##### # # ####### #############
# # #.# #. . . .#. .#     #. . . .      #
# ### # # ########### ### ####### ### ###
# #. .# #.    #         #   #   #.# #   #
# # ##### ##### ########### # # # # ### #
# #. . . .                #   # #.#     #
################################# #######
