####### #################################
#  . . .#. . . .#. . .                  #
### ### # ##### # ### ##### #############
#. .#   #.#   #.#.# #. . .#     #       #
# ### ### ### # # # ##### ### ### ##### #
#.#   #. .    #.#.#. .# #. .#     #   # #
# # ### ####### # # # # # # ####### ### #
#.# #. .# #. . .#.#.#.# # #. . .  # #   #
# ### ### # ### # # # # ##### # # # # # #
#. . .    #.#   #. .#.# #   # #.# #   # #
# ### ##### ######### # # # ### # #######
#   # #  . .#. . . . .  # # #. .#   #   #
### # ### ### ####### # # # # ##### ### #
# # # #. .#. .#     # # # # #.#     #   #
# # # # ### ### ### # ### ### # ##### ###
#   # #.#. .#     # #     #. .#         #
##### # # ### ##### ####### # ###########
#   # #. .    # #   #  . . .#   #       #
# ### # ####### # ### # ### # # # ##### #
#     #       #   #   #.# # # # #     # #
############# ######### # # # # ####### #
#. .#  . .#   #. . .#. .# # # #   #     #
# # # # # ##### ### # # # # # # # ### ###
#.#.# #.#. . . .#  . .# #   # # #   # # #
# # ### ### ######### # ##### # ### # # #
#.#. . .#   #         # #     #   # #   #
# ########### ######### # # ### # # ### #
#. .#     # #     #     # # #   # #   # #
# # # ### # ##### ### ### ### ### ##### #
# #.# #     #   #   #   #   # # #   #   #
### # ##### ### ### ### ### # # # # # ###
#. .#   #         #   #   # #   # # # # #
# ##### ####### ##### ### # ##### # # # #
 .#   # #     # #   #   # #     # # #   #
# # ### # ### # # ##### # ### ### # ### #
# #     # # # # #       # # #   # #     #
# ##### # # # # ######### # ### # # #####
# #   # #   # #       #   #   # # # #   #
# ### # ##### ####### ### ### # # ### # #
#     #     #               #   #     # #
#########################################
