############### ######### ###############
#     #      . .#. .    #.#   # #       #
# ##### ##### ### # ##### # # # # ### # #
# #   #   # #.#. .#.#. . .# # # # #   # #
# # # ### # # # ### # ##### # # # ### # #
# # #   #   #.#. .#. .    # #   # #   # #
# # ######### ### ####### # ### # # ### #
# #   #   #  . .#.#   #   #   # # # # # #
# ### # # ### # # # # ####### # # # # # #
#   #   #     #.#.# #     #   # # #   # #
### ########### # ####### # ### ####### #
#  . .#    . . .#. . . . .# #   #   #   #
# # # # ### # # ######### ### ### # # ###
# #.#.# #. .# # #     #. .#   #   # # # #
### # ### ### # # ### # ### ### ### # # #
#. .#. .#.#   # # # # #.#   #   #   #   #
# ##### # # ### # # # # # ### ######### #
#.#   #. .#   # # #   #.  # #     #     #
# # # # # # # # ### ### ### # ### # #####
#.# # # # # # #     # #.#       #   #   #
# # # ### # # ####### # # ######### # # #
#.# #   # # #     # #. .#   #     # # # #
# # ### # # ##### # # ##### # ### # # ###
#.# #     # #   # # #.#   # #   # # #   #
# # ######### # # # # ### # ##### ##### #
#.# #         # # # #. .  #     #   # # #
# # # ######### # # ### ####### ### # # #
#.# #. . . .#   # # #. .    #     #     #
# ### ##### # ### # # ##### ##### ### # #
#. . .  #. .#   # #. .#   # #   #     # #
# ####### # ##### # ##### ### # ####### #
# # #. . .#   #   #.# #   #   #       # #
# # # ### ##### ### # # ### ########### #
#   #.#   #. .# #  . . .    #   #   #   #
##### # ### # # # ##### ##### # ### # ###
#. . .# #. .#.# # #   #.#     #   #   # #
# ### ### ### # ### ### # ####### # ### #
#. .# #. .# #.#     #. .  #       #   # #
# # ### ### # ####### ############# ### #
# #. . .    #. . . . .                  #
#########################################
