################### #####################
#           #    . .  #. . .            #
# ##### ##### ### ##### ### ##### ##### #
# #   #       #  . . . .  #.    # #     #
### # ############### ##### ### # # #####
#   #   #      . . .#   #. .  # # #   # #
# ####### ##### ### ##### ### # # ### # #
#     #   #    .# #. . . .#   # #   #   #
##### # ### ### # # ####### ### # # #####
#       # # #. .# # #     # #   # #   # #
######### # # # # ### ##### # ### # # # #
#      . .# #.# #   #       # # # # #   #
# ##### # ### # ### ######### # # # #####
#   #. .#. . .#   #     #     #   #     #
##### ####### ### ##### # ### ####### # #
#  . .#       # # #   # # #   # #     # #
# # # ######### # ### # ### ### # # # # #
# #.# #. . . . .#   # #     # #   # # # #
# # ### ####### ### # ####### ##### ### #
# #. . .  #   #.# # # #     #   #   #   #
# ##### # # # # # # # # ### # ##### # # #
# #   # #   # #.#   #   # # #       # # #
# ### # ####### ######### # ######### ###
#     # #. . . .          #   #     #   #
# ##### # ########### ####### # ##### # #
# #   # #. .#. . . .#         #     # # #
# # # # # # # ##### ######### ##### ### #
#   # # # #. .    #.        #     #   # #
####### # ### ### # ####### ##### ### # #
#       #   # #   #. . . .#   # # # #   #
# ######### # # ####### # ### # # # #####
# #         # #   #. .# #.  # #   # #   #
# # ######### ##### # ### # # ##### # # #
# #   #. . .# #. . .#. . .# #     #   # #
# ### # ### ### ######### # ### # # # # #
#   # #. .#. . .#   #     # #   # # # # #
### # ### ######### ####### # # ### #####
# # # # #.#         #       # # #   #   #
# # # # # # ######### ####### ### ##### #
#   #   #.#           #                 #
######### ###############################
