####################### #################
#          . . . . .#. .    #     #     #
########### # ##### # # # # # ### # ### #
#. . . . . .# #    . .# # # #   # # #   #
# ############# ### # # # # ### # ### ###
#.#       #     #   # # # #     #     # #
# # ####### ######### # ### ########### #
#.#       # #   #     #   #           # #
# ####### # # # # ##### # ########### # #
#.  #   #   # # # #   # #           # # #
# # # ####### # # # # ############# ### #
#.#   #. . .  # # # #   #         #   # #
# ##### ### ##### ##### ######### ### # #
#. . . .  #. . .#       #       #   #   #
# ####### # ### ######### # ### ### # ###
# #   #   #   #.#. . . . .#   #   # #   #
# ### ######### # ####### ### ##### #####
#   # #. . . . .#.  #   #.  #     # #   #
# # # # ####### # ### ### # ##### # # # #
# #   #.#   #   #.    #. .#     #   # # #
# ##### # ### ### ##### # ############# #
#   #  .#     #. .#. . .# #. . .        #
##### # ####### ### ####### ### #########
#     #.    #. .  #.#. . .#.# #. . .    #
# ##### ##### ##### # ### # # # ### ### #
# #   #. .#. .# #. .#.# #. .  # # #.  # #
# # # ### # ### # # # # ### ### # # ### #
#   #   #. .    #.# #.#   # # #   #. .# #
# # ### ### ##### ### ### # # ####### # #
# #   #   # #   #. . .    # #   #  . .# #
# ### # # ### # # # ######### # # # #####
# #   # # #   # # #           # # #. . . 
# # ### # # ##### ######### ### ### ### #
# # # # #       #       # #   #   #   # #
# # # ############# ### # ### ### ### # #
# # #       #     #   # #   #   #   # # #
# # ####### ### ### ### ### ##### # # ###
# # #     #   #   #   #   # #     # #   #
# ### ### ### ### ### ### # # ######### #
#       #     #       #   #   #         #
#########################################
