##### ##################### #############
#    .#. . .#. . . . .  #. .            #
# # # # ### # ####### ### ############# #
# # #. .# #. .      #.#. .  #         # #
### # # # # ####### # # ##### ##### ### #
#   # # # #   #. .# #.#. .#   #   #   # #
# # # # # ### # # ### ### # ### # ### # #
# # # # #   # #.#. .#.  #.#     #   # # #
# # # ##### # # ### # ### ##### ##### # #
# # #       # #.#  . .#. .#   # #   # # #
# ####### # # # ####### ##### # # # # # #
#       # # # #. . .#. .      # # # # # #
# # ### # ### # ### # ######### # # ### #
# #   # # #   #   #. .        # # #   # #
### # # # # ################# # # ### # #
#   # # # #                 #   # # # # #
# # ### # # ##### # # # ######### # # # #
# # #   # # #   # # # #             # # #
# # # # # ### # # # ######### ######### #
# # # # #     # # #     #   #         # #
# # # ######### # ##### # # ######### # #
# # #       # # #     #   # #     #   # #
# # ### ### # # ### ####### # ### ##### #
# #   #   # # #   #   #   #   #   #     #
# ##### # # # # ##### # # ##### ### # # #
# #   # # # # #   #   # #     # #   # # #
# # # # # # # # # ##### ##### # ####### #
# # #   # #   # #     # #     # #       #
# # ############### # ### ##### #########
# #         #     # # #   #   #         #
# ####### # # ##### # # ### # ### #######
#       # #   #     # #   # #   #       #
# # ### # ####### ### ### # ### ####### #
# #   # #     #   #   # # #   #   #     #
# ### # ############### # # ##### #######
#   # #                   # #   #       #
### ######### ######### ### # ##### #####
# #     #   #         #   # #     #     #
# ##### # ##### ##### ##### ##### ##### #
#       #           #             #     #
#########################################
