############################# ###########
# #                 #        . . .  #. .#
# # ######### ### ### ### ####### ### # #
#   #   #     #   #   #   #  . . .#. .#.#
##### # ######### # ### ### # ##### ### #
#     # #       # # #   #   #.#. . .  #.#
# ##### ####### # # # # # ### # ####### #
#   # #   #     # # # # # #. .#. .# #. .#
### # ### # ##### # # # # # ##### # # # #
#   #   #     #   # # # # #. .  #.  #.# #
##### # # # ### ### # # # ### ### ### # #
#   # #   #     #   # # # # #. . .#. .# #
# # ##### ####### ### ### # ####### ### #
# #     # #     #   #   #   #. . . .# # #
# ##### # ##### ####### ##### ##### # # #
# #   # #   # #   #     #  . .#. .# #   #
# # # # ### # ### # ####### ### # # ### #
# # #   #    . .#   #. . .#. . .#.# #   #
# # ##### ### # ##### ### ##### # # #####
# #       #  .#. . . .#  . . .# #.#     #
# ######### # ####### ####### ### ### ###
# #   #     #.#       #. .#  . . .# #   #
# # ### # ### ######### # ##### # # # # #
# #     # #  . . . .  #.#. . .# # # # # #
######### # # # ### ### ### # # # # ### #
#         # # # # #. . .# # #.# # #     #
# ### # ##### # # # # ### # # # # ##### #
# #   # #     #   # #   # # #.# # #     #
# # # # # # # ##### ### # # # ### # #####
# # # # # # #     #   # # # #.#   # #   #
# # # # # ########### ### ### # ##### # #
# # # # #       #   # #   #. .#       # #
# # # # ####### # # ### ### ########### #
# # # #     # #   #     #  . . . .    # #
# # ####### # ######### ### ##### ##### #
# #   #     #   #     # #   #   #.  #   #
# ### ######### # ### # # ### # # ### ###
# # #           #   # # #     # #.#   # #
# # # ####### ##### ########### # # ### #
#   #       #     #             #.#     #
################################# #######
