############################# ###########
#   #         #        . . .#.    #     #
# ### ### ### # ### ### ### # ### ### ###
#     #   # # # #   #  .# #.#.  #       #
####### ### # # # ##### # # # # # ##### #
#         # # # #     #.# #. .# #   #   #
######### # # ####### # # ##### ### #####
#       # #   #   #   #.#         #     #
# ##### # # ### # # ### ##### # ### ### #
# #. . .# #   # #   #  .    # #   # # # #
# # ### ##### # ####### ### ##### # # # #
# #.#  . . . .# #   #. .  #     # #   # #
# # ######### # ### # # # ##### # ##### #
# #. .#      .#     #.# #     # #   #   #
# ### ####### ####### # ####### ### ### #
#   #.#     #.#. . . .# #       #   #   #
### # # ### # # ##### # # ########### ###
#   #.#   #  . .#     # #   #       # # #
# ### ### ####### ##### # # # ##### # # #
# # #. .# #       #     # # #   # # # # #
# # ### # # ####### ##### # ##### # # # #
# #   #.# # #       #     # #     #   # #
# ### # # # ####### ####### # # ####### #
#     #.# #       #     #     #       # #
####### # # ##### ##### ### ####### ### #
 . . . .# # #   #     # #   #     #     #
####### # # ### # ### # # ### ### #######
#       # #     # #   # # #   #   #     #
# ####### ######### ### # ##### ####### #
# #       #   #     #   #     #         #
# # ####### # ### ### ##### # # #########
# #     #   #   # #       # # # # #     #
# # # # ####### # ### # # # # # # # ### #
# # # #     #   # # # # # # #   #   # # #
# # ##### # # ##### ### # ### ####### # #
# #     # # #           #   #   #     # #
# ################# ### ### ##### # ### #
#     #         # # #   # #       #     #
# ##### ### ##### # # ### # #############
#         #       # #     #             #
#########################################
