################# #######################
#    . .#  . . . .              #   #   #
##### # # # # # # ####### # ### # # ### #
#. . .#.# #.# # #   #     #   #   #     #
# ##### # # ### # # ##### # #############
#.#   #.# #. .# # #     # #             #
# ### # # # # # ### # # ######### # #####
#.#   #.# # #.#   # # #   #     # #     #
# # ### # ### ### ### ### ##### # ##### #
#.# #. .#   #. .# #     #     # #     # #
# # # ##### ### # # ### ### # # ####### #
#.#. .#   #   #.# # # #   # # #         #
# # ### # ##### # # # ### # # ###########
#.#.#   #. . . .# # #     # #       #   #
# # ##### # ##### # ######### # ### ### #
 .#.#. . .# #     # #       # #   #     #
### # # ##### ##### # # ### ### # #######
#  . .# #     #       #   #   # # #     #
##### ### ######### # # # ### # # # # # #
#     #   #   #     # # #   # # #   # # #
# ##### # ### # ##### # ### # # ##### ###
#   #   # #   # #     #   # # #     # # #
##### ### # ### ####### # # # ##### # # #
#     #   #     #       # # #     # #   #
# ### # # # ##### ##### ### # ### # ### #
# #   # # # #     #     #   # #   #   # #
### ### ### # ##### ##### ##### # ### # #
#   #     # # #         # #     # #   # #
####### # # # ########### # # # # # # # #
#     # # # #     #       # # # # # # # #
# ### ### # ##### # # ####### ### # ### #
# # #     #     # # #     #   #   #   # #
# # ########### # ####### # ### ##### ###
# #           # #     #   #   #     #   #
# ### # ##### ####### # ### # ##### ### #
#   # # #   #         # #   #     # #   #
### ### # # ########### # # # ####### # #
# # #   # #     #       # # # #   # # # #
# # # ### ############### # # # # # # # #
#   #   #                 # #   # #   # #
#########################################
