######### ###############################
#      . .        #   #             #   #
# ##### # # ### # # ### ####### ####### #
#   #. .# #   # # #           #         #
##### ### # ### # ########### ###########
#. . .#   # #   # #     #   #     #   # #
# ### ##### # # ### ### ### ##### ### # #
#. .# #     # # #   # #     #   #   # # #
# # ### ##### ### ### ######### ### # # #
# #. .# #   # #   # #           #  . . . 
##### # # ### # ### ##### ##### ### #####
#. . .# #     #   #   #   # # #   #.#   #
# ##### ####### # ### # ### # ### # # # #
#.#   #       # #   # #   # #   # #.# # #
# ### ##### # # # ### ### # ### # # ### #
#. .#     # # # #   #   # #     # #. .# #
# # ##### ### # ### ### # # ##### ### # #
# #.  #       # # #   #   # #   #. . .# #
### # ######### # ### ##### # # # ##### #
#. .#   #     #. .  #       # # #.#   # #
# ##### # ### # # ########### # # ### # #
#. . .# # #   #.#. . .        # #.#   # #
##### # # # ### ##### ########### # ### #
#. .#.# # # #. .#   #. . .  #. . .  #   #
# # # # # # # ### # ### # # # ####### ###
#.#. .# # # #.# # #   # #.# #.    #   # #
# ##### ### # # # ### # # ### ##### ### #
#.#     #   #.# # # # # #. . .      #   #
# # ##### ### # # # # # ### ######### ###
#.#   #. . . .  # #   #   #       #     #
# ##### ######### ####### ### ##### ### #
#.#. . .        #       #   #       #   #
# # ########### ### ####### ######### # #
#.#. .#       #         # #   #     # # #
# ### ### ######### ### # # # ##### # # #
#. . .#   #       #   # # # # #   # # # #
# # ### ### ##### # ### # # # # # # # # #
# #   #   # #   # #   #   # # # # # # # #
# ##### ### # # # ### ##### # ### # # # #
#           # #   #   #     #     #   # #
#########################################
