############### #########################
#. . . . . . . .  #     #     #         #
# ####### ### # ### ### # # ### ##### # #
#.#       #   #     #   # #     #   # # #
# ######### ### ##### ##### ####### ### #
#. . .  #   #   #   #       #     #     #
# ### # ### ##### ### ### ### ### #######
# # #.#   #     #   #   # #   # #   #   #
# # # ### ### # ### ### ### ### # # # # #
#   #.  #   # # #   # #     #   # # # # #
##### ####### # # ### ####### ##### # # #
#. . .#     # # #     #       #     # # #
# ##### ### # ### ##### ######### # # # #
#. .#   # #   #   #           #   # # # #
# # ##### ##### ### ######### # ##### # #
# #. . . . .    #. .        # #     # # #
# # ####### ##### # ####### # ##### # # #
# #       #. . . .#. . .  # #     # # # #
# ######### ##### ##### ### # ### ##### #
# #       #     #   #. .#   #   #       #
# # ##### ##### ##### # # # ### # # #####
# # # # #   # # #. . .# # # # # # #     #
# # # # # # # # # ##### # # # # # ##### #
#   # # # # #   #. . .# # # # # #     # #
##### # ### ##### ### # # ### # ####### #
 . .# #   # #. .# #. .# # #   #   #     #
### # ### # # # ### ### # # ##### # ### #
#  . .# #   #.#. . .#   # # #   # #   # #
##### # ##### ########### # # # # ##### #
#   #.#      . . .# #     #   # # #   # #
# ### ####### ### # # # ####### # # ### #
# #. .#  . .#   #.# # # #       # #     #
# # ##### # ##### # # # # ####### #######
#  . . . .#. . .#.#   # # #     # #   # #
############### # ####### # ### # ### # #
#           #  . .  #     # # #   # # # #
# ######### # # # ### ##### # ##### # # #
#   #     # # # #         #   #     #   #
### ### # ### # ############### ### ### #
#       #     #                   #     #
#########################################
