########### ##### #######################
#     #   #.#    . . .              #   #
# ### # ### # ####### ############# ### #
# #   # #. .#       #. . .        #     #
# # ### # ######### ##### ###############
# #      . . . . .#     #. . . . . .    #
# ############### ############### # #####
# #   # #     #  .#  . . .#. . .# #. . .#
# # # # # ### ### ### ### # ### ### ### #
# # # # #   #   #. . .# #. .#  . .#   #.#
# # # # ### ### ####### ######### ##### #
# # # # #   #   #. . . .        #. .#. .#
# # # # ### ##### ##### ########### # ###
# # # #   #     #. .# #.#. . . . .#.#. .#
# ### ### ##### ### # # # ####### # # # #
#   # #   #   #   #.# #. .#     #. .# #.#
### # # ### # ### # # ######### ####### #
#   # # #   #   #  .# #    . . .#    . .#
##### # ##### # ### # # ### ### ##### # #
#     # #     #    . .#   #. .#. . .#.# #
# ##### # ########### ##### # ##### # # #
# #     #   #       #. . .# #.#    .#.# #
# ### # ##### ##### ##### ### # ### # # #
# #   #       #     #    . . .# #  . .# #
# ######### ####### ######### ### ### # #
#           #             #   #   #   # #
############# ########### # ### ### ### #
#     # #     #   #     #   # # #     # #
# ### # # ### # ### ### ##### # ####### #
#   #   #   # #   # # # # #   #   #     #
### ##### # ##### # # # # # ##### # # # #
# #     # #       # # # # # #     # # # #
# ##### ########### # # # # # # ##### # #
#     #             #   #   # #   #   # #
##### ########### ##### # ####### # ### #
#   #             #   # #         # # # #
# # ############# # ### ########### # # #
# #   #             # #             # # #
# ### ############### ########### # # # #
#   #                             # #   #
#########################################
