####### #################################
#      .  #  . .  #. .          #   #   #
# ##### # ### # ### # ### ##### # # # # #
#   #. .#   #.#. . .#.  # # #   # # # # #
### # ##### # ####### # # # # ### # ### #
#   #. .#   #. .# #. .# # # # #   #     #
# ### # # ##### # # # # # # # ##### #####
# #   #.# #. . .# #.# # #   #       #   #
# ##### ### ##### # # # ############# # #
#     #. . .      #.# #     # #. .    # #
# # # # ########### ####### # # # ##### #
# # # #     #     #. .    # # #.#. .  # #
# # # ##### ##### # # ##### # # ### ### #
# # #     #     #   #. . .# #. .  #. .# #
# # # ######### ##### ### ### ####### ###
# # # #       #     #   #. . .      #. . 
# # # # # ####### ####### ######### # ###
# # #   #     # #   #   #   #     # #   #
# ### ### ##### ### # # ### # ### # #####
#   #   #     #   #   #   #   # # #     #
### ### ##### ### # ### # # ### # ##### #
#   #   #   #     # #   # #     #     # #
# ####### ### ##### # ### ####### # # # #
#       #   #     # #   #   # # # # # # #
# # # ##### ##### # # # ### # # # ### # #
# # #     #     # # # # #   #   # #   # #
# ####### ##### ### # # # ##### ### # # #
#       #     # #   # # # #   # #   # # #
######### ### # # # # ### # # # # ### # #
#           # #   # # #   # #     # # # #
# ### ####### ### ### # ########### # # #
# # #   #     #   #   # #         #   # #
# # # # # ######### ### ######### ##### #
# #   # # #   # # # # # # #     #       #
# ####### # # # # # # # # # ### ### ### #
# #     # # #     #   # # # #   #   #   #
# # ### # ####### ##### # # # ### ### # #
# # #   #     # #   #   # # # #   #   # #
# ### ### ### # ### ### # # # ####### # #
#       #   #   #       #   #         # #
#########################################
