################### #####################
#   #            . .      #   #   #     #
### # ######### # ####### # # # # # ### #
#   # #         #. . .#   # #   # # #   #
# ### # ####### # # # ######### ### # # #
# #   # #       # # #. .        #   # # #
# ####### ####### # # # ### ##### ### ###
#         #       # # #.  #         #   #
# ##### ########### ### # ######### ### #
# #     #  . . . .#   #.#         # #   #
### ##### # ##### ### # ##### ### ### ###
#   #     #.#   #. .# #. .  # # #   #   #
# ### ##### ### ### ### # # # # # # # # #
# #   #   #. .# #  . .# #.# # # # # # # #
# # # # ### # # ##### ### # # # ### # # #
# # # #     #.#      . . .# # #     # # #
# # ######### ########### # # ### #######
# #       #  .#           # #   # #   # #
# # # ##### # # ########### # # ### # # #
# # # #   # #.# #. . .#     # #     # # #
# # # # # # # # # ### # ##### ####### # #
# # # # #   #.# #.#. .#     #       # # #
# ### # ##### ### # ####### ### # # # # #
# #   #     #. .#.#. . .  #   # # # #   #
# # ####### ### # ##### # # # ### #######
# # #     # #. .#. .# #.# # #   #     # #
# # # ### # # ##### # # # ### # ### ### #
# #     # # #. . . .# #.#   # #   #   # #
# # ### # # # # ##### # ### ##### # # # #
# # #   # # # #       #.  #   # # # #   #
# # ####### # ######### # ### # # ### ###
# #       # # #. . . . .# #   # #   #   #
# ######### ### # # ##### # ### # # ### #
# #         #. .# # #     #     # #   # #
# ### ####### ##### # ### ####### ##### #
#   # #   #  .#     # #   #     #     # #
### # # # # # ####### ##### ### ####### #
#   # # # # #. . . .#       # #     #   #
# ### # # # # ##### ######### ##### # ###
# #   # #   #     #.        #       #   #
################### #####################
