##### ########### #######################
#   #.#          . . . .        #   #   #
# ### ########### # ### # ##### ### # # #
#. . .#. . . . .# # #. .#     #       # #
# ##### ####### # ### # ### ##### ##### #
#.#  . .#      .# #. .#   #     #     # #
# # # # ####### ### # ####### # ##### # #
#.# #.# #      . . .# #     # #     # # #
# # # # # ########### # ### # ### # # # #
#.# #.# #       #     # #       # # # # #
# ### ########### ##### # ### # # ### ###
#. .#. . . .  #   #     #   # # #   #   #
### ### ### # # ### ### ### # ##### ### #
# #. .#   #.# #   #   #   # #   # #   # #
# ### ##### # ### ##### ### ### # # ### #
#   #. . . .#   #     #   #   #   # #   #
### # ### # ######### # # ### ##### # ###
#   # #   # #         # #   #   #   #   #
# ##### ### # ### ####### # ### # ##### #
# # #   #   # #   #       #   # # #     #
# # # ##### # # ### ### ##### # # #######
#   #   #   # # #   #   #   # # # #     #
### ### # ### # # ##### # # ### # # ### #
# #   # # #   # # #     # #     #     # #
# ### ### # # # # # ##### # ##### # ### #
#   #   # # # # # #   #   # #     # #   #
### ### # # # ### ##### # # # ##### # # #
# #       # # #   #     # # # #   # # # #
# ####### # # # ##### ##### # # # # ### #
#         # # #   #   #   # # # #   #   #
### ####### # ### ##### # ### # ##### ###
#   #   #   #   #     # #     #   #   # #
# ### ### # ####### # # ######### # ### #
# #   #   # #   #   # # #       # #     #
# # ### # ### # # ##### # ##### # #######
# # #   # #   # # #     # #   # #   #   #
# # # ### # ##### ####### # # ### # # ###
#   # #   # #               # #   # #   #
##### ##### # ################# # # ### #
#           #   #               # #     #
#########################################
