################### #####################
#   #              .                    #
# # ### ######### # ### # ############# #
# #     # #       #.  # #             # #
# ##### # # ##### # # ######### ### ### #
# #   # # # #     #.#   #     #   #   # #
# ### # # # # ##### ### ##### ##### # ###
#     # #   # #   #. .#       #   # #   #
# ##### # ### # # # # ########### ### # #
# #     # #   # # # #.        # #   # # #
# # ####### # # # ### ####### # ### ### #
# # #       #   #   #. .#     #   #     #
### # ####### ##### # # # ####### ##### #
#   # #     #     # # #.# #       #   # #
# ### # # # ####### # # # # ######### # #
# # # # # #   #   # # #.# #. . . .  #   #
# # # # # ### ### # # # ### ##### # #####
#   # # # # #   #   # #. .#.#   #.#     #
##### # # # ### ##### # # # # ### ##### #
#     # # #       #   # #.#.# #. .    # #
# ### # # ####### # ### # # # # ####### #
#   # # # # #   # # # # #. .  #.#       #
# # # # ### # # # # # # # ##### ####### #
# # # # #   # # #   # # #   #  . .    # #
### # # # ### ### # # # ### ##### ### ###
#   # # #   #     # # #   #     #. .#   #
# ##### ### # ##### # # ####### # # ### #
# #   #     # #   # #   #       # #.  # #
# ### ######### # # ##### ######### # # #
# #     #   #   # #   # # #. . . . .# # #
# ##### ### # ####### # # # ### # ##### #
#   # #     #       # # # #.#   # #     #
### # ##### ####### # # # # ##### # #####
# # #   # # # #     # # # #. . .# # #   #
# # ### # # # # ##### # # ##### # # # ###
# #   # #   # #     #   #     #.# # #   #
# ##### ### # ##### ########### # # ### #
# #   #             #     #  . .# #   # #
# # # ############# # ### # # # # ### # #
#   #                 #     #.# #   #   #
############################# ###########
