############### #########################
#   # #        . .            #         #
# ### # ##### # # ########### # ### ### #
# #   #     # # #.#. . . .  #   # #   # #
# # ####### # ### # ##### ##### # # ### #
#       #   #   #. .    #. .  # # #   # #
####### # ##### # ######### # ### # # # #
#     # #     # #         #.#     # # # #
### # # ####### ########### ####### # ###
#   #       #   #  . . .#. .  #     #   #
# ######### # ### # ### # # # ####### # #
# #       # # #   #.#. .#.# #       # # #
# # ##### # # # ### # ### # ####### # # #
# # # # # #   # #. .#. . .#   #   # # # #
### # # # ### # # ####### ##### # # # # #
#   # # #     # #. . .#   #     #   # # #
# ### # ####### # # # ##### ####### # # #
#   # #     #   # # #.#     #     # # # #
##### # ### ### # # # # ### # ### # # # #
# #   # # #     # # #.#   # #   #   # # #
# # ### # ####### # # ### ##### ##### ###
#       # #       # #. .#     #     #   #
##### # # # ### ### ### ########### ### #
#     # #   #   #   #. .  #     # #   # #
# # ### # ### ### ### # ### ### # ### # #
# # #   # #   #   #. .#   # #   #     # #
### # ##### ### ### ##### ### ######### #
#   # #   # #   #  .#     #   #   #     #
# ### ### ### ### # # ### # ### ### #####
# #   #   #   #   #.#   # # # # # #   # #
### ### ### # # ### ### ### # # # ### # #
# # #   #   # # #  .  #       #   # # # #
# # # ### ### # ### # ##### ##### # # # #
# #   #   #   #   #.#     #   #   # # # #
# ####### ####### # ##### ### # ### # # #
#         #     # #. .#   #   #   #   # #
####### # # ### # # # # ####### ####### #
#   #   # # # #   # #.#     #       #   #
# # ##### # # ##### # ##### # ####### ###
# #       #   #     #.    #             #
##################### ###################
