####### #################################
#   #  . . . .  #. . .        #   # #   #
# # # ##### # ### ### # ##### # # # # # #
# #   #   # #.#. .  #.#     #   # #   # #
# ####### # # # ##### ### # ### # ##### #
#         # #. .#   #.  # #   # #     # #
########### ##### # # # # ### ### ### # #
 . . . .# #     # # #.# #   #   #   #   #
####### # # ### ### # ### # # # #########
#     #.# #   #     #.#   # # #     #   #
# ### # # ########### # ### # ##### ### #
# #   #.# #      . . .#   # # #   #     #
### ### # # ##### # # ### # ### # # #####
#   #. .# # # #. .# # #   #     # #     #
# ### ### # # # ### # # ##### ### ##### #
# #. .#   #   #.#   # #     #   #     # #
# # ### ####### # ### # # # ##### # # # #
# #.# #      . .#   # # # #     # # # # #
# # # ####### ####### # # ##### ### ### #
#  . .#    . .#     # # #     #   #   # #
##### ##### # # ### # ####### ### # # ###
#   #. . . .# # # # # #       #   # #   #
# # # ##### # # # # # ####### # ### ### #
# # # #     # # # #   #       # #   #   #
# # # # ##### # # # ########### # ### # #
# # # # #     #   # #   #       #   # # #
# # ### # # ####### # # # ### ####### # #
# # #   # #     #   # # # #   #       # #
# ### ### # ### ##### ##### # ####### # #
#     #   #   #     #       # #     # # #
####### ##### ### # ##### # ####### ### #
#     # # # #   # #     # # #       #   #
# ##### # # ##### ##### ### # ####### # #
#       # # #         #   # # # #     # #
####### # # # # ##### ### ### # # #######
# #     # # # #     #   #   # # # #     #
# # ##### # ##### ##### # # # # # ##### #
# #   #   #       #   # # # #   #     # #
# ### # ######### # ### # # # ####### # #
#     #           #     # #         #   #
#########################################
