########### #############################
#    . . .#. . .                #       #
# ### ### # ### ### ##### ##### ####### #
# #  .#. .# #. .  #     #     #   #     #
# # # # ##### # ##### ####### ##### #####
# # #.#. . . .# #   #     # #   #   #   #
# # # ######### # # ### # # # # # ### # #
# # #. . . .#   # #   # #   # # # #   # #
# ######### ##### ##### ##### ### # #####
#       # #. . .#   #   #   #     # #   #
# # # # # ##### ### # ### # ####### # ###
# # # #   #. . .  #   #   #     #       #
# # ####### ### # ### # ##### ### ##### #
# #   #  . .#   # #   # #   #         # #
# ### # # ####### ##### # ########### # #
#   # # #. . .  #       #. .      #   # #
# # # # # ### ########### # ##### # #####
# # # # #   #. .    #. . .#.  # # #     #
# # # # ##### # ##### ##### # # # ##### #
# # # #     # #. .#. .# #. .#   #   # # #
# # # ##### # # # # ### # # ####### # # #
# # #   #   # # #.#.#   #.#   # #   # # #
### ##### # # # # # # ### ##### # # # # #
#   #     # # # #. .  #. .# #   # # #   #
# ### # ### # ######### # # # ### #######
#   # # #   #     # #. .#   #   #   #   #
### ### # ### # # # # ######### # # # # #
#   #   # #   # #   #.#. . .  # # # # # #
# ### # # ########### # ### # # ### # ###
#   # # #         #  .#.# #.# #     #   #
### # # ########### # # # # # ######### #
#   # #       # #   #. .  #.#   #       #
##### ####### # # ### ##### ### # #######
#     #     #   # #   #. . .  #         #
# ##### ### ##### # ### # # ########### #
#   #   # #   #   # #. .# #   #     #   #
# # # ### ##### ##### ### # # ##### # # #
# # # #         #  . .#   # #       # # #
# ### ### ####### # ### ############# # #
#   #     #       #.#   #             # #
################### #####################
