################# #######################
# #     #     #  .      #. .  #. . . . .#
# # ### # ### # # ##### # # ### ####### #
# #   # #   # # #. . .# #.#. . .#     #.#
# ### ##### ### # ### # # ##### # ##### #
#   #     #   # # # #.# #.#   #   #  . .#
### ##### ### # # # # ### ### ##### # # #
#   #         # # # #. .#.#       # #.# #
# # ##### ##### # # # # # # ####### # # #
# #     # #     #   # #. .  #       #.# #
# ##### # ### # ##### # ############# # #
#   # # #     #     # # #     #  . . .# #
# # # # ##### ####### # # ### ### ##### #
# # # #   #   #       #   #   #. .#   # #
### # ### # ### ### ########### ### # # #
#   #   #   #   #   #    . . . .#   # # #
# ##### ####### # ### ### ####### ### # #
#   #   #       # #   #. .#       # #   #
##### # # # ### ### ### ### ####### #####
#     #   # # # #   #  .#   #   #. . .  #
# # ####### # ### # # # ##### ### ### # #
# # #       # #   # # #. . . .#. .#. .# #
# # # ####### # ##### ### ### # ### ### #
# # # #       # #   #   #   #. .#. .#   #
### # # ####### ### ### ######### # # # #
#   # # #             #     # #. .# # # #
####### # ######### ####### # # # ### # #
#     # #   #     # #     #   #.# #   # #
# ##### ##### ### ### ### ##### ### ### #
#   #         #       #  . . . .#   #   #
### ##### ############# # ##### # # # ###
# #   #   #             #.#     # # # # #
# ### # ### ############# # ##### # # # #
# # # # #   #        . . .#   #   # # # #
# # # ### # # ####### # ##### # ### # # #
# # #     # # #. . . .# #   # # # # #   #
# # ####### # # ####### # # ### # # # ###
# #         # #.# #     # #     # # #   #
# ########### # # # ##### ##### # # ### #
#             #.#   #       #   #   #   #
############### #########################
