########### ############### #############
#   #     #.#   #    . .#  . . . .  #   #
# # ##### # # # # ### # ##### ### # ### #
# #     #. .# # # #  .#. . .#   #.#     #
# ##### # ##### # ### ##### ### # #######
# #   #  . . . .# #. .#  . .#   #. . . .#
# # # ##### ### ### ##### ######### ### #
# # #     # #  . . .#    . . . . .# #. .#
### ##### ### ### ### ########### ### # #
#   #       # #   #   #       #  . .#.# #
########### ### ### ### # ### ##### # # #
#         #   # #   #   # #   #    . .# #
# ########### ### ### ##### ### ####### #
# #               #   #   # #   #       #
# # ############### ### # # # ##### # # #
#   #   #   # #     #   # # #   #   # # #
##### # # # # # ##### ### # ### # ##### #
#   # #   #   # #     #   # #   # #     #
# # ##### ##### # # ### ### ##### # #####
# #     #       # # # #           # #   #
# ##### ########### # ########### # # # #
# #   #             #         #   #   # #
# ### ####### ### ####### ##### # # # # #
#   #   #     #   #       #     # # # # #
# # ### # # ####### ##### # # ##### ### #
# # #   # # #       #       # #   #   # #
# ### ### # # ####### ##### ### # ### # #
#     #   # #   # #   #   # #   #   # # #
####### ### ### # # ##### ### ##### # # #
# #     #   #   # #     #     # #   # # #
# # ##### ### ### ########### # # ### # #
#   # #   #   #   # #       # #       # #
##### # # ### # ### # ##### # ######### #
#     # #   # # #   # #   # # #         #
# ##### # # # # # ### # ### # # ####### #
#   #   # # #   # #   #     # #   # #   #
### ####### # ### ### ##### ### # # ### #
# #       # #   #   # #   #   # # #     #
# ####### # ### ### ### # ### ### ##### #
#             #   #     #         #     #
#########################################
