# ################# #####################
#. .#. . . .      #.# #     #     #     #
# # # ##### ##### # # # # ### ### # ### #
# #.#. .# #. . .# #.#   # #   # # # # # #
# # ### # ##### # # ##### # ### # # # # #
# #. .#. .#   #.# #.#   # # # #   # # # #
# # # ### # ### # # # ### # # ##### # # #
# # #. . .  #. .# #.# #   #         # # #
# ### ####### ##### # # ### ######### # #
#   #   # #. .#. . .#. .#   #       #   #
# # ### # # ### ##### # # ### ##### #####
# #   #   #.#. .#. . .#.  # #     # #   #
##### ##### # ### ##### ### # ### # ### #
#     #    .#. . .#. . .#     # # # # # #
# ######### ####### ##### ##### # # # # #
# #   #. . .#   #. .#     #   # # #   # #
# # # # ### # ### ### ##### ### # ##### #
# # # #.#   # #. .    #         #       #
# # # # # ### # ####### ############### #
#   # #.#     #.# #     #         #   # #
# ### # ####### # # ##### ######### # ###
# # # #. . .#. .# #       #       # #   #
# # # # ### # ### ##### ### ##### ##### #
# # # #   #. .    #   #     # #   #     #
# # # ### # ####### ### ##### # ### #####
# # #   # #               #   #         #
# # ### # ########### ### # ####### #####
#     # # #         #   # #   #   # #   #
# ##### # # ### ### ### # ### ### ### # #
# #     #     #   # #   #   #     #   # #
### ##### ####### # ####### ### ### ### #
#   #     #     # #       #   # #   # # #
# ######### ### # ####### ##### # ### # #
# #         #           #   #   #     # #
# ############# # ##### # ### ### ##### #
# #           # #   # # #             # #
# # ######### ##### # # # # ######### # #
#   #       #     # #   # #     #   # # #
# ### ############# ##### ##### # # ### #
#   #               #     #     # #     #
#########################################
