############################### #########
#   #                    . . . .#       #
# # ### ####### ######### # # # # ### # #
# #     #       #  . . . .# # #   # # # #
# ####### # ####### ##### ### # ### # # #
# #   #   # #  . . .#     #   #   # # # #
### # ##### # # ##### ##### ##### # # # #
#   #       # #. . .# #     #   #   # # #
# ##### ####### ### ### ####### ##### # #
#     # #  . .#   #.#   #       #     # #
##### ### # # ### # # ####### # # ##### #
#. .# #   #.#. .# #.#       # #   #   # #
# # ### ### ### ### ##### # # ##### # # #
#.#.# # #  .#  . . .#   # # #   #   # # #
# # # # ### # # ##### # ### # # ##### # #
#.#. .# #. .# # #     #     # #     #   #
# ### # # # # # ############# # ####### #
 .#  .# #.# # # #   # #       # #   # # #
##### ### ### # # # # # ### # # # # # # #
#   #. . .#   #   # # # #   # # # # # # #
# # ### ### # # # # # # # ### # ### # # #
# #     #   # # # # # # # #   #     # # #
# ####### ##### # # # # # # ######### # #
# #     # # #   # # #   # #       #   # #
# # ##### # # # # # ############### ### #
# # #   # #   # # #               #     #
# # # # # ####### # # ########### #######
#   # # #   # #   # #         # #   #   #
##### ##### # # # # ### ##### # # # ### #
#         # #   # #   #     #   # #   # #
######### # ############### ##### ### # #
#     #       #             #     #   # #
# ### # ####### ######### # # ##### # # #
# # # #   #     #     #   # #     # # # #
# # # ##### ####### # ##### # ### # # # #
# # #       #       #       #   # # # # #
# # # ####### ####### ########### # ### #
# #   # #     #       #           #   # #
# ##### # ############# ### ### # ### # #
#       #             # #   #   #   #   #
#########################################
