################################# #######
# #   #                  . . .#  .      #
# # # # # ##### ### ##### ### ### ##### #
# # # # # #     #   #  . .#  . .#. .  # #
# # ### ### # ### ### # ####### ### # # #
#     #   # #   # # # #.#. .# #. .#.# # #
##### ### # ### ### # # # # # ### # ### #
#         # # #   # # #. .#.# # #.#. .# #
# ######### # ### # # ##### # # # # # ###
#   #     # # #   # #     #.# #. .# #. .#
##### ##### # # # # ####### # # ####### #
#     #     # # # # #  . . .# #. . . .#.#
# ##### # ### # # # # # ### # ####### # #
# #     #     # # # # #.#   # #      . .#
# ############# ### # # # ### # ##### # #
#               #   # #.# #   # #   # # #
########### ##### ### # ### ##### # ### #
#           #     #   #. .#       #   # #
# ######### # ####### # # ########### # #
# #     #   #   #     # #.  #           #
# # ### # ##### ### ### # # ########### #
# # # # # #   #     #   #.#       #   # #
# # # # # ### # # ### ### ####### # # ###
#     # #     # # #   #. .#. .  #   #   #
# # ### ##### ### # ### ### # ######### #
# # #       # #   #   #.#. .#. .      # #
# # ####### # # ##### # # ##### ####### #
# #       # # # #   # #.#.#   #. . . .# #
# ####### # # # ### # # # # # ### ### ###
# #     # # # #     # #. .  #   #   #. . 
### ### # # ######### # ####### ### #####
#   #   # # #       # #       #   # #   #
# ######### # # ### # ####### ### ### # #
# #   #     # # # #   #     #   #     # #
# # # ### ### # # # # # ### # # ####### #
# # #     #   # # # # # #   # #   #   # #
# # ####### ### # # # ### ####### # # # #
# #     #   #   # # # # #       # # # # #
# ####### ### ### # # # ####### # ### # #
#         #     #   #   #           #   #
#########################################
