########### #############################
#        . .                  #         #
# ##### # # ############# # # # ### ### #
#   #   #.#     #. . .  # # # # #   #   #
### # ### ####### ### # ### ### # # #####
#   #   #. . . . .  #.#   #   # # # #   #
##### # # ########### ### ### # ##### # #
#   # # #       #. .#.  #   #         # #
# # # # ######### # # # ### ######### # #
# # # # #      . .#.#.#   #   # #   # # #
# # ### ####### ### # ### # # # # # ### #
# #     #. . . .#. .#.  # # # #   #     #
######### # ##### ### # # ### ###########
#. . . . .# #   #. . .# # #   #         #
# ####### ### # ##### ### # # # ##### # #
#. . .#   #   #   #   #   # # #     # # #
# ### # ### ##### # ### ### ### ##### # #
# #. .# #     #   # #     #         # # #
# # # # # ### ##### # # # ##### ### ### #
# #.# # # # #       # # #     #   # # # #
### # # ### ####### # ##### # ##### # # #
 . .# #   # #       #     # #   #   #   #
# ##### # # # ########### # # # # #######
# #   # # # #   #     #   # # # #       #
### # ### # ##### ### # ### # ##### ### #
#   # #   #     # # #   #   # #   #   # #
# ### # # ##### # # ######### # # ### ###
# #     #   #     #       #   # #   #   #
# ##### ### ############# ### # ### ### #
#   #   #   #                 # #       #
# # # ### ### ### ########### # # ##### #
# # # #   #   #   #           # # #     #
# # ### ### ### ### ### # ##### # # # # #
# # #   # # #   #   #   # #   # # # # # #
# # # ### # ##### ### ####### ### # # # #
# # #     #     # #   #     # #   # # # #
# ########### ### ### # ### # # ### ### #
#   #       #   # #   # # #   #   #   # #
### # ##### ### # # ### # ########### # #
#   # #         # #     #             # #
#########################################
