######################### ###############
#   #     #   #        . .#. . . .  #. .#
# ####### ### # ### ### # # ##### ### # #
#           #   #   #  .# #. .# #. .#.#.#
########### ##### # # # # ### # ### # # #
#             #   # # #.#   #. .# #.#.#.#
### ######### # ### # # ### ### # # # # #
#   # #   # # # #   # #. .# #. .# #. .#.#
# ### # # # # ### # # ### ### ### ##### #
#   # # # #   #   # #   #. . .  # #   #.#
### # # ### ### ### # # ### ### # # ### #
#   #           # # # #   #   #   #   #.#
# ############# # # # # # ### ####### # #
#       #   #   #   # # #   #       # #.#
######### # ######### ##### ####### # # #
#         #   #     #   # #     # #   #.#
# # ######### ##### ### # # ### # ##### #
# #   #  . . .#   #   #   # #   #. . . .#
##### ### ### # # ### ####### ### ##### #
#     #. .#  .# #     #       #  .#   # #
# ##### ##### ####### # ##### # # # ### #
# #    .#   #. . .# # #   #   # #.# #   #
# # ### # # ##### # # ### ##### # # # # #
# # #  .# # #   #. .#. .# #     #.# # # #
# # # # ### # ##### # # ### ##### # # # #
# # # #. .# #. . .#.#.#. .#     #.#   # #
# # ##### # # ### # # ### ####### ### # #
# #     #.# #.# #. .#.# #.#. . . .  # # #
# ####### # # # ##### # # # ##### # ### #
#   #  . .#  . . .#  .#  . .#   # #   # #
### ### ######### # # ####### # # # # ###
# #   #.#     # #.# #. .#   # #   # #   #
# ##### # ### # # # ### ### # ##### ### #
# #    .#   # # #.#   #. .# # #   #   # #
# # ### ##### # # ### ### # # # # ##### #
#   #  .  #   # #. .#   #.# # # #       #
##### # ### ### ### ##### # # # # #######
#   # #. .# # #    . . . .# # # # #     #
# # # # # # # ########### # # # # ##### #
# #   # #.#               #   # #       #
######### ###############################
