############### #########################
#      . . . . .#                   #   #
# ##### ##### # # ### ####### ####### # #
# #  . .#     #     #       #       # # #
# # # ##################### ####### ### #
# # #. . . . .        #   #       #     #
# ##### ### # ####### # # # ##### ##### #
# #   #   # #.  #   # # # #     # #   # #
# ### ### ### ### ### ### ### # # # # ###
#   #   #   #. .#     #   #   # #   #   #
### ### ### # # ####### ### ### ##### # #
#   #     # # #. . .    #   # #     # # #
# # # ##### # ##### ####### # ##### ### #
# # # # #   # #   #.    #   #     #   # #
# ### # # ##### ### ### # # ##### ### # #
#     # # #     #. .  # # # #   #     # #
####### # # ##### # ### # # # # ####### #
#     # #   #    .# #   # # # #         #
# ### # ######### ### ### # ####### # # #
# #    . .#  . .#.#   #   # #     # # # #
# # ### # ### # # # # # ### ##### ### # #
# # #  .#. . .#. .# # # #   #     #   # #
# ### # ######### # ### # # # ##### ### #
#   # #. .#. . .# #   # # # # # #   #   #
### # # # # ### # # # ### ### # # ### # #
# # # # #. .  #.# # #   #     #   #   # #
# # # ### ##### # # ### ############### #
# # #   #   #. .# #   #           #     #
# # ### ##### # # ### # ######### # ### #
#     #   #. .# #   # # # #       # # # #
### ##### # ### ### # # # # ### ### # # #
#   #     #.#   # # # # #   #   #   #   #
# ### ##### ##### # ### ######### # #####
#   # #   #. .#   #   #       #   # #   #
# # # # # ### # ##### # # ### # ##### # #
# # #   # #. .# #     # #   # #       # #
### # ### # ### # ####### ### ######### #
#   #   # #.#   # # #     #     #   #   #
# ####### # # ### # ####### # ### # #####
# #       #.#     #         #     #     #
########### #############################
