##################### ###################
# #   #     #       #. . . .        #   #
# # # ### # ##### ### # ### ##### ### # #
# # # #   #     #     #   #.  # #   # # #
# # ### ####### ##### ### # # # ### # # #
# # #   #     # #     #   #.#   #   # # #
# # # ### ### # ####### ### ##### # ### #
# # # #   # #     #     #. .#   # # # # #
# # ### ### ##### ### ### # # # # # # # #
#   #   #     #       #. .#   # # #   # #
# ### ### ### ######### # # ### # ##### #
#   #   # #      . . .#.# # #   #       #
### ##### # ##### ### # # # # # # #######
#         # #  . .#  . .# # # # # #     #
# ##### ### # # ##### # # ### ### # ### #
# #     #   # #. . .# # #   #   # # #   #
### ##### ### # ### ### ### # # # ### ###
#   # #   #   #   #. .#   # # # #       #
# ### # ### ####### # ##### ### ####### #
#     # #   #     # #. .# #   #       # #
####### # ### ### ##### # ### ### ### ###
#       #     #   #. . .#   #   #   #   #
### ############### ### ### ##### # # # #
#   #        . . . .#   #         # # # #
# ### # ##### ####### ### ######### ### #
# # # # #  . .# #   # #   #     #   #   #
# # # # # # ### # # # # ### ### # ### # #
# #   # # #. .#   # # # #   # # # #   # #
# ##### # ### ##### # # # ### # # # #####
#   #   #   #. .  #   # # # # # # # #   #
# # ### ### ### # ####### # # # # # ### #
# #   #   #   #.#   #   #     # # #   # #
##### # # ### # ### # # ### ######### # #
#     # #   # #.  #   #     #       #   #
######### # # # # ### ### ### ##### #####
#   # # # # # #.#   #   # #       #   # #
# # # # # # ### ### ### ### ######### # #
# # #   # #   #. .# #   #     #     #   #
# ### ####### # # # ##### ##### ### #####
#             # #.#               #     #
################# #######################
