################# ##### #################
#           #   #.#    . . . . . . .    #
########### # # # # ### # ######### ### #
#           # # #.#   # #         #.#   #
# ######### # ### ### # ######### # #####
#   #     # #. . .#   # #. . . .# #. .  #
### ##### # # ##### ##### ##### ##### # #
#   #   # #  . .#   #  . .#   #.#. . .# #
# ### # # ##### ####### ### # # # ### # #
# #   #        . . .#. .#   #. .#.#   # #
# ####### ######### # ####### ### # ### #
# #   #   #        . .#     #. . .# #   #
# # # # ##### ####### # ### ### ### # # #
# # # # #     # #   # # #       #   # # #
# # ### # # ### # # # # ######### ### # #
# #     # #   # # # # #     #     #   # #
# ### ### # # # # ### ####### ##### # # #
# #   #   # # #   #   #       #   # # # #
# # ### # # # ### ######### # # # # # # #
# #   # # # #   #           # # # # # # #
# ##### # # # # ####### ##### # ### # # #
#     # # # # #   #     #     #     # # #
####### # # ##### ####### ########### # #
#     # # #     #     #   #           # #
# ##### # ##### # # ### ### ### ##### # #
# #     #     # # #   # # # # # #   # # #
# ### # ####### # # # # # # # # # ##### #
#     # #       # # # #   #   # #     # #
### ### # # ##### ### ######### ##### # #
# # #   # # #   # #     #           # # #
# # # ### # # ### # ### # ##### ### # # #
#   #   # # # # # # #   # # #     # # # #
##### # # # # # ### # ### # # ### # # # #
#   # # # # # #   # # #   #   #   # # # #
### ### # ### ### ### # ####### ### # # #
#   #   #   # #     # #     #   #   #   #
# ### ##### # ##### ### ### # # #########
# #       # #         #   # # # #     # #
# ####### # ######### ##### # # # ### # #
#         #       #         # #     #   #
#########################################
