# #######################################
#. .  #. .                      # #     #
# # ### # ### ####### # ####### # # ### #
# #. . .#.  #     #   #     #   # # # # #
# # ##### # # ### # ####### ##### # # # #
# #     #.# #   # #       #         # # #
# ####### # # # # ##### ############# # #
# #. . . .# # # #     #             # # #
### # ### # ### ############# ####### # #
#. .# #   #   #     #       #       #   #
# ##### ##### # ##### ### # # ##### #####
#. .#   #   # #   #     # # #     #     #
# # # # ### # ### # ##### # ####### # ###
# #.# # #   #   # # # #   # #     # #   #
# # # ### ### # # # # ####### ###########
# #.#   #   # # #     #       #         #
# # ### ### # # # # ### ############### #
# #. .#     # # # # #   #   #           #
# # # ######### # ### ### # # ###########
# # #. .#       #   # # # # # #         #
# ##### # ##### ### # # # # # # #########
#     #.#     #   # #   # # #   #   #   #
####### ##### ##### ### # ### ### # # # #
#. . . .    #     #   # # #       # # # #
# ##### ### ##### ### # # # ######### # #
#. .#     #     #   #     #           # #
# # # ######### ########### ########### #
# #.# #       #             #     #     #
### # # ##### ##### # ####### ### # #####
#. .#       #     # #         # # # #   #
# ######### # ### # ### # ##### # ### # #
#. . .    # #   # #   # #       #   # # #
# ### ### ### ### ### ##### ### ### ### #
# #. .#   #   #     #     #   #   #     #
# # ### ### # # ######### ####### #######
# #. .# #   # #     #   # # #   #   #   #
# ### # # ### ##### # ### # ### # # # ###
# # #.# #   #     # #     #   # # # #   #
# # # # ### ####### ####### # # # ##### #
#   #.#   #       #         #   #       #
##### ###################################
