### ##################### ###############
#  .    #     #         #.#   #   #   # #
# # ### # ### # ####### # # # # # # # # #
# #.  #     # #   #   #. .# # # #   # # #
# # # ### ### ##### # # ##### # ####### #
# #.#   #   # #     # #. . .# # #   #   #
### ### ### # # ##### ##### # # # ### ###
#. .  #   # #   #   #     #. .# #   # # #
# # ##### # ##### # ##### ### # ### # # #
#.#     # #   # # # #. .# #. .  #   #   #
# ####### ### # # # # # ### ##### ##### #
#. . .#     #   # # #.#. . .          # #
##### # ######### # # ############### # #
#. . .#       #   # #. . .#     #   # # #
# ### # ##### # ### ##### ### ### ### # #
#.#   # #     # # # #   #.#   #   #   # #
# ####### ##### # # ### # # ### ### ### #
#. . .#   #     # # #   #.# # #   #     #
##### # ### ##### # # ### # # ### #######
#. . .#   #. .    #   #. .#     # #     #
# # ####### # ######### ####### # # ### #
#.# #. . . .#. .  #. .#.#   #     # # # #
# ### ####### # ### # # # ### ##### # # #
#. .#.#     # #. . .#.#.  #         #   #
# # # ##### ######### # ### #############
# #.#.#. .# #       #. .#   #     #     #
# # # # # # # ##### # ### ### ### # #####
# #.#.#.#. .#   #   #     # #   # # #   #
# # # # ### ### # ######### ### ### # # #
# #.#.#.# #.#   # # #   #   #   #   # # #
# # # # # # ##### # # # # ### ### ### # #
# #.#. .# #.#. .  #   #       # # #   # #
# # ##### # # # ### ########### # ##### #
# #.      #. .#.#   #   # #             #
### ########### # ### # # # #############
#. .  #. . . .#.# #   #   #   #         #
# ##### ##### # # # ######### # ##### # #
#. .#. .    #. .#   #       # # #   # # #
# # # ############# # ### ### # # # ### #
# #. .                  #       # #     #
#########################################
