####### #################################
#  . . .    # #. .            #         #
# # ### # # # # # ##### # ##### # ##### #
# #.# # # # # #.#.    # #       #     # #
### # # # # # # # ### ########### ### # #
#. .#   # # # #.#.  #     # #     #   # #
# # ####### # # # ##### # # # # ####### #
#.#   #     #. .#. .  # # # # # #     # #
# ### # ##### ##### # # # # # ### #######
#. .# # # #. .#   #.# # #   #     #     #
### ### # # ### ### # ### ######### ### #
#. .#   # #.#   #. .#   #   #       #   #
# ### ### # # ### # ### ##### ####### # #
#. .# #   #.  #  .#   # #           # # #
# # # # ### ##### ### # # ######### # # #
# #.#   #. .#. . .#   #     #     # # # #
### ##### ### ### # # ####### ### # ### #
#. .  #. .  #. .# # # #       # # #   # #
# ### # ##### # # # ### ##### # # ### # #
#.#   #.#. .# #.# #         # # #   # # #
# ##### # # ### ########### ### # # # # #
#. . . .#.#. .#. .    #   #     # # # # #
######### ### ### ### ### ####### # # ###
 . . .#. .# #. .#. .#     #       # #   #
##### # # # ### ### ### ####### ### ### #
#   #. .# #    . . .  # #   #   #   #   #
# # ########### ### # # # # ##### ### # #
# # #         # #   # # # #       #   # #
# ### ####### ### ### ### ######### # # #
# #   #     #     #   #   # #       # # #
# # ####### ####### # # ### ####### # # #
#   #       #       # # #           # # #
####### ### # # ### ### ### ##### ##### #
#       #     # #   #   #   #   # #     #
# ##### # ##### # ### ### ### ### # #####
# #     # #     # #   #   #       # #   #
# ####### # ##### # # ############# # # #
#     #   # #   # # #       #   #   # # #
# ##### ### ### # ##### ### ### # ##### #
#     #   #     #     #   #     #       #
#########################################
