############# ###########################
#        . .#.                          #
# ####### # # ####### ### ###############
# #. . . .#. .      #   #         #     #
# # ####### ####### ### ### ####### ### #
# #.#. . .# #. . .# #   #   #       # # #
### # ### ### ### # # # # ### ####### ###
#. .#.# #. . .#. .# # # #   #   #   #   #
# ### # # ##### # # # ##### ### # # ### #
#. . .  #     #.# # #     #       #     #
# ############# # # # # # # #############
#   #. .#. . . .# # # # # # #           #
##### # # # ####### # # # ### ##### ### #
#. . .#. .# #     # # # #         #   # #
# ### ### ### ### # ### ######### # ### #
 .#   #   #   #     #       #   # #   # #
# ##### ### ######### # ### # # ##### ###
# #     #     #   #   #   #   #     #   #
# # ####### # # ##### # ########### # # #
# # #       #   #     #     #     # # # #
# # # ### ####### ### ### # # ##### # # #
# # #   # #   #     #   # #   #     # # #
### ### ### # # # ####### ##### ### # # #
# #   #     # # #   #   #     #   # # # #
# # ########### ### # # # ####### ### # #
# #       #     # # # # # #     #   # # #
# # ### # ### # # # # ### # ### ### ### #
# #   # # #   # # # # #   # #   #   #   #
# ##### # # ### # # # ### # ##### ### # #
#   #   # #   #   # #   # #   #   #   # #
### # ### # # ##### ### # ### ##### ### #
#     #   # #     # # # #   #       #   #
####### # # ### ### # # ### ######### # #
#   #   # #   # #   #       #         # #
# # # ######### # ##### ##### ######### #
# # #     #     #   # # #   #   #     # #
# ####### # # # ##### # # ### # # ### # #
#     #   # # #   #   # #   # # # #   # #
##### # ### # ##### ### ### ### # # ### #
#       #   #         #   #     # #     #
#########################################
