########################### #############
#                    . . .#. .    #     #
# ##### ############# ### ### ### ##### #
#   #   #     #  . . .# #. . .  #   #   #
# # ### ##### # # ##### ##### ##### # ###
# #   #       # #. . .#       #     # # #
# # # # ####### # ### ######### ##### # #
# # # # #   #   #   #. . .#     # #. . .#
# ### ### # # # ### # ### # ##### # ### #
#   # #   # # # #   #   #.# #   #. .  #.#
### # # ### # ### ##### # # # ### ##### #
# # #     # #   # #   # #.#   #. .    #.#
# # ####### # # ### # ### ##### ##### # #
# # # #     # #   # #   #. . . .#. .# #.#
# # # # ##### # # ##### # # ##### # ### #
# #   # # # # # #     # # #     #.#. . .#
# ####### # # ####### # # ####### ##### #
#     #     #   #   #   #   #  . .#     #
# ### ##### ### # # ####### ### #########
# #           #   #       # #. .#. . .  #
# ########### ############# # ### ### ###
#   # #   #     #     #     #.#. .# #. . 
### # # ####### # ### # ##### # ### ### #
#   #     #   #   #     #   #. .  #   # #
# ####### # # ##### # # # # # ### ### # #
#       #   #     # # # # # #   #     # #
# ##### # ####### # # # # ##### ### ### #
# #     # #   #   # # # #         #   # #
# # ##### # ### ##### # ##### # # ##### #
# # #     #       #   # #   # # #     # #
### ############# # ### # # ### ##### # #
#   #   #     #     #   # # #   # #   # #
### # ##### # ####### # # ### ### # ### #
#   # #     #         # # #   #   # #   #
# ### # # # # ##### ### # # ### ##### ###
# #   # # # # #     #   #   # # #     # #
### ##### ### # ### ######### # ### # # #
#   #     #   # #           #   #   # # #
# ##### ### ### ####### ##### ### ##### #
#       #   #         #       #         #
#########################################
