############# ###########################
# #    . . . .                          #
# # ### # ### # ############### ####### #
# #   #.# #   #     #       #     #   # #
# ### # ### # # # # ####### # ##### # ###
# #   #. .# # # # #       #   #     #   #
# # ##### # ### ######### ############# #
#   #. . .#   #         #   #     #   # #
##### ####### ######### # ####### # # # #
#. . .#     #         # #       # # # # #
# ### ##### ##### ### # ### ##### ### # #
#. .#     #     # #   #   #     #     # #
# # ########### ### # ### ##### # ##### #
# #. . . .  #       # # #     #         #
# # ##### # ######### # ##### ###########
# #   #. .#       #   #     #     # #   #
# ##### # ####### # ### ### ##### # # ###
#     #.#       # #   # # # #     #   # #
##### # ####### # ##### # # ####### ### #
#     #.      # #         #         #   #
####### ##### # # ######### # ##### # ###
#. . . .#. .# # #   #     # # #   # # # #
# ##### # # ### ##### # ### ### # # # # #
#. . .# #.#. .#     # #   #     # # #   #
# # # ### ### ##### # ### ####### # ### #
# # #.#. .# #. .#   #   # #   #   #   # #
# ### # ### # # # ### ##### # # ####### #
# #. .#.  # # #.#     #     # #         #
# # ### ### # # ####### ##### ###########
# #. . .    # #. . . . . .  #       #   #
# # ######### ########### ### ######### #
# #         #           #. .#         # #
# ######### ############### ####### ### #
#         # #. . . . . . . .  #   #   # #
##### ### # # ##### ##### # ### # ### # #
#   #   # # #.# #   #     #     #   # # #
# # ##### # # # # ### ############# # # #
# # #     # #.#   # # #   #       # #   #
# # # ##### # ##### # ### # ####### # ###
# #   #     #.      #     #         #   #
############# ###########################
