######### # #############################
# #    . .#.#  . . .        #       #   #
# # ### # # ### ### ####### # ### # # # #
#   #  .# #.#. .#. .#   #   # # # # # # #
# ##### # # # ### ### # ##### # # ### # #
# #  . .# #.#. .#.#   #   # #   #     # #
### # ### # ### # # ##### # # # ####### #
#   #.#   #. . .#.#     # # # #     #   #
# ### ########### ####### # # # ##### ###
# #  . .#. . .  #. . . .# #   # #   #   #
# # ### # ### ######### # # ### ### ### #
# #   #. .  #.#. . .  #. .# # #   #   # #
# ######### # # ### ##### # # # # ### # #
#         # #. .  #. . .#.# # # # # # # #
# # ##### ####### # ### # # # # ### # # #
# #     #     # # #   #. .#   #     # # #
# ####### ### # # ### # ##### ####### ###
#       #   # #     # #             #   #
# ##### ### # ####### ##### ########### #
#   #     # #       #     #   #       # #
##### # # # ##### # # ### ##### ### ### #
#     # # # #     # #   #         #     #
# # ### ### # # ### # # ### ### ####### #
# # # # #   # # #   # #   #   #       # #
### # # # ### ### ### ### ### ####### # #
#   #   # #   #   #     #   #       # # #
# # ##### ##### ### # ##### ##### # # # #
# # #   #     # #   # #         # # # # #
# ### ##### ### ### # # ### ##### # # # #
#   # #   # #   #   # # #   #     # # # #
# # # # # # # ### ### # ##### ##### # ###
# # # # # # # #   #   # #     #     #   #
# # # # ### ### ### ### # # ### ##### # #
# #   #     #   # # #   # # #   #   # # #
####### ##### # # # # # # # # ### # # # #
#     # #     # #   # # # # #     # # # #
# ### ### # ######### # # ######### ### #
# #       #       #   # #       # # #   #
# ################# ### # ##### # # # ###
#       #           #   #     #   # #   #
#########################################
