### #####################################
#. .#. .    #. .          #         #   #
# ### # ##### # # ####### # ### ### # # #
#. .#.#. . . .#.#     # #   #     #   # #
# # # ######### ### ### ##### ### # ### #
# #. .      #. .  # #   #   #   # # # # #
# ########### # ### # ##### # # # ### # #
# # #. . . .#.# #   # #   # # # # #   # #
# # # ##### # # # # # # # # ### ### ### #
#   #.#. . .#.# # # #   # #   #   # #   #
##### # ##### # # ####### ### # # # # # #
 . . .#.#    .# #           # # # # # # #
####### # ### # ##### ### ### # # # # # #
#     #.# #. .# #   #   #   # # # # # # #
# ### # # # ### # # ### ### # ### # # # #
# #   #.# #. .# # # # #   # # #   #   # #
# ##### ### # # # # # # # # # # # #######
#     #. .# #.# # # # # # #   # # #     #
##### ### ### # ### # # # ######### ### #
#       #. .#.#   # # # #     #       # #
####### ### # ### # # # ####### ##### ###
#          . .  #     #   #   # #   #   #
# ######### # ##### ### # # # # # # ### #
#     #     #     #   # #   # #   # #   #
####### # ####### ### # ### # # ### #####
#   #   #   #   #   # #   # #     #     #
# ### ### # # # # # # ### ##### # ##### #
# #   #   #   # # # # #   #   # #   #   #
# # ### ####### # ### ##### # ##### #####
# #   # #       # # #       #     #     #
# ### # # # ##### # ############# ### # #
# # # # # # #     #     #   #   #   # # #
# # # # # ### # # ### ### # # ### # # ###
# # # # # #   # # #   #   #   #   # #   #
# # # ### # ### ### ### ####### # ##### #
# # # #   # #     # #   #       # #     #
# # ### # # ### # # # ##### ##### # #####
# #     # #   # # # #     # # #   #     #
# ########### # # # ##### # # ######### #
#             # #         # #           #
#########################################
