##### ############### ###################
#   #.# #    . .#  . .                  #
# # # # # ### # ### ### ### ########### #
# # #.# # #  .#. . .#     #     #     # #
# # # # # # # ####### # # # ##### ##### #
# # #.# # # #.#     # # # #     # #     #
# ### # # ### # ### # # # ##### # # #####
# #. .  # #. .# #     # #     # #   #   #
# # ##### # # # ##### # ### # # ##### # #
#. .# #   #.# #     # #   # # #       # #
# ### # ### # ##### # ### ### ### ##### #
#.# # # #  .#   # # #   #   #   #     # #
# # # # # # ### # # ### ### ####### # # #
#.# #   # #.#   # # #   #   #       # # #
# # ##### # # ### # ##### ### ####### # #
#. . .#   #.# #. .#     #   #     #   # #
##### ##### ### # ##### ### ##### # ### #
#   #. .#  . . .#.    #   #   # # # #   #
# # ### ### ##### ### # ##### # # # ### #
# #   #. .#   #. .#   #   # # # # # #   #
# ### ### ##### # # ### # # # # # # # ###
#   # #  .#. . .# # # # #   # # # # # # #
### ##### # # ### # # # ##### # # # # # #
#       #. .# #   # #   #     # # # #   #
####### ####### ### ##### # # # # # #####
#     # #       #       # # # # # #   # #
# ### # # # ##### # ### # ### # # # # # #
# #   #   # #     #   # #   # # # # #   #
# ### ### ### # ##### ### # # # # # #####
#   #     #   #     #   # # # # # #     #
### ####### ### # # ### ####### # #######
#   #       #   # #   # #       #       #
##### ########### ### # # ############# #
#   # #         #   # #         #     # #
# # # ####### # # # # ######### # # ### #
# # #   # #   #   # #   #     # # #   # #
# # ### # # # # # # ### # ### ### ##### #
# #     # # # # # #   #     #   # # #   #
# ##### # # # # # ### ######### # # # ###
#     # #   # # #   #         #     #   #
#########################################
