# ################################# #####
#. .#                . . . . .#    . . .#
### ################# # ##### ##### ### #
# #.#. .#  . . . .#. .# # # #. .#   #. .#
# # # # ### ##### # ##### # ### ##### # #
#. .#.#. . .#   #. .#     #    . . . .# #
# ### ##### # # ### # ################# #
#.#. .#     # #     # #               # #
# # ### ##### ####### ##### ##### ### # #
#. .#   # #   #           # #     #     #
# ### ### # ### ######### # # ##### # # #
# #   #   # #   # #         # #     # # #
# # ### ### ##### # ######### # ####### #
# #   #   #       # #   #     # #       #
# # # ### # ### ### # # # ##### # ### # #
# # #     # #     #   # #   #   # #   # #
# ########### # ############# ### ### # #
#   #         #   #         # # # #   # #
### ####### ##### # # ##### # # # # # # #
# #   #     #     # # #       #   # # # #
# ### # ### # ##### # ############# # # #
# #   # #   # #     #     #         # # #
# # # # # # # ########### # ### ### # # #
#   # # # # #     #     # # #   #   # # #
### ### ### ### # # ##### ### # # ### # #
#   #   #     # # #   #   #   # #   # # #
# ### # ### # ### ### ##### # ####### # #
# #   # #   #   #     #     # #       # #
# # ### # ##### ######### ### # ####### #
# # #   #     #   #   #   #   # # #     #
### ####### ##### ### # # # ### # # # ###
# #       # #   #     # # # #   #   # # #
# # ### # # # ######### ### # ####### # #
# #   # # # #     # #     # # #     #   #
# ##### ### ##### # # ##### # # ### ### #
# #     #       # # #   # # #   # #   # #
# ### # # ##### # # # # # # ##### # # ###
#     # # #     # # # # # #   #   # #   #
####### # ####### # # # # # # # ### #####
#       #           # #   # #     #     #
#########################################
