############# ######################### #
# #       #  .#    . .#   #    . . . .#.#
# # ##### ### ##### # # ### ### ##### # #
# #     #   #.#. . .#.# #   #  .#   #.#.#
# ######### # # ##### # # ##### # ### # #
#       # #  . .#    . .#   #. .#. .#.#.#
# ##### # ### ######### ##### ### # # # #
# #   #   #   #     #  . . . .#. .#. .#.#
# ### ### # ### ### ##### # ### ####### #
#   #   #   #     #   #   # #  . . . . .#
# # ### ######### ### ##### # ######### #
# #   #           #         # # #     # #
##### ##### ####### ######### # # ### # #
#   #   #   #       #       # # # # #   #
# # # ### # ######### ####### # # # ### #
# #   #   #     #     #     # # # #   # #
####### ##### # # ##### ### # # # ### # #
#   #   #     # # #     #   #   #   #   #
# ### ### # ### # ##### ### ##### # ### #
#   # #   # #   #     # #         # # # #
### # # ##### ####### # # # ####### # # #
# # # # # #   #   #     # #   #     # # #
# # # # # # # # # ####### # # # ##### ###
# # # # # # # # # #   #   # # #     #   #
# # # # # # ### # # # # ### # ##### ### #
#     #   # #   # # #   #   #   #   # # #
########### # ##### # ### ##### # # # # #
#       #   # #   # # #   #     # #   # #
# ####### ### # # # ### ### # # # ##### #
#       #     # #   #   #   # # #       #
####### ####### ##### ####### # # #######
#     #   #         #       # # #       #
# ####### # # # # # ####### ### ####### #
#   #       # # # #   #   #   #       # #
### ########### ### # # # ### ####### # #
#   #       #   #   # # #     #     # # #
# ### ##### # # ### ### ##### # ### # # #
# #   #   #   # #   #   #     # # # # # #
# # # # ######### ############# # # # # #
#   # #           #             #     # #
#########################################
