##### ##################### #############
#   #.#      . .#          . . . .  #   #
# # # ####### # # ######### # ### # ### #
# # #. . .#. .#.# #. .#   # #   #.#   # #
# ####### # ### # # # ### # ##### ### # #
#     #  . .#  .# #.#. .# #     #.  #   #
##### ######### ### ### # ##### # # #####
#         #    . . .# #. . .#   #.#   # #
######### ####### ### ##### # ### ### # #
#     #           #   #   #.# #. .# # # #
# ##### ########### ### ### # # # # # # #
# #     #   #   #   #. . . .# #.# # #   #
# # ##### ### # # ### ######### # # # ###
#   #   # #   #   #  .#    . . .# # #   #
##### ### # ######### ##### ### # # ### #
#         # #        . . . .#   # #   # #
# ######### ############# ### ### ### # #
# #   #                   #   #       # #
# ### # ### ##### ######### ##### # ### #
#   #   #   #     #         #     #   # #
### ######### ##### ### # ### ######### #
#           # #     # # # #   #     #   #
# ######### ### ##### # # # # ##### # ###
# # #   #     #       # # # # #     #   #
# # # # ##### ######### # # ### ####### #
# # # #                 # #       #     #
# # # ##### # ########### # # ##### # # #
#   # #     # #         # # # #     # # #
##### ##### ### ######### # # # ##### # #
#     #   #   #     #   # # # # #     # #
# ##### # ### ##### # # # # ### # ### # #
# #     #   #     #   #   # #   # #   # #
# # ####### # ########### ### ### ### # #
#   #     # # #   #       #   #   #   # #
# ####### # # # # ######### ####### #####
#   #     # #   #   #     #       #     #
# # # ##### ####### # # # ####### ##### #
# # # # # #       #   # # #     # #   # #
# # # # # ############# # ##### # ### # #
# #   #                 #       #     # #
#########################################
