######################### ###############
#. . . . . . . .#      . .              #
# ##### ####### ####### # # # ####### ###
#. . .# #     #. . .#  .# # #       #   #
# ### # # ### ##### ### # ### ### ##### #
# #. .# # #   #   #. . .#   #   #     # #
# # ##### # ### # ##### # # ####### # # #
# #. .#   # #   #       # #   #   # # # #
# ### # ##### # ##### ### ### # # ### # #
#   #.#       # #     #   # # # # #   # #
##### ######### # ##### ### # ### # ### #
 .#. .      #   # #   #     #   # #   # #
# # # ##### ##### ### ######### # # # ###
#.#.#     #     # #           #   # #   #
# # ### # ##### # # ######### ####### # #
#.#. .# #     # # # #       #       # # #
# ### # ##### # ### # ############# ### #
#.#. .#     # #   #   #     #           #
# # # # ### # ### ##### ### # ####### # #
#.#.# #   # #   # #     #     #   #   # #
# # # ### # ### # # ########### # ##### #
#. .#   # #   # # #   #   #     # #     #
# ### ### # # # # ### ### # ####### # # #
# #   #   # # # #   #     #         # # #
# # ### ### # # ### ############# ##### #
# # # # #   # #   #   #         # #   # #
# # # # # ### ##### ### # ##### ### # # #
# # #   #   #     #     #     #   # #   #
# # ############# ############### #######
# #       #     #               #       #
# # ##### # ### # # ### ##### # ####### #
# # #   # #   # # # # # #     #   #     #
# # ### # ##### # # # # # ####### # #####
# #     #       # #   # # #     # # #   #
# ####### ####### ##### # ##### ### # ###
#     #   #     #     # #     #     #   #
##### # ### ######### # ##### ######### #
#   # # #           # #   # # #         #
# ### # ########### # ### # # # ##### ###
#     #           #     #   #   #       #
#########################################
