####### ####################### #########
#     #.#     #    . . .  #    .        #
# ### # # ##### ### ### ### ### ####### #
#   # #.# #     #. .# #.#   #. .      # #
##### # # ### ### # # # # ### # ####### #
#     #.#   #   #.# # #.# #. .# #       #
# ##### ### ##### ### # ### ### # #######
# #. . .#. . . . .#   #. . .#   # #     #
# # ##### ####### # ### ##### ### # ### #
# #.# #  .#       #     #     # #     # #
# # # # # # # ########### ### # # ##### #
# #. .# #.# # #   #       #   # # # #   #
# ### # # # ### ### ### ####### # # # # #
# #. .# #.#   #     #       #   #   # # #
# # ### # ### ######### # # # ####### # #
# #.# # #.#     # #   # # #   #       # #
# # # # # # ### # # # # # ######### ### #
#  . .# #.#   #   # # # #   #   # # #   #
##### # # ### ##### ### ##### # # # # ###
#   #.# #. .#   #   #   # #   # #   #   #
# ### ##### ### # ####### # ### ##### # #
#   #. . . .  #   #   #   # #       # # #
### # ### # # ##### # # ### ####### ### #
# # # #   # #   #   # #   # #   #       #
# # ### ### ### ##### ### # # # ### ### #
# # #   #     #       #   # # # #   #   #
# # # ### # # # ##### # ### # # # ### # #
# # #   # # # # #   # # #   # #   # # # #
# # ### # # # ### # ### # ### ##### # # #
# # #   # # #     #     # # #       # # #
# # ##### # ############# # ######### ###
# #       #   #           # #           #
# # ### # # # ############# ######### # #
# # #   # # #               #     #   # #
# ### ### # ### ####### ##### ### ##### #
#   #   # #   #       #     # # # #     #
### ### # ### ####### ##### # # ### ### #
# #   # # # # # #   #     # #   #   # # #
# ### ### # # # ### ####### ### ### # # #
#         #   #               #     #   #
#########################################
