##### ############################# #####
#    . . . .#. . .#. . . . .#    . .    #
# ######### # ### # # ##### ##### ##### #
#     #   #. .#  . .# #    . .#  .#   # #
####### # ### # # # ### ##### ### ### # #
#       #     # # # #   # #  . .#. .#   #
# ############# ### # ### ##### ### #####
# #   #         #   # #       #. .#. . .#
# # ### ######### ### ####### ### # ### #
#   #   #   #     #       # # #. .#   #.#
##### ### # # # # # # ### # # # ##### # #
#     #   #   # # # #   # #   #. . .# #.#
# # ########### ### ##### # ####### ### #
# # #       #     # #     # #     #. . .#
# # # # ### # # # # # ##### # ### ### # #
# # # # # # # # # # # #       # # #   # #
### # # # # # ### ### ##### ### # ##### #
#   # # # # # #   #   # #   #   #   #   #
# ####### # ### ### ### # ### ##### # # #
# #       #     #   #   # #     #     # #
# # ######### # # # # ### ##### # # # # #
# # #         # # #   #   #   #   # # # #
# # ### ####### # # # # ### # ####### # #
# #   #   # #   # # # # #   #       # # #
# ### ### # # ### # # # ####### ### # # #
#   #     # #   # # # #     # # # # # # #
# # ####### ##### # ##### # # # # # # # #
# # #     #       #     # # #   #   # # #
# ### ### ### # # ##### ### ##### ### # #
# #   #       # #   #   #   #   # #   # #
# # # ############# # ### ##### # ##### #
# # # #     #     # # #       #         #
# # # ##### # ### ### # # ### ######### #
# # #   #     # # #   # #   #     # # # #
### ### ####### # # # # ### # ### # # # #
#   # #     #   #   # # # # #   #   #   #
# ### ### # # ####### # # # ##### #######
#   #   # # # #     # #   #     # #     #
# ##### ### # # ### # # ### ### ### ### #
#     #     #   #     #   #   #     #   #
#########################################
