######### ### ###########################
#       #.#  . . . .#. .          #     #
# # ### # ######### # # ######### # #####
# # # #  . . . . .#. .#. . .#     #. . .#
# # # ########### ### ##### ####### ### #
# #   #         #. .# #   #.#. . . .#. .#
####### ####### ### # ### # # ####### # #
#   #   #     #  . .#     #. .    # #.# #
# ### # # ### ### ############### # # ###
#     # # # #   #. . . .#  . . .#   #. .#
# ##### # # # ######### ### ### ####### #
# #     # # # #        .#. .# #. .#. . .#
### ### # # ### ####### # ### ### # ### #
#   #   # #     #     #. .#   # #.#.#   #
# ### ### ####### ### ### # ### # # # # #
#   #   # #       #       # #. . .#.# # #
####### # # ############### # ##### # ###
# #   # #   #             # #. . . .#   #
# # ### # ### ######### # # ### ### # # #
# # #   # #   #         # #     #   # # #
# # # ### # ### # ####### ####### ##### #
#     #   # # # # #     #         #     #
### ####### # # ### ### ############# # #
# # #     #   #   #   #               # #
# ### ### ### # # ### ############# # # #
# #   #     # # # # # #             # # #
# # # ##### ### # # ### ############# # #
# # # #   #   # # #     #   #       # # #
# # # # ##### # # # ### # # # ######### #
# # # #         # # #   # #   #         #
# # # ########### # # ### ##### ##### # #
#   #     #       # # #         #     # #
########### ####### # ######### ####### #
#         # #     # # #   #     #     # #
######### # # ### # # ### ####### ### # #
#     # #   # # #   #   #   #   # #   # #
# ### # ##### # ##### # ### # ### # ### #
#   # #       #       #   # # #   #   # #
##### ##### ### ########### # ### ### # #
#           #               #     #     #
#########################################
