##### ###################################
#. . .  #     # # #   #                 #
# # # # # ### # # # # ################# #
#.# # # #   # #   # # #       #   #   # #
# ### ### ### ### # # ####### ### # # # #
#. .#     #     #   # #   #       # #   #
# # ####### # ### ##### # ####### # #####
# #. . .  # # #         #     #   # #   #
# # ### ### ### ############### ### # # #
# #   #. .#           #     #   #     # #
# ####### ####### ##### ### # ### #######
#       #. .    #       # #   #         #
######### # ### ######### ##### #########
#. . . .# #. .#           #     #       #
# ##### ##### ####### ##### ##### ##### #
#.#. .#. . . .      #       #   #. . .# #
# # # ####### ############### ### ### # #
#. .#.#       #. . .    #   #. . .  #.# #
# # # ######### ### ### # ### ####### # #
# # #. .      #.  #. .# #. . .#   #. .# #
# ### # ####### ##### ### ####### # ### #
#   # #. . . . .#   #.#. .#       #.#   #
# # ####### ##### # # # ### ####### #####
# # # #   #     # # #. .  #     #  . .  #
# # # # # ##### # ### # ####### ### # # #
# # #   #     # #   # # #       #   #.# #
# # ####### ### ### # ### ####### ### ###
# #       # #   #   #           # #  . . 
# ### # # # # ### ####### ####### # # ###
#   # # # # # #   #     # #       # #   #
### # # ### # # ### ### ### ##### # ### #
# # # #     #     # #       # #   #   # #
# # # ### ##### ### ######### # ##### # #
# # #   # #   # #   #         # #     # #
# # ### # # # ### ### ######### # # #####
# # #   # # #   #   # #   #     # # #   #
# # # ### ##### ### # ### # ### # ### # #
#   #   #     #   # #   # #   # # #   # #
### # # ######### # ### # ##### # # ### #
#   # #           #   #         #   #   #
#########################################
