############# ###########################
#         #  .  #. . . . . . .#. . . . .#
# ####### # # # # ########### # ####### #
#     # #   #.# #. . .#     #. .  # #. .#
# ### # ##### # ##### # ##### # # # # # #
# # # #      .# #. . .  #   # # #   #.# #
# # # ####### # # ####### # # ####### # #
# # #   #    .# #. . .#   # #     #. .# #
# # ### # ### # ##### # ### ##### # ### #
# # #   # #. .# #. . .#   #     # #.#   #
# # # ### # ##### ####### ##### # # #####
# #   # # #. .#. .      # #     # #. .  #
# ### # # ### # ####### ### ##### # # # #
# #   # #   #. .#     #     #   # # #.# #
# ##### # # # # # ### ####### # # # # ###
#   #   # # # # # # #   #     # # # #. . 
# # # ##### # ### # ### # ##### # # #####
# #   #     #   #   #   #     # # #   # #
####### ####### ### # # ##### # # ### # #
#   #         # #   # #     # # #   #   #
### # # # # ### # ######### # ### # #####
# # # # # #   # #   #     # # #   #     #
# # # # ##### # # ### ### ### # ##### # #
# # # #     # #       # #     # #     # #
# # # ##### # ######### ####### # # # # #
#   #     # #         #         # # # # #
# ### ### # ##### ### ############# # # #
# # #   # # #   #   # #     #       # # #
# # ##### # # # ### # # ### ##### ##### #
#   #     # # #   # # #   #     #     # #
### # # # # # ### # # ### ##### # ##### #
#     # # #     # # #   #   # # # #     #
######### # ##### # # # ### # # ### #####
#     #   # # #   # # #       # #   #   #
# ### # # # # # # # # ########### ##### #
# #     # #   # # # # #     #     #     #
# ### ######### ### # # ##### ##### #####
#   # #   #     #   #   #   #   #   #   #
# # ### # ####### ####### # ##### ### # #
# #     #       #         #           # #
#########################################
