####### #################################
#      . . .                            #
##### ##### ### ### ####### ######### # #
#     # #. .  #   #   #   #       # # # #
# ##### # # ### ### # # ##### ### # # ###
# #     #.# #   #   #   # #     #   #   #
# # ##### ### ### # ##### # ########### #
# # #. . .#   #   # #     #         #   #
# # # ### # # # # # # ############# #####
#   #.#   # # # # # # # #         #     #
##### # ### # # ### # # # ### ######### #
#. . .#   # # #   # #   #   #       #   #
# ####### # ##### ### ##### ######### ###
#.#. .#   #     #   # #           #   # #
# # # ####### # ### # # ######### # ### #
#. .#. . .  # #   #   #   #     # # #   #
# # ##### ### ### ####### # # ### ### ###
# #     #. .#   #         # #   #     # #
# ####### # ### ##### ##### ### ####### #
# #. . .# #.  #     #       # #     #   #
### ### ### ### ### ######### # ### # ###
#. .#  . . .#     #         # #   # # # #
# ######### # # ### ##### ### ### ### # #
#. . . .#   # #   # #     #     #   # # #
# # ### ##### ### # # # # # ####### # # #
# #   #. . .#   # # # # # # #     #   # #
# ######### # # # # # ### # # ### # ### #
# #. . . .#.# # # # #   # #   #   #     #
### ##### # # # # ### # ### #############
 . .#   #. .# # #   # #               # #
# # # ### # # ### # ##### ########### # #
# # #   # # # # # #     #     #   #   # #
### ### ### # # # ##### ##### # ### ### #
#   # #   # # # #     #     # #     #   #
# ### ### # ### ####### ### # ####### # #
#   # #   #   # #       #   #         # #
### # # ### # # ### ##### ##### ####### #
# #   # #   # # #   # #   #   #     #   #
# ##### ##### # # # # # ##### ####### # #
#             #   # #   #             # #
#########################################
