################### #####################
#     #  . . .#. . .          #   #     #
# ### # # ### # # # ######### ### ##### #
# #     #.#  . .# # #     # #           #
# ####### ### ### # # ### # #############
#   #    . .# #   # #   #     #         #
### # ##### # # ### ### ##### # ####### #
# # # #   #.# #   #   # # #     #     # #
# # ### # # ######### ### # ######### ###
 .#     # #. . . .  # #       #   # #   #
# ############# # ### # ### ### # # ### #
#. .#    . . .# #. .#     # #   #   # # #
### ##### ### # ### ### # ### ####### # #
# #. . . .#. .# #. .  # #     # #       #
# ######### ##### # # ######### # #######
#     #  . .#. . .# #           # # #   #
##### ### ### # # # ####### # ### # # ###
#   #    . . .# # #       # #   # # #   #
# # ########### # # # # # ##### # # ### #
# #   #         # # # # #     #   #     #
# ##### ######### # # # ############### #
# #   #   #       # # #               # #
# ### ### # ##### # # ##### # ####### # #
#   #     # #     # #     # #       # # #
### ####### # ##### ##### # ##### ### # #
# # #       # #     #     #     #   # # #
# # # # # # # ### ########### # ### ### #
# #   # # # #   # #     #   # #   #     #
# ####### # # # # ##### # # ### # ### ###
#         # # # #     # # #   # #   #   #
########### # # # # # # # ### ##### ### #
#       # # # # # # #   # #           # #
# # ### # # ### # ### ### ######### # # #
# # # #   # #   #   #   #   #     # # # #
### # ### ### # ### ####### # ### ### # #
#   #         # #   #     # # # #     # #
# ####### ##### # ### ### ### # ####### #
# #     # #     # #   # # #   #       # #
# # ### ### ##### ##### # ##### ##### # #
# #   #     #           #       #       #
#########################################
