######################### ### ###########
#             #         #.#  . . . . .  #
# ### ##### ### ####### # # # ####### # #
# #   #     #   #       #.# #       #.# #
### ##### ### ########### ######### # # #
#   #   # # # #. . .#. .#. .#. . .# #.# #
# ##### # # # # ### # # ### # ### ### ###
#     # #   #. .# #.#.#. . .#. .#. .#. .#
# ### # ### # ### # # ######### ### # # #
# #   #   #  . .# #. .# #  . . .# #.# #.#
### ### # ##### # ##### # # ##### # ### #
#   #   # #   #.#     #   #.# #. . .#. .#
##### ### # # # ##### ##### # # ##### # #
#     #   # #  .#. . . . . .# #.# #  .# #
# ############# # ########### # # # # ###
# #            . .#         #. .#   #. .#
# ######### ##### ######### # ####### # #
#   #       #     #     # #  .#. .#   #.#
### ### ##### ##### ### # ### # # # ### #
# #     #     #     #        . .#.#   #.#
# # ##### ##### # # ############# ##### #
# # #     #     # # #         #  . .#. .#
# ### # ######### ### ### ### ##### # # #
#     #         #   # #   # #   # #.#.# #
############### ### # # # # ### # # # # #
#               #   # # # #   # # #.#.# #
# ############### # # # # ### # # # # ###
# #   # #         # # # #   #   # #.#. .#
### # # # ########### # ### # ### # # # #
#   #     #     #     # # # #   #  .# #.#
# ####### # ### # ##### # # ### ### ### #
# # # #   # # #   # #   # # #     #. .#.#
# # # ##### # ##### # ### # # ### ### # #
# # #     # # # #   # #   # # #      . .#
# # ##### # # # # ### # ####### ####### #
# #     #   #     #   # #     #   #     #
# ##### ##### ##### ### # ### ##### # ###
#     # #     #   #     # # #       # # #
##### # ##### ### ####### # ######### # #
#     #                   #             #
#########################################
