################# #######################
#. . .#  . .#  . .          #       #   #
# ### # # # ### # # ####### ####### # ###
#. .#.# #.#. . .# #       #       # #   #
### # ### # ### # ####### ### ### # ### #
#. .#. . .# #   #     # #   # #   #     #
# ########### ### # # # ### # ######### #
#.# #         #   # # # # # # #       # #
# # # ############# ### # # # # ##### # #
#.#   #     #       #   #   #     #   # #
# ####### ### # ##### ####### ##### # # #
#. .  #   #   # #     # #   # #     # # #
# # # # ### ### # ##### # # ### # ##### #
# #.# # # #   # #       # #   # # #     #
# # # # # ##### ####### # ### # ### #####
# #.# # #           #   # #   # #   #   #
# # # # ##### ####### ### ####### ##### #
# #.# #       #     # #. . . .  #. . .  #
# # ########### ### # # ##### # # ### ###
# #. . . . . . .  # # #.  #. .# #.  #. . 
# # # # ####### ### # # ### ##### #######
# # # # #     #. .#   #.#. .#. . .#     #
# # # ### ### # # ##### # # # ##### ### #
# # #   # # # # #. . . .#.# #. .#   # # #
# # ### # # # # ####### # ##### # ### # #
# #   # #   # #       # #. . . .#   #   #
# ### ####### ####### ##### ######### ###
#   #         #     #     #           # #
# # ########### ####### # ############# #
# #         #   #     # #     #       # #
# # # ######### # ### ### ### # # ##### #
# # #         # #   #   #   # # #     # #
# ########### # # ##### ### # # ##### # #
# #     #   #         # #   #   #   # # #
# # ### ### ########### ##### ### # ### #
#   # #   #     # #     #   # #   # #   #
# # # # # ##### # # ##### # # # ### # ###
# # # # #       # #       # #   # # # # #
# ### # ######### # ####### ##### # # # #
#     #           #   #           #     #
#########################################
