########################### #############
#   #     #   #            . .          #
# # # ##### # # ########### # ### ##### #
# # #       # #   #         #. .#   #   #
# # ######### ### ############# ### # ###
# # #    . .#   #             #.  # #   #
# ### ### # ### ############### # # ### #
# #   #  .#. . .#   #  . . .#. .# #   # #
# # ##### ##### # # # # ### # ### # # ###
#   #. . .#  . .# #   #.#  . .#   # #   #
##### ####### ### ##### ### ########### #
 . . .#     #.#   #    . .# #. .    #   #
##### ##### # # ####### # ### # ### # # #
#     #   #  .# #. . .# #. . .#. .# # # #
# ##### # ### # # ### # ######### # # # #
#     # #   #.# #.# #.#     #. . .# # # #
####### ### # ### # # ####### ##### # # #
#       # #  . . .# #. . . .#. . .# # # #
# ####### ####### # ####### ### # # # # #
#   #       #     #       #. .# #.# # # #
##### # ### # ########### ### ### # # ###
#     # #     #         #    . .#.# #   #
# # ### # # ### ####### ####### # # # # #
# # #   # # #   #   # #        . .# # # #
### # ### # # # ### # ########### # # # #
#   #   # # # #   #             # # # # #
# ####### ### # # ############# # # ### #
#       #   # # #   #         # # # #   #
# # ### ### # # ### ######### # ### ### #
# #   #   # # #   #         # #     #   #
# ### # # # # ############# # ##### # ###
# # # # # # #   #   #     # #       #   #
# # # ##### # # # # ##### # ######### # #
# # #     # # # # #       # #       # # #
### ####### # ### ########### ##### # # #
#   #       #     # #         #     # # #
# ### ##### # ##### ####### ####### # # #
# #   #   # # #     #       #     # # # #
# ### # # ### # ##### ####### ### # ### #
#     # #     #       #         #       #
#########################################
