####### #################################
#    . .    #. . .      #. . . . . . .  #
##### ##### # ### ####### ########### # #
#. . .#     #.  #. . . .#.          #.# #
# # ######### ######### # ########### ###
#.# #. . . . .        #. .  #       #. .#
# # # ############### # # # # ##### # # #
#.# #. .#       #   # # # #   # #   # #. 
# ##### # ##### ### # # ####### # #######
#. . . .      #   # # #   #     #       #
# ############### # # ### # ### ####### #
# #       #       # # #   #   #   #   # #
# # ##### # ####### # ####### ##### # # #
#     #   # #       #       # #     # # #
# ##### ### # ########### ### # ##### # #
#     # # # # #   #     #     #     # # #
# # # # # # # # ### ### # # ######### # #
# # # # #   # #   # # # # #           # #
# ### # ##### # ##### # # ############# #
# #   #     #         # #       #       #
# # # # ### # ######### ####### ####### #
# # # #   #   # #       #   #   #     # #
# # ##### # ### # ####### # # ### ### # #
# #     # #     # #       # #       # # #
##### # # ####### # ####### ######### # #
#     # #     #     #     #       #   # #
# ### # ### # # ##### ############# ### #
#   # #   # #   #         #     #   #   #
# # ##### # # ### ####### ##### # # # # #
# #     # # #     #     # #   #   # # # #
# ##### # # ########### # # # ####### # #
#   #   # #       #   # # # #     #   # #
##### ### ####### # ### # # ####### ### #
#     # #       # #     # #   #     #   #
# ##### # ####### # ##### ### # ##### # #
# #     # #       # #   # # #   #   # # #
# # ##### # ####### # ### # ### # # # ###
# #       #     #     #   #     # # #   #
# ############### ##### # ####### ##### #
#                 #     #       #       #
#########################################
