########### #############################
#    . . .#.  #. . . . . .          #. .#
# ### ### # # # ######### ########### # #
# #  .#  . .# #.#   #   #. . . .#. . .#.#
# ### ####### # ### ### # # ### # ##### #
#   #. . . .# #. . .    # #   #. .#   #.#
### # # ### ####### ##### ##### ### # # #
#   # #   #. . . . .    #     #     # #. 
# # # ################# ##### ###########
# # #                 #     #       #   #
# # ##### ########### ### ##### ##### # #
# #     #       #   #   #     # #     # #
# ##### ####### ### # # ### ### # ##### #
#     #     # #     # #   #   #       # #
# # ##### # # ####### ### ### ####### # #
# #     # #   # #   # #   #   #     # # #
##### # # ##### # # # # ########### ### #
#     # #       # #   # #     #     #   #
# ### # ####### ####### # ##### ##### # #
# #   #       #   #         #   #     # #
# # ######### ### # ### ##### ####### # #
# #     #   #   # # #       # #       # #
# ##### # # ##### # ##### # # # ### ### #
#     # # #       #     # #   #   # #   #
# # # # ######### ### # ### ##### ### # #
# # # #   #     #   # #   #     #   # # #
# # ##### # ### ### # ### ##### ### ### #
# #     # # # #   # # #   #   # #   #   #
# ####### # # # # # # # # # # ### ### # #
#   #   # # # # # # # # # # #     #   # #
# ### # # # # # ### ### # # ####### # # #
#     # #     #   # #   # #     #   # # #
# # ### ### ##### # # ### ####### # ### #
# #   #   #     # # #   #   #     # #   #
# ### ### ##### ### # # ### # ####### ###
# # #   #   #   #   # # # # # # #   #   #
# # ####### # ### ##### # # # # ### # # #
# #   #     # #   # #   #   # #   # # # #
# ### # ##### # ### # ####### ### # ### #
#   #   #     #     #       #     #     #
#########################################
