####### #################################
#  . . .                    #           #
### ##### ########### ### # # ##### ### #
#. .#   #   #       #   # # # #   #   # #
# # # ### # # ##### ### # ### # ##### # #
#.# #     # # #   # # # #     #   # # # #
# # ######### ### # # # ######### # # ###
#.# #. . .  #   # # # #       #   # #   #
# ### ### # ### # # # ### ### # ### ### #
#. . .  #.#   # #     #     #   #     # #
# # ### # ### ### ##### ######### ##### #
# #   # #. .#     #     #       #   #   #
# ### ##### ### ### # ### ##### # ### ###
#   #     #.  #   # # #   #   #   #   # #
### ####### # ##### # # ##### # ####### #
#     #  . .#   #   # # # #   #     # # #
# ##### # ### # # ### # # # ####### # # #
# #     #.#   # #   # #     #     # # # #
# ####### # ### ######### ### ### # # # #
#   #    .#   #         # #   # # # #   #
### # ### ### ####### # # # ### # # # # #
#   # #. .  # #   #   # # #   #   # # # #
# ##### ##### # # ####### # # ####### # #
# # #. .#     # #         # #     #   # #
# # # ######### ### ####### ####### ### #
#   #. .#. .      #       #   #   #   # #
####### # # ####### ####### ### # ##### #
 . . .#. .#. .    # #           #       #
##### # ##### ### # # ### ###############
# #. .# #. .#. .# #     #     #   #     #
# # ##### # ### # ### # ### # ### # #####
#  . . . .#. .#.#   # #   # #   # # #   #
############# # ### # # # # ### # # # # #
# #       #  . .# # # # # #   #   # # # #
# # ######### # # # # # # ### ##### # # #
#   #   #     # #   # # #   #     #   # #
# ### # ####### ##### # # ####### # #####
# #   #     #   #     # #       # #   # #
# # ####### # ############# ### # ### # #
#   #         #             #   #       #
#########################################
