####### #################################
#      .#. . .            #       #     #
# ##### # ### ### ####### ####### # ### #
# #   #.#.# #. .#     # # #     # # #   #
# # # # # # ### ##### # # ##### # ### # #
# # # #.#. .  #. .# # # #     #   #   # #
# ### # ### ##### # # # ##### # ### ### #
#     #. . .    #.#   #       #     # # #
########### ##### ################### # #
#. . . . .# #. . .                    # #
# # ##### ### ### ############# ####### #
#.# #   #. .#.# #   #. . .  # #     #   #
# # # # ### # # ### # ### # # # # # # ###
#.# # # #  . .#     #.# #.#   # # # # # #
# ### # # # ######### # # ####### # # # #
#. .# #   # #. . . . .  #. .    # # # # #
# # # ####### ############# ### # ### # #
# #.# #. . . .            #. .# #   #. . 
# # # # ##################### ##### # ###
# #.# #. .#       #         #. . .# #.# #
# # # ### ### ##### ############# # # # #
# #.#   #. . .      #      . . . .# #.# #
# # ######### ####### ##### ####### # # #
# #. . . .  #.#   #   # #  . .#     #.# #
# ### ### ### # # ##### # ### ####### # #
#   #   #.#. .# #       # # #.#. . . .  #
# # ##### # ### ##### ### # # # #########
# # #  . .#.  #     #   #   #. .  #     #
# # # # ### ### ####### ##### ### # ### #
# # # #. . .    #     #     # #   # # # #
# # ### ######### ######### # ##### # # #
# #   #       #     #   # # #     # # # #
# ### ##### # # # # # ### # ### # # # # #
# # #     # # # # # #   # #   # # # # # #
# # ### # # ### # # # ### # # ### # # # #
# #   # # #     # # # #   # #   #     # #
# ### # ######### # # # ### ### ####### #
# #   # #       # # # # #     # #   #   #
# # ### # ##### # ### # # ### # # ### # #
#   #         # #       #   # #   #   # #
#########################################
