########### #############################
#. . . .#  .        #         #         #
# ##### # # ### ### # ####### # ##### # #
#.#. .#.# #.  #   #       #   #. .#   # #
# # # # # # # ### ######### ### # # #####
#. .#.#.# #.#   #     #     # #.#.# #   #
##### # # # ### ####### ##### # # # ### #
#. . .#.# #. .#   #   # #   #. .#.#   # #
# ##### ### # # ### # # ### # ### ### # #
#.#   #. .# #.#     # # # # #.# #.  #   #
# # ##### ### ####### # # # # # # # #####
#.#     #.#. .  #   # #   # #.# #.#     #
# ##### # # # ### # # ##### # # # #######
#. . .# #. .#     # # #     #. .#.#. . . 
# ### # ### ######### # ####### # # #####
# # #.#     #. . . .#   # #. . .#. .#   #
# # # ####### ##### ##### # ##### ##### #
#   #. . . . .    #. . .  #.#   # #     #
# # # ########### ##### ### ### # # #####
# # # #   #   # # #   #. . .    # # #   #
# ### # # # # # # ### # # # ####### ### #
#   # # #   # # #     # # #     #   #   #
### # ####### # ####### # ####### ### ###
#   #       #   #     # #             # #
# ### # ####### # ### # ##### ######### #
# # # #         # #   #     #           #
# # # # ######### # ##### # ########### #
# # # #           #     # #           # #
# # # ################### # ######### # #
# #     #     #           #   #   # # # #
# ####### ##### # ####### # ### # # # # #
#         #     # #     # # #   #   # # #
# # ####### ##### ##### # # ####### ### #
# #   # # #     #     #   #     #   #   #
# # ### # ##### ##### ##### ### # ### ###
# # #     #   # #   #     #   # # # #   #
### # ##### # # # # # ### ### # # # # # #
#   # #     # # # # #   # # # # # # # # #
# ### ####### # # # ### ### # ### # ### #
#             #   #   #     #     #     #
#########################################
