######### ###############################
#. . . . .#. . . . . .        #       # #
# # ##### # ######### ####### # # ### # #
#.# #     #. .#     #. .    #   # # # # #
# # # ####### ##### ### ### ### # # # # #
#.# #       #. . .# #. .  #   # # # # # #
# # ############# # # # # ### # # # # # #
#.#     #. .  #. .# #.# # # # # # #   # #
# ####### # ### ### # ### # # # # ##### #
#. . . . .#. . .#   #. .#   # # #       #
# ### ### ####### ### # ##### # ####### #
#   #   #           # #. . .# #       # #
# # ### ############# ##### # ####### # #
# # # #     #     #   #   #.#       # # #
### # ##### # ### # # # # # ####### # # #
#   #       #   # # # # # #.  #   # # # #
# # ######### ##### ### # # # # ### # # #
# # #       # #   #     # #.# #   # # # #
# ### ##### # # ########### # ### # ### #
#         #   # #        . .#   #   #   #
# # ####### ### # ### ### ###############
# # #     #     #   # #  . . . . . . . . 
# ### ### ####### # ### ### # ###########
#       #   #     #   #   # #   #       #
# ######### ######### ### # ##### ##### #
#   #     #   #         # #       #   # #
##### ### ### # # ### # # ######### ### #
#     # #     # # #   # #     #   #     #
### ### ####### # # ### # ### ### #######
#   #         # # # # # #   #   #       #
############# # ### # # # # ### ####### #
# #             #   # # # # #   #     # #
# # ########### # ### # # # # ####### # #
# # #   #       #     # # # #   #       #
# # ### # ############# # # ##### #######
# # #   # #       #     # # #     #     #
# # ### # # ##### ##### # # # ##### ### #
# #   # # # #   #       # #       # # # #
# ### # ### # ########### # ####### # # #
#     #     #             #         #   #
#########################################
