################################# #######
#  . . . .#      . . .#      . .#.      #
# # ##### ####### ### ####### # # ##### #
# #.#   #. .#  . .# #. . .#  .#. .    # #
# # # # ### ### # # ##### ### ### ##### #
# #.# #    . .#.# #     #. . .#   #     #
# # ######### # # ##### ####### ### # # #
# #. .  #    . .# #             #   # # #
# ### ### ####### ############### ### # #
#   #. .#   #   # #               #   # #
####### ### # ### # ### ########### ### #
 . . .#.  # #   # # #   #       #   #   #
##### # # # ### # # # ### ##### # ##### #
#   #. .# # # #   # #   # #   #   #     #
# # # ### # # ### # # # ### ####### # # #
# #   #   #   #   # # #   # # #     # # #
####### ### ### ### # # # # # # ### # # #
#       #   #   #   # # # # #   #   # # #
# ##### ##### ##### # # ### ##### ### # #
#     # #     #   # # # #   #     #   # #
# ### # # ##### # # # # # ### # ### ### #
# #   # # #   # #   # # #     # #   #   #
### ### # ### # ##### # ### ### # ### ###
#   #   #     # #   # # #   #   #   #   #
# # ########### # # # # ##### ######### #
# # #     #     # #   #     # #       # #
# # ##### ##### # # # ##### # # ### ### #
# # #   #       # # # #   # # # # #   # #
# ### ####### # # ### # ### # # # ##### #
#       #   # # #   # #   # # #   #   # #
# ##### # # ### # # ### # # ##### ### # #
#     # # # #   # #     # #           # #
# ### ### # # ##### ### # ####### ##### #
#   #   # # #     #   # #   #   #   #   #
### ### ### ##### ### ##### ### ### ### #
# #   #     #   #   #     #   # #   #   #
# ### ######### ### ##### ### # ##### # #
#   #           #   #       # #       # #
# # ############# ### ####### ######### #
# #               #   #       #         #
#########################################
