##### ###################################
#    . .        #       #     #   # #   #
##### # # ####### ### ### ### ### # # # #
#     #.#   #     # #       #       # # #
# ##### ### # ##### ################# ###
# #   #.#   #. . .  #     #         #   #
# ### # ##### ### ### ##### ####### ### #
#   # #. . . .#. .    #   # #     # # # #
# # # ### ### # # ##### # ### ##### # # #
# # #   #   # #.#       #         #   # #
# # ### ### # # ################# # ### #
# #   #   # # #.  #. . . . . .  #   #   #
# ### ### # ### ### ####### # # ##### ###
#   #   # # #. .#. .#     # #.#       # #
# # # ### # # # # ####### ### ######### #
# # #     # #.# #. . . .# #. .#. . .    #
# # # ####### # ####### # # ### ### #####
# # # #  . . .# #     #. .#. .#.  #. .  #
### ### # ##### # ### ### ### # ##### # #
#   #   #. . .#   # # #. .# #.#.#   #.# #
# ### ### ### ##### # # ### # # # # # ###
# #     #   #. . . .# #.#   #. .  # #. . 
# ##### ##### ##### ### # ### ###########
#     #     #     #. . .  # #       #   #
# ### ### # ##### ### ##### ####### # # #
# # #   # #     #   #     #     # #   # #
# # ### # ### ##### ### ### ### # ##### #
# #   # # # #   #     #       # #       #
# ### # ### # # ############# # #########
#   # #   # # #     #       # # #   #   #
# ### # # # # # # ######### # # # # ### #
#     # #   # # #   #     # # #   #   # #
##### # ##### # ### # ##### # ##### # # #
#   # #     # #   #   #   # #     # #   #
# # # ##### # ### ##### # # ##### #######
# # # # #   #   #       # #     #       #
### # # # ### # ########### ########### #
#   #   # # # #         #   #   #       #
# ####### # # # ### ##### ### # # #######
#         #   #   #           # #       #
#########################################
