########### #############################
# #        . . .          # #. .    #. .#
# # ####### # # ######### # # # ##### # #
#   #       # #. . . . .# # #.#. .#. .#.#
# # # # ##### ####### # # # # ### # ### #
# # # #   # # #     # #.# #. .  #.#.# #.#
### # # # # # # ### # # ### ##### # # # #
#   # # # #   #   # # #. .#.#   #. .# #.#
# ### # # ##### ### # ### # # # ##### # #
# #   # #       #   # #. .#.  #       #.#
# # ### ######### # # # ### ########### #
# #   #   #   #   # # #.#. .        #  . 
# ### ### # ### # # # # # ####### # # # #
#   # #   #   # # # # #. .      # # # # #
### # ####### # # # # # ##### # ### # ###
#   #         # # # # #   # # # # # #   #
##### ############# # ### # # ### # ### #
#   # #     #       #   # #   #   #   # #
# # ### ### # ####### ### ##### ### # # #
# #     # #   #       #   #     #   # # #
# ####### ##### # ##### # # ####### ### #
#   #     #     # #     # #   #     #   #
# # # ##### ### ### ##### ### ### ### # #
# # #   #   #     #   #   # #     # # # #
# ##### # # # # # ### # ### ####### # ###
# # #   # # # # #   # #     #       #   #
# # # ##### ### # ### ####### ####### # #
#   #     # #   #   #             #   # #
######### # # # # # ######### ### ##### #
#   #   #   # # # #     #       #   #   #
### # ##### # # # # ### # ######### # ###
# # #       # # # #   # #   #     # #   #
# # ######### ### ### ####### # ### ### #
#   #         #     #       # #   #   # #
# ### ####### # ### ######### ######### #
# #   # #   # #   #   #   #   # #       #
# # ### # # # ### ##### # # ### ##### # #
# #     # #     #       #   # #   #   # #
# ####### # # ############### ### ##### #
#         # #                 #         #
#########################################
