######################### ###############
#                        .        #     #
##### ########### ####### ### ##### # ###
#     #     #     #. . . .  #       #   #
# ######### # # ### ##### ############# #
# #   #   #   # #  .#     #. . .      # #
# # ##### ##### # # # ##### ### ##### # #
# #   # # #     # #.# #. . .# #.#   # # #
# ### # # # # # # # # # ##### # # ### # #
# # #     # # # # #.# #.#     #.#     # #
# # # ##### ### # # ### # ##### ####### #
# # #       #   # #. . .  #    .      # #
# # ### # ### ### # # ######### ##### # #
# #   # # #   # # # #     #   #. . .# # #
# ### ### # ### # # ### ### # ### # ### #
#     #   #     # #   #     #   # #. .# #
# ##### ######### ### ######### # ### # #
#     # #           # # #     # #   #.# #
##### # # ### ##### # # # ##### ##### ###
#   # # # #   #     # # #     #     #. .#
# # ### ### # ####### # ##### # # # ### #
# # #   #   # #       #   #   # # #   #.#
# ### ### ### # ######### # ### ####### #
#     #   #   # #         #   # #  . . .#
####### ####### # ########### ### # # # #
# #     #       #   #       #     #.# # #
# ### ### ######### # ##### ####### ### #
#     # #   #  . .#   #  . . . .#  . .# #
####### ### ### # ####### ##### ### # ###
#   # #   # #. .#. . . .#.#    . .# #. .#
# # # ### # # ### ##### # ####### # ### #
# #  . . .# #. .# #   #. .#     #.# #. .#
# ### ### ### # # # # ##### ### # ### # #
# #. .#  . .# #.# # #     # # #  . . .# #
# # ####### ### # # ##### # # ##### ### #
# #. . .#  . . .# # #   # # #     # #   #
# ##### ##### # # ### # # ### ### ### # #
# #   #.#     # #   # # # #   # #     # #
# ### # # ##### ### # # # # # # ####### #
#     #.#     #   #   # #   # #         #
####### #################################
