######################### ##### #########
#         #         #    . .  #.#       #
# ####### # ####### # ### # # # # ##### #
# #   # # #     #   #   # #.# #.# #  . .#
# # # # ####### ####### ### ### # ### # #
# # #       #           #. .#. .# #. .#.#
# # ### ### ##### ####### # # ### # ### #
# # #   #         #  . . .# #.#   #.# #.#
# ### ##### ####### # ####### ##### # # #
#     #   # #       #. . . .#. . . .# #.#
##### # # ### ### ### # ### ######### # #
#   # # #     #   #   #   #. . . .    #.#
### ### ####### # # ##### # ##### ##### #
#   #   # #     # # #   # #     #.  #. .#
# ### ### # ### # # ### # ##### # ### ###
#     # #   #   # #     #     # #. .#. .#
####### ####### # ### ### ##### # # ### #
#     #         #   # #     #   # #.  #.#
##### ####### ##### # # ##### ##### # # #
#   #       # #     # # #     #  . .# #.#
# ######### # # ##### # ####### # # ### #
#     #   # # # #   # #       # #.# #. .#
##### ### # # # # ### # # ### # # ### ###
#   #   # # # # #     # # #   # #. . .  #
# ##### # # # # ####### ### ####### ### #
#     # #     #   #   #   #       # # # #
# ### # ### # # ### # ### ### ### ### # #
#   #   #   # #     # # #   #   #     # #
### ##### ### # ##### # ### ########### #
# #       #   #   #   #   #           # #
# ######### # ##### ##### ############# #
# #   #     # #     #             #     #
# # # # ##### ####### # ######### ### # #
# # #   #   #   #     # #   #     #   # #
# # ####### ### ####### # # ##### # ### #
# #         #   # #     # #     #   #   #
# ########### # # # ########### ### # ###
# #       #   # # # #         #     #   #
# # ##### # ### # ### ####### ######### #
#   #       #   #     #                 #
#########################################
