################### #####################
#  . . .#    . . . .                    #
# # ### ##### # ### ####### ####### ### #
# #.#  . . . .# #         #   # #   #   #
# # ##### ### ### # ######### # # #######
# #. .#   #   #   # #       # #   #     #
# # # ##### ### ##### ##### # ######### #
# # #. .#   #       #     #         #   #
# ##### # ### # # # ############### # ###
#     #.#   # # # #               # # # #
##### # ### # # ######### ##### # # # # #
#     #. .# # #         #   #   # #   # #
######### # ########### ### # ### ##### #
 . . . .#.#     #   #   #   # # # #   # #
####### # ##### ### ##### # # # # # # # #
#. . . .#. . .# # #       # # #   # #   #
# ####### ### # # # ### # # # ####### # #
#.#       #. .#   # #   # # #     #   # #
# ######### # ##### # ### # ### ####### #
#. . . . . .#     # #   # #   #     #   #
########### # ### # ### # # # # ### # ###
#       #   # # # #   # # # # #   #     #
# ####### ### # # ##### # # # ####### # #
# #       # #   # #     # # # #     # # #
# ### ### # ##### # ##### ### # ### ### #
# #   #   #       # #       # # #   #   #
# # ############# # ####### # ### ### # #
#   #             # #       #       # # #
### # # ######### # # ##### # ####### # #
#   # # #         # # #   # #     #   # #
##### ### ### ##### # # # ######### ### #
#     #   #   #     # # #   #       #   #
# ##### ##### # ##### # ### # ##### # ###
# #   # #     # #     # #     #     # # #
# ### # ### # # ### # # ####### ##### # #
# # # # #   # #   # # #   #     #   # # #
# # # ### ##### # # ############### # # #
# #       #   # # #                 # # #
# ######### ##### # # ########### ### # #
#           #     # #       #       #   #
#########################################
