# #######################################
#. . .                  #               #
# ### ####### ### ##### # ##### ####### #
#   #. .#   # # # #     #     #       # #
##### # # # # # # ####### ######### ### #
#. .# #.# # # # # #           #   #   # #
# # # # # ### # # # ######### ### # # ###
#.#.# #.# #   # # # #       #     # #   #
# # ### # # ### # # # ##### ########### #
#.#.#. .# # #   # #     # # #     #     #
# # # ### # # ### # ### # # # ### # #####
#.#. .#   # # #   # # # # # # # # # #   #
# ### # ### # # ### # # # # # # # ### # #
#.# # #     #   #   # # # # # #   #   # #
# # # ########### ### # # # # ##### ### #
#.#   #         #   # # #   # #       # #
# ##### ####### # ### # ##### # ####### #
#. . .  #. .  #   #   #   #   # #       #
# ### ### # ####### ### ### # # ####### #
#   #. . .#. .      #   #   # #. .    # #
# # # ####### ######### # ### # # ### ###
# # #       #. . .    # # #   #.#. .#   #
# # ######### ### ### ### # ### ### ### #
# #         # #. .  #     #   #.# #.  # #
# ####### # ### ############### # # ### #
#   #   # #   #.#. . . . .#. . .  #.#   #
##### ####### # # ##### # # ####### # # #
#     #       #. .    # #. .#   #. .# # #
### ### ############# ####### ### ### # #
#       #  . . . . .#   #     #. .#   # #
# ####### # ####### ### # ##### # # ### #
# #     # #. .#  . .# # # #. . .# # #   #
### ##### # # ### ### # # # # ##### # ###
#   #     # #. .#. . .#   #.# #   # #   #
# ### ### # ### ##### ##### ### ### ### #
# #   #   # # #.#   #.#    .#   #     # #
# # # # ### # # ### # ##### # ### ##### #
# # # # #   # #. .# #. . . .#     #   # #
# ### # # ### # # # ####### ####### # # #
#     # #     # #.#         #       #   #
################# #######################
