####################################### #
#        . . . . . . . .#       #  . . .#
# ### ### ##### # ##### ####### # # # # #
# # # #  . .#   # #   #. . .# #   #.# # #
# # # # ### ##### # ####### # ##### ### #
# # # #   #. .  # #   #    . .#    .#   #
# # # ### ### # # ### ####### ##### # ###
# # #   # #. .# #   #        . . . .# # #
# # # # # # # ################### ### # #
#   # # # #.# #. . . .      #     #   # #
####### # # ### ##### ##### # ##### # # #
#       # #. .#.    #.    # #   #   # # #
### # # # ### # ### # ##### ##### ##### #
#   # # #   #. .  # #. . .#   #   #   # #
# ### # # # ### # ####### ### # ### # # #
# #   # # #   # #   #   #.# # # #   # # #
# ##### ### # ##### # # # # # # ##### # #
# #   #   # # #   #   # #.#   #   #   # #
# # # ### ### # # ##### # ####### # ### #
#   #   # #   # #       #. . .#   #. .  #
# ### # # # # # ############# ##### # ###
#   # # # # # # #  . . . . . .#. . .#.  #
# # ####### # # # # # ######### ##### ###
# # #       # # # #.# #. . . .#. .# #. . 
### # ##### # # # # ### ##### ### # #####
#   # #   # # # # #. . .#   #.  #.  #   #
# ### # # ### # # ### # ### # ### ### # #
# #   # #     # #   # # #   #. . .    # #
# ### # ####### ### # ### ### ######### #
#   # # #   #     # #       #   #       #
# # # # # # ##### # ####### # # #########
# # # # # # #   # #     #   # #         #
# # # # ### # # ### ### ####### ####### #
# # # #     # # #     # #     #     #   #
# # # ####### ### ##### # ### ####### # #
# # #       #     #     # # # #       # #
### ####### ####### ##### # # ### ### # #
#   #     #       #     # # #     #   # #
# ### # ######### ######### ########### #
#     #         #           #           #
#########################################
