# #######################################
#.#. . . . . .      #           #   #   #
# # ####### # ### ### ### ####### ### ###
#. .  #   # #.  #   # # #           # # #
# ##### # ### ##### # # ########### # # #
# #     #   #. .  # #   # #       # # # #
# # ####### # # ### ### # # ##### # # # #
#       #   # #. .#       #   #   # #   #
# ####### # # ### ######### ### ##### ###
#   #     # #   #.            #         #
### # ####### # # ########### ######### #
#   # #     # # #.#. . .    # #     # # #
##### # ### ### # # ### ### ### ### # # #
#   # # #   #   #. .  #.#   #   # # #   #
### # # # ### ### ##### # ### ### # #####
#     # #     #   #. . .# #. .  # #     #
# # ########### ### ### ### # # # ##### #
# # #  . . . .#   #.# # #. .#.# #       #
# # # # ##### ### # # # # ### # #########
# # # #.#. .#.# # #.#   #.# #.#   #     #
# # # # # # # # # # ##### # # ### ##### #
# # # #. .#.#. .# #.#. . .# #. .#     # #
# # # # ### ### ### # ##### ### ### # # #
# # # #   #.#  . .#.#.#. .#   #.  # #   #
# # # ### # # ### # # # # ### # # #######
# # #   # #.# #  . .#. .#. . .#.#       #
# # ### # # ### ############# # #########
# #   # # #. .#   #. .    #. .#. . . . . 
# ### # ### # ### # # ##### #############
#   # #   # #. .# #.#.  #. .  #         #
### # ### # ### ### # # # ##### ####### #
#   #   # #   #. . .#.# #.# #   # #     #
######### ### ####### # # # ##### # #####
# #         #   #   #.# #.  # #         #
# # # # # ##### # # # ### ### # ####### #
# # # # #     #   # #. . .#       #   # #
# # # # ####### ### ### # # ####### # ###
# # # # #     #   #   # # #     #   #   #
# ### # ### # ####### # ### ##### ##### #
#     # #   #         #           #     #
#########################################
