####### ######################### #######
#. .#  . .    #   #. .  #. . . . .# #   #
# # ### # # ### ### # # # ######### # # #
#.#. .# #.# #   #. .#.# #.#           # #
# ### ### # # ### ### ### # ########### #
#.#  . . .#   #. .  #. . .#     #     # #
# ####### ##### ############# ### # # # #
#. .#     #. . .          #   #   # # # #
# # # ##### ############### ### ### ### #
# #.# #. . .#                   # #   # #
# # ### ##### ######### ######### ### # #
# #. . .      # #     #     #       # # #
# # ########### # ### ####### ### # # # #
# #             # # #   #       # # # # #
# ######### ##### # ### # ####### # # # #
#     #   # #     #   #   #     # # # # #
# # # ### # # ####### # ### ### ### # ###
# # #   #   # #       #       # # # #   #
# # ### ##### # ############### # # # # #
# #   #       #       #     #   #   # # #
# ##### # # ### ### # # ### # ######### #
#     # # #       # # # # #   #   #     #
# ### # ##### ##### # # # ####### ### # #
#   # #     #   #   # # #       #     # #
##### ##### ### # # # ### # ### ####### #
#         # #   # # #     #   # # #     #
# ####### # # ### # # ##### ### # # #####
#       # # #   # # # #   # #   #   #   #
# # # ### # ### ### ### ### # ####### ###
# # #   # #   #   #     #   #           #
# ##### ### ##### ####### ############# #
# #   # # #     #     #   # #   # #   # #
# ### # # ##### ##### # ### # # # # # # #
# # # # #     #   #   #   # # #   # #   #
# # # # ##### # # # ##### # # ### # ### #
# #     #   # # # # #     #   #   # #   #
# ### ### # # # # # # ######### ### # ###
# #   #   # # # # # # #       # # # #   #
# ##### ### # # # # ### # ### # # # ### #
#       #   #   # #     #   #     #   # #
#########################################
