####### #################################
#. .#  . .      #             #         #
# # # ### ### # # ######### # # # ##### #
#.#.#   #.  # #   #       # # # #     # #
# # ##### # # ##### ### ### ### ##### ###
#.#. .#. .# #     # # #   #         #   #
# ### # ### # ### # # ### ########### ###
#.#  . .#   #   # # # #         #   #   #
# ####### # # # # # # # # ##### # # ### #
#. .#   # # # # #     # #   #   # #   # #
### # # # # ### # ##### ### ######### ###
#. .# # # # #   #   #     #         #   #
# ##### # # # ########### ####### # ### #
#.#     # # #         #   #     # #   # #
# # ##### # ######### # ####### # # ### #
#.#   #   # #       # # #     # # #   # #
# ### ### # # ### # # ##### ### # ### # #
#. .#     # # # # # #     # #   #   #   #
# # ######### # # ##### ### # ######### #
# #. . . .      #     # #   # # #     # #
######### ####### # # # # ### # # ### ###
 . . .#. .      # # # #   # #   # # #   #
##### # ####### # # ####### # ### # ### #
#   #.#. .  #   # #       #     # #     #
# # # # # ### ####### ### # ##### ##### #
# # #.# #. .#   #   #   #       #     # #
# ### # ### ### # # ### ####### ####### #
# #. .#   #.  #   #   #       #       # #
# # ####### # ####### ####### ##### ### #
#  .#    . .#   #   #       #     #     #
### ##### # ### ### # ##### # ### #######
#  . . . .#   #     #     # #   #   #   #
# ### ### # # ####### # # ##### ### ### #
# #   #   # #   #     # #     #   #     #
### ### ##### # # ####### # ##### #######
#   #   # # # # # #     # #   #       # #
# ### ### # ### ### ### # ##### ####### #
# # #   #     #       # #   # # #       #
# # # # ##### ######### ### # # # #######
#   # #     #             #   #         #
#########################################
