### ############################### #####
# #.# #    . . . . .#. .#      . . .    #
# # # # ### ####### # # ####### # # # ###
#  . .#   #.#. .#. .#.#. . . .#.# # #   #
##### ### # # # # ### ####### # ### # # #
#   #.#   #. .#.#. . .#      . .#   # # #
# # # ######### ### ### ####### # ### # #
# # #. . . . .#.#   #   #       # #   # #
# ##### ##### # # ### ### ####### # ### #
# #   # #    . .# #   # # # # #   # #   #
# # # ### ##### ### # # # # # # ### # # #
#   # #   #     #   # # #   # # #   # # #
##### # ### ##### ### # ##### # # ### # #
# #     #     #   #   #   #   # # #   # #
# # ##### ### # ### ##### # ### # # #####
#   #     #   # #   # #   # #   # #     #
##### ##### ### ##### # ### # # # # # # #
#     #     #         #     # # # # # # #
# ##### ####### # ### ### ### ### # ### #
#   # # #       #   #   #     #   # #   #
# # # # ############# # ### ### ##### # #
# #   #       #     # # #   #   #     # #
# # ### ### ### ### ### # ### ### ### # #
# # # # # #       # #   # #   #   #   # #
# # # # # # ########### ### ##### ##### #
# #   #   # # #         #   #     #     #
# ####### # # # ### ##### # # ##### #####
# #     # # # #   # #     # # #         #
# # ### ### # # # # # ### ### ##### ### #
#   #   #   # # # # # #     #     #   # #
######### ### ### # # ##### ##### ##### #
#       #     #   # #     #   #   #     #
# # ### ####### # # ##### # # # ### ### #
# # #           # #     # # # # #   #   #
### # ######### ######### ### # # # #####
#   # # #       #       # #   # # #     #
# ### # # ####### ##### # # ### # ##### #
# # # # #     #   #       # #   #     # #
# # # # ##### # # ########### ######### #
# #   #       # #           #   #       #
#########################################
