####################################### #
#   #           #       #       #      .#
# ### ### ##### # ##### # ### # # ##### #
#     #   #       #       #   #   #  . .#
######### # ####### ### ### # ####### # #
# #       #   #     # # #   #     #. .# #
# # ### ####### ##### ### ######### # # #
# # #   #     # #     #   #    . . .# # #
# # # ### ### ### ##### ### # # ####### #
# # # #   # #     #   # #   # #.#     # #
# ### # ### ######### # ##### # # ### # #
#     # # # #         #   #   #.#   #   #
####### # # # ####### ### # # # ### #####
#         # # #     # #   # # #. .#     #
# ####### # # # ##### # ##### # # #######
# #     # #   # #     # #     # #. .#. . 
### ### # ##### # ####### ### # ### # ###
#   #         #   #       #   #   #.#.# #
# ########### ### ### ### ####### # # # #
# #   #     #         #   #       #.#.# #
# ### # ### ######### ##### ####### # # #
#   #     # #         #     #  . . .#.# #
# # ##### ### ### ##### # ### # ##### # #
# #     #     #   # #   # #   #.#. . .# #
####### ### ##### # # # # # ### # ##### #
#       # # #     # # # # # # #.#. . . .#
# ####### # # # ### # ### # # # ####### #
# #     #   # #     #   # # # #.  #. .#.#
# # ######### ######### # # # # ### # # #
# # #         #         # #   #. . .#.#.#
### # # ####### ### ##### ### # # ### # #
#   # # #       #       #   # # # # #. .#
# ### # # # ####### # ##### # # # # # ###
# #   # # # #       #   #   # # #   #   #
# ##### # # ############# ### # #########
# #     # # #   #         #   #     #   #
# # ####### ### # # ####### ### ### # # #
#   #       # # # #   #   # #     # # # #
##### ### ### # ##### # # # # ### ### # #
#     #       #       # #   #   #     # #
#########################################
