################################# #######
#          . .#    . .#          .      #
######### # # ##### # ########### ##### #
#   #     #.#. .#. .#. .#    . . .# #   #
# ##### ### ### # ##### ##### # # # # ###
# #     #  . .#. .#    . . . .# # # #   #
# # # ##### # ############# ##### # ### #
# # #     # #. .#. . . . .# #     #   # #
# # ##### # # # # ####### # # ####### # #
# #     # # # #. .#     #.# #         # #
# ####### # ### ####### # # ########### #
#       # #   #         #.# #   #       #
####### # ### ########### # ### ####### #
#           #   #      . .# # # #   #   #
# ####### ### ### ##### ### # # # # ### #
#   #   # # #   # #. . .#   #     #     #
### # # ### # # ### ##### ##### ### ### #
# # # #     # # #. .#   # #     #   #   #
# # # ######### # # ### # ####### ### ###
# # #           #.# #   #     #   # #   #
# # ##### ####### # # ####### # ### # # #
#   #     #      .# # #       #   # # # #
########### ##### # # ### # # # # # ### #
#           #. . .# #     # # # # #   # #
# ########### ### # ##### ### # # ### # #
#     #. .#. .# # #   #   #   # #     # #
##### # # # # # # # # # ### ########### #
#     #.#. .# # # # # #   #     #       #
####### ##### # # # # ######### ##### ###
 . .#. .# #   #   # #         #     # # #
### # ### # ##### # ##### ### ##### # # #
#  . .#   #   #   #     #   #     # # # #
# ### # ##### # # # ### ### ####### # # #
# #   # #     # # #   #   #     # # # # #
# # ### ### # # ######### ### # # # # # #
# # #       # #       # # # # # # # #   #
### ####### ######### # # # # ### # ### #
#   #     # #       #   #   #   # #   # #
# ### ### ### ### ########### # # ### # #
#       #       #       #     #   #   # #
#########################################
