####################### #################
#               #      . . . . .        #
# ############### ### # # ##### ####### #
# #     #       #   # # # #   #. .#   # #
# ##### # ########### # ### ##### ### # #
# #   #   #   #       # #   #. . .#   # #
# # # ### ### # ### # # # ### ### # ### #
# # #   #   # #   # # # # #. .#   # #   #
# # ### ### # ##### # # # # ### ### # # #
# # #     # # #     # #   #.#   #   # # #
# # ##### # # # # ######### ##### ### # #
# #   # # #   # # # #     #. .  #     # #
# ### # # ### ### # # ##### # # ####### #
# #   # #   #     # #       #.#   #   # #
# # ### ### ####### ######### ### # # ###
# #   #  . . . . . . .#    . .  #   #   #
# ### ### ########### # ### # # ####### #
# #   #  .#         #.# #. .# # #     # #
# # ##### # ######### ### ### ### ### # #
# # #. . .#          . . .#   #   #   # #
# # # ### ############# ### ### ##### # #
# # #. .# #. . .  #   # #   #   #       #
# ### # # # ### # # # ### ####### ##### #
#     #.# #.  #.# # #     #   #   #     #
####### ### ### # # ##### ### # ### #####
#    . .#. .#. .# #   #   #   # #     # #
# ### ### ### ### ### ##### ### ### # # #
# #. .#. .# #.#   # #     # #     # # # #
# # ### ### # # ### ##### # ##### # # # #
# #.#. .    #.# #. .    # # #     # #   #
# # # ####### # # # ### # # # ### ##### #
# #. .#     #.# #.#. .# # #   #   #   # #
# # ####### # # # ### # # ######### # # #
# #         #.# #. .#.# #     #     # # #
# ########### ##### # # ### # # ##### # #
#   #       #. . . .#.#   # #       # # #
# # # ##### ######### ### ########### # #
# #   #   # #       #.# # #     #     # #
# ##### # # # ####### # # # ##### ##### #
#       # #   #      .#   #       #     #
##################### ###################
