####### ################# ###############
#      . . . . .#. . .#  .#. .          #
# ############# # ### # # # # ### ##### #
# #       #    . .#. .# #. .#.  #   #   #
# # # ### ######### ### # # # # # # #####
# # # # # #   # #. .# # # # #.# # #     #
# # # # # # # # # ### # # # # # # ##### #
# # # #     # #  . .#   # # #.# #     # #
# ### ####### ##### ##### ### # ####### #
# #   # #   #   # #.#     #. .#   #     #
# # ### # # ### # # # ##### ##### # # # #
# #     # # # # #. .#   #. .#   # # # # #
# # ####### # # # ####### # # ### ### ###
# # #     # # #  .#  . . .# #   #   #   #
# ### # # # # ### ### # # # ### ### # # #
#   # # # #     #.#. .# # # #       # # #
### ### # ### # # # # ### # ########### #
#   #   #     #  . .# #   #   #         #
# ### ############# # # ##### # ##### # #
#   # # #     #     # #     # # #     # #
##### # # ##### # ### ####### ### # # # #
#     # #       # # #   #     #   # # # #
### # # ##### ### # ### ### ######### # #
#   # #   #   #   # # #   # #         # #
# ####### ##### # # # ### # # ######### #
# #   #         # #   #   # #   # #   # #
# # # ########### ### # ### ### # # # # #
# # #             #   #   #   # # # # # #
# # ##### ########### ### # ### # # # # #
# # #   # #             # # #   #   # # #
# # # # # ############# ### # ### ##### #
# #   # #           # #     # # # # #   #
# ##### ### ### ### # ####### # # # # # #
#     #   #   #   # #       # # #   # # #
####### # ### ### # ####### # # ### ### #
#     # #   #   # #       #   #         #
### # ### # # ### ##################### #
#   #     # #   #     #     # #     #   #
########### # # ####### ### # # ### # # #
#           # #         #   #   #     # #
#########################################
