##### # #################################
#   #.#. . .          #         #   #   #
### # ##### ### ### ### ##### # # ### # #
#   #. . .#.  #   #         # # #     # #
# ####### # # # # ########### # # ##### #
# # #. .#.#.# # #     # #     # # #     #
# # # # # # # # ##### # # ##### # #######
#. . .#. .#.# # #     # # #     # #     #
# ######### # # ####### # ####### ### # #
#. . .#    .# #         #       #     # #
##### ##### ##### ######### ########### #
#   #. . .#. .  #         #           # #
# # ##### # # ######### ############### #
# #   # #.# #. . . .  # #               #
# ### # # ### # ### # # # ###############
#   #   #. .# # #. .# # #     #       # #
### ####### # ### ### # # ### # ##### # #
# #   #   #.# #. .#   #     # # #   #   #
# ### ### # # # # # ### # # # ### ##### #
#       #. .# #.# # #   # # #     #   # #
####### # ### # # # # ##### ####### # # #
#   # # #.#   #.# # #     #   #     #   #
# ### # # ##### # # ##### ### # #########
#   # # #. . . .# #     #   #   # #     #
### # # ### # ####### # # ####### # ### #
# # # #     # #       # #       #     # #
# # # ####### # ##### # ### # ### ##### #
# # #   #     # #     #   # #       #   #
# # ### # ##### ####### # ########### # #
# #   # # #   #     #   #       #   # # #
# ### # # # ##### # # ######### ### # # #
#     # #   #     # #       # #     # # #
# ##### ##### ### # ####### # # ##### # #
#     #       #   #       #   #   #   # #
##### ### ### # ######### ######### ### #
#   #   # #   #     #   #     #   #   # #
# ##### ### ####### ### # ### # # ### # #
#   #       #     #     #   # # # #   # #
### ############# ########### # # ##### #
#                             # #       #
#########################################
