####################### #################
#                      . . . . . . . .  #
# ### ######### ####### # ########### ###
# #   #         #       #   # #     #. .#
# # ### ### # ### ### # ### # # ### ### #
# # #   #   # #   #   #   #   # #   #. .#
# # # ### # # # ##### ######### # ### ###
# # # #   # # # #   #           # #  . .#
### # ##### # # # # ### # ##### # ##### #
#   #   #   # #   #   # # #   # #     #.#
# # ### # ########### # ### # ### ##### #
# #   # # #   # #     #     #   # #  . .#
# ### # # ### # # ### # ####### # # # # #
# #   # #     # # #   #     #   # # #.# #
# ##### ####### # ########### ##### # ###
#     #       # #   #         #     #. .#
# # # ####### # # # # ######### ##### # #
# # # #     # # # # #       #   #. .# #.#
# ### # ##### # # # ### ### # # # # ### #
#   # #     #   # #   #   # # # #.#. . .#
### # ##### ####### # ##### # # # ##### #
#   #     #       # #     # # # #.#. .# #
# ### # ######### # ##### ### # # # # ###
# # # # #       # # #     #   # #. .#. .#
# # # ### ####### # ####### ### # ##### #
# # #   # #       # #       #   #   # #.#
# # ### # # ####### # ####### ##### # # #
# # #   # # #       #     #     #   # #.#
# # # # # # ############# # ### ##### # #
# # # # # #     #       # #   #     # #.#
# # # ### ##### # ####### ######### # # #
# # #     #   # #   # #   #       #   #.#
# # ######### # # # # # ### ##### ##### #
# # #       # #   #   # #   #  . . . . .#
# # # # ### # ### ##### ### # # ##### # #
# # # # #       # #     #   # #.#   # # #
### # # ####### # ####### ### # ### # # #
#   # #   #   # #   #     #   #.#   # # #
# ####### # ### ### # ##### ### # ##### #
#         #           #     #  .#       #
############################### #########
