####################### #################
#   #           #     #. .    #. . . .  #
# # # ######### # ### # # ##### ##### ###
# # #     #     # # # # #. . .#. .# #. .#
### ##### ####### # # # # # # ### # ### #
#   #   #         # # # # # #. . .  #. .#
# ### # ### ####### ### # # ######### # #
#     #   #     #       # #     #. . .# #
### ##### ##### ### ##### ##### # ### # #
#   #   #     #     #     # #   #.#   # #
##### # ##### ############# # ### # ### #
#     #     #        . . . .# #. .# #   #
# ######### ######### ##### ### ### # ###
# #. . . .#. . . .#. .#   #.#. .#   # # #
### # ### # ##### # ##### # # # # ### # #
 . .# #  . .#    . .#   #  . .# # #   # #
##### # # ########### # ####### # ### # #
# #   # # #           #       # #   # # #
# # ### # # ####### ######### # # # # # #
# #   # # # #   #   #       #   # # # # #
# ### # # # ### ##### ##### ##### # # # #
# #   # # #   #       #       #   # # # #
# # ### # # # ####### # ### # ##### # # #
# # #   # # #   #   # # #   #       # # #
# # # # # ### # ### ### # # ### ##### # #
#   # # #   # #     #   # # #   #       #
##### # # # ######### ### ### ### ### # #
#     # # #         #   # #   #   #   # #
### # # ####### ####### # # ### # #######
#   # #       #   #   # # # #   # #     #
# ### ####### ### # # # # # # # ### ### #
#   # #     #   # # #   # # # # #     # #
# # ### ####### # ####### # # ### ##### #
# #   # #   # # # #     # # #     #   # #
# # # # # ### ### # ### ### # # ### # # #
# # #   # #   #   # #       # #     # # #
# ####### # ### # # ##### # # ######### #
#     #   #     # # #   # # #     #     #
# ### # ########### # ### # ##### #######
#   #   #           #     #     #       #
#########################################
