### ############# #######################
#. .  #. . . .  #. .# #           #     #
# ### # ##### ##### # # ####### ### ### #
#. .# #.#   #. .  #.# # #     #   # # # #
# # ### # # ### # # # # # ### ### # # # #
# #. . .# # # #.# #. .# #   # # #   # # #
# ### ### # # # # ### # ### # # ##### # #
#   #     # # #.#   #. .#   # #   #   # #
# # ####### # # ### ### ##### ### ### ###
# #       #   #. .# #  .#. .# # #       #
# # ##### ####### # ### # # # # ####### #
# #     #       #.#   #. .#.  #       # #
# ##### ####### # ### ##### ### ##### # #
#     # #       #. .#     #.    #     # #
# ### # # # ### # # ####### ########### #
#   # # # # #   # #. . . . .        #   #
### ### # ### ### ##### ######### ### ###
#   #   #   #   # #   #   #     #   #   #
# # # ### # ### # # # ##### # # # # ### #
# # # # # #   # #   #       # # # #   # #
# ### # # # ### # ### ### ### # ##### # #
#   # # # #   # #   # # # #   #     #   #
# # # # # ### # ### ### ### # # ### # # #
# # # # #   # #   #   #   # # #   # # # #
### ### ### # ### ### ### # # ##### # ###
#   #     # #   #   #   #   # #     #   #
# ### ##### ### # # ######### # # ##### #
#     #     # # # # #     #   # #     # #
# ##### ### # # # # # ### # ####### # # #
#   # # #   #   # # # # # #   #     # # #
# # # # ######### # # # # ### # ####### #
# #   #         # #   # #   # # #   #   #
# ##### ####### ##### # ##### # # ### ###
# #   # #     #     # #   #   # #     # #
# # ### # ### # ### # ### # ### ####### #
#   #   # # # #   # # # #   #           #
##### # # # ####### # # ### # # # #######
#     # #       #   # # # # # # #       #
# # ########### # # # # # # # ###########
# #             # # #   #   #           #
#########################################
