####### ####################### #########
#   #  .#  . .#       #   #    .        #
# # ### # # # ####### # # # ### ### #####
# #   #.# #.#. . . .#   #   #  .  #     #
##### # # # # ##### ########### # ##### #
#     #.# #.# #   #.#  . .#  . .#   #   #
# ##### ### ### ### ### # ### # ##### # #
# #    . .#. .#   #. . .#. . .#   #   # #
# ####### # # ### ########### # # # #####
#       #.# #. .#             # # # #   #
####### # # ### ################# # ### #
#     # #.#   #. . . . .  #   #   #   # #
##### # # ##### ####### ### # # # # # # #
#   #   #. . .#     #. .#   #   # # #   #
# # # ####### ####### # # ### ### # # ###
# # #        . . . . .# # #   #   # #   #
# ############# ##### ### # ### ### ### #
#             # #     #   # #     #   # #
######### ### ### ##### # # ####### ### #
#         #       #     # #   #     #   #
# # ######### ### # # ####### # ##### ###
# # #       # #   # #       # # #     # #
### # ##### ### ### # ### ### # ####### #
#   # #   # #   #   # #   #   # #     # #
# # # # ### # ### # ##### # ### ##### # #
# # # #       #   # #   # # #       # # #
# # # ########### # ### # # # # ##### # #
# # #     #   #   # #   # # # #   #     #
# ####### ### # ### # ### # # ### # #####
#       #     # #   # #   # #   # # #   #
# # ### # # ### ##### ##### ### # # # # #
# # #   # # #       # #     #   #   # # #
# ####### ### # # # # # ### ##### ### # #
# #     # #   # # # # # #   #   # #   # #
# # # # # # ##### ### # ##### ### # ### #
#   # # # # #   #     #         # #   # #
##### ### # ### # ##### ####### # ##### #
#   #   # # #   #   # # #   #   #     # #
# # ### # # # ##### # # # # ######### # #
# #     # #       #   #   #         #   #
#########################################
