################################### #####
#    . . . .#      . . . . . . . . .    #
### # ##### # ##### ######### # ### # # #
#   #.#  . .# #. . .# #       # #   # # #
# ### ### ##### ### # # ####### # ### ###
# #  . .#. . . .# # #   #       # #     #
# ##### ######### # ####### ##### # ### #
#     #.#. . . .# #   #     #     # #   #
# ### # # ##### # ### # # ### ####### # #
# # # #.#. . .#.#   # # # #   #   #   # #
# # # # ##### # ### # ### ### ### # #####
#   # #. . . .#.  #   #   # #   # # #   #
##### # # ### # # ##### ### # # # # ### #
#     # #   # #.# #     #   # #   #   # #
# # ### ### ### ### ### # ######### # # #
# #   # #   #. .#   # # #         # #   #
##### # ##### ### ### # ######### # # # #
#     # #   #. .#   #   # #       # # # #
# ### # # # ### ### ##### # ####### # # #
# #   #   #   #. .#       # #       # # #
# ############### ### ##### # ##### # # #
#     # #    . . .  #     #   #     # # #
##### # # ### ##### # ############### ###
#   # #   #. .#   # #   #         #     #
# # ####### # ### # ##### ####### ### # #
# #  . . . .# #   # #     #     #   # # #
# ### ####### # ### # ##### ### ### ### #
#   #. . . .# #     #   #   # # # #     #
# # # ##### # ########### ### # # #######
# # #   #. .# #             #   #   #   #
### ### # ### # ########### ####### ### #
#     # #.#   #. . . .    #       #     #
# ### # # ##### ##### ##### ##### ##### #
#   # # #. . . .    #.#   #   # # #   # #
# # ### ####### ##### # # # # # # ### # #
# #   #   #   # #. . .# #   #   #     # #
# # # ##### # # # ######### ########### #
# # #       # # #. . . .  # #     #   # #
# ########### # ####### # ### # ### # # #
#           # #       #.#     #     #   #
####################### #################
