############################# ###########
#     #             #        . . .  #   #
# ### # ####### ### ### ##### ### # ### #
#   # # #       #   #   #     # #.#   # #
### ### ##### ##### # # # # ### # ### # #
# #     #     #   #   # # # #   #.  #   #
# # ##### ##### # ### ### # # ### # #####
# # #     #   # #   # #   # # #. .# #. .#
# ### # # # ### ### ### ### # # ##### # #
#     # # #     #       #     #.#. . .#.#
####### # ##################### # ##### #
#       #   #         #       #. .  #. .#
####### ### # ####### # ####### # ### # #
#     #   # # #     #     #     # #. .# #
# ### ##### ### ### ##### # # ### # # # #
# # #       #   #     #     # #   #.# # #
# # # ####### ####### ######### ### ### #
# # # #       #     #           #  . .# #
# # ### ##### # ######### ####### # # # #
# #     #     #           #       # #.# #
# ####### ################# ######### # #
#   #   # #       #         #. .#  . .# #
# ##### # # ##### # ######### # ### ### #
#       # #   #     #. . . . .#. . .#   #
######### ### ####### ############# # # #
#       # # #   #  . .# #           # # #
# ##### # # ### # # ### # ####### ### # #
# #   # # #   # # #. .#   #       #   # #
# # ##### ### # # ### ############# # ###
# #     #     # # # #. .          # # # #
# ##### ####### # # # # ######### ### # #
#     # #     # # # # #.#     #   #   # #
##### # # ### # # # # # ##### # ### # # #
# # #     # # # #   # #. . .#   #   # # #
# # ####### # ####### # ### ####### ### #
# #       #   #       # #. .  #   # #   #
# # ##### ### # ##### # # # ### # # # ###
# # #   #   #   #     # #.#     # #   # #
# # # ##### ########### # ####### # ### #
#   #                   #.#       #     #
######################### ###############
