####### #################################
#. . . .          #                     #
# ##### ##### ##### ### ######### ##### #
#.#     #   # #   # # #         # #   # #
# ####### # # # # # # # ##### # ### ### #
#.#. . .# #   # # # # # #     #   #   # #
# # ### ####### # # # ### ####### ### # #
#. .  #. .    # # # #     #     # #   # #
# ####### ### ### # ####### # # # ### # #
#       #.  #   # # #. . .  # # #   #   #
######### # # # # # # ### ### # ### ### #
#. . .#. .# # #   # #.#. .  # #   # # # #
# ### # # # ####### # # ##### ##### # # #
#.# #. .# #     # #. .#.#   #   #   # # #
# # ##### ##### # # ### # # # # # # # # #
#.#       #     #. .  #.# #   # # # # # #
# ######### ##### ##### # ####### # # # #
#.      #   # #. .# #. .#     #   # #   #
# ####### ### # ### # # # ### # #########
#. . . .#   # #.  # #.# # #   #         #
# # ### ### # # ### # # ### ######### # #
# # #. .  #   #.#   #.# #   #   #   # # #
# # # ### ##### # ### ### ##### # ### # #
# # #.#   # #. .  #  . .#     # #   # # #
# ### ##### # ######### ##### # ### # ###
# #. .#. . . .  #. . .#. .  # #     #   #
# # ### ######### ### # # # ### ##### # #
# #.#. .#     #. .#  .# #.#       #   # #
# # # ### ### # ##### ### ### # # #######
# #. .    # # #.#   #.#. .  # # #       #
# ######### # # # # # # # # # ######### #
#   #. . . .# #.# # #. .# # # #   #   # #
##### ##### ### # # # ### # ### # # ### #
 . . .#   #. . .# #   #   #   # #   #   #
####### # ##### # ##### ##### ##### # ###
#       #       #     #     #       #   #
# ##################### # ##### ####### #
# #   #       #       # # #   # #     # #
# # ### ##### # ##### ### ### ### ### # #
#   #   #       #           #     #     #
#########################################
