############### #########################
#            . .  # #. .        #       #
# ####### ### ### # # # ####### ####### #
# #       #  . .# #. .#. .    #         #
# ##### # ### # # # ##### ########### ###
#     # # #   #.# #.    #. . .      #   #
##### # # # ### ### ######### ##### ### #
# #   # # # # #. . .        #. .  # #   #
# # ### # # # # ### ######### # # # #####
#   #   # #   #   # #. . . .# #.# #     #
##### # ######### # # ##### ### # ##### #
#   # #   #   #   # #.# #. .#. .# #     #
# ### # # # # # ### # # # ### # ### # # #
#     # # # # # #   #.#  . . .# #   # # #
##### # # # # # # ### ######### # # ### #
# #   # # # #   # #. .#. .#     # # #   #
# # ### # ####### # # # # ####### ### ###
#   #   #       # #.# #.#. . .  #   #   #
##### ### # # # # # ### ##### # ### ### #
#     # # # # # # #. . .  #. .#   # #   #
# ### # # # ### ### ### # # # ##### #####
#   # #   #   #   #   # # #.# #. .#     #
# # ######### ### ### # ### ### # ##### #
# #         #   #   # #   #. . .#. .#   #
# ####### # ### # ### ### # ##### # #####
# #   # # #   # # #   #   # #   # #. . . 
# ### # # # ### # # # # # # ### # # #####
#     # # # #   # # # # # #     # #     #
####### ### # ##### # # ######### ##### #
#     #     #     # # #     #     #   # #
# ### ### ######### # ##### # ### # # # #
# #   #   #         #   #   # #   # # # #
### ### ### # ########### ### ##### # # #
#   #   #   # #     #     # # #     #   #
# ##### # ### # ##### # ### # # #########
# #     # # # #       # #   # #     #   #
# ### ### # # ########### ### ####### ###
# #   #   # #             #   #     # # #
# # ### ### # ### ######### ### ### # # #
#   #       #   #         #       #     #
#########################################
