########### ############### #############
#     #   #.# #   #     #  . .    #. . .#
# ### # ### # # # # ### # # # ### # ### #
#   # # #. .# # #   #     # #.#   #.#. .#
##### # # ### # ### ####### # ##### # # #
#     # #.# #   #   #       #. . . .#.# #
# ##### # # ######### ####### ### # # ###
# #     #.#. .#       #. . .#   # # #. .#
# # ##### # # # ####### ### ### # ##### #
# #. . . .#.#.#   #. . .# #.# # #   #. .#
# # ####### # ##### ##### # # # ### # # #
# #.#    . .#. . .#. . .# #. .#   # #.# #
# # ##### ####### # ### # ### ### ### # #
# #.#. . .# #. . .# #. .# # #.# # #. .# #
# # # ##### # ##### # ### # # # # # # # #
#  . .#. . . .# #   #. .# #. .#   #.# # #
####### ####### # ##### # # ####### # # #
#   # #.#  . . .# #. . .#. .#. . . .# # #
# # # # # # ### ### ##### ### ####### # #
# #   #.# #.#  . . .#    . . .#       # #
# ##### ### # ########### # ### ####### #
#   #  . .#.# #         # # #   #       #
### ##### # # # ######### # # ### #######
# #   #  .#.# # #       # # # #   #   # #
# ### ### # # # # ### # ### # # # # # # #
#   #    . .# # # #   # #   # # # # #   #
### ######### # ### ### # ### # # # ### #
#   #         #     # #   #   # #     # #
# ### ####### ####### ####### ### # # ###
# #   #       #             #   # # #   #
# ### # ####### ########### ### # # ### #
# #   # #       #               # #   # #
# # ### # ####### ######### ##### ### ###
#   #   # # #     #   #     #     # #   #
##### ### # # ####### # ##### # # # ### #
#     #   # #     #   # #     # #   #   #
####### ### ####### # ### ########### # #
#       # # #       #     #   #       # #
# ####### # ### ########### # # ####### #
#         #     #           #   #       #
#########################################
