####### #################################
# #    . .#. .        #       #         #
# # ### # # # ####### ##### ### ### ### #
#   #   #. .#. .    #           # #   # #
############### ### # ########### ### ###
#. . .#. . .#. .# # #       #       #   #
# ### # ### # ### # ####### # ##### ### #
#.# #. .#  .#.#   #     #   # #   #   # #
# # ####### # # ####### # ### # # # # ###
#.#        . .#         # #   # # # #   #
# ########### ############# ### # ##### #
#. . . . .#   #             #   # #   # #
# ####### # ### ######### ####### # # # #
#   #   #.#   #. . . .  #         # # # #
# # ### # ### # ##### # ########### ### #
# #     #. .# #.  #. .# #         #   # #
# ######### # # ### # # # ####### ### # #
#   #  . . .# #.#. .# #         #     # #
##### # ### ### # # # ################# #
#     #.#   #. .#.# #           # #   # #
### ### ##### ### ############# # # # # #
#   #  . . .#.# #. . .#   #     #   # # #
# ### # ### # # ##### # # # ######### # #
# #   #   #. .  #. . .# #   #       #   #
# # ####### ##### ### # ########### #####
# # #     # #   #.#   #           #   # #
# ### ### # ### # # ############# ### # #
#     # # #     #.# #. . . .    #   #   #
# ##### # ####### # # ##### ### ### ### #
#   # #   #  . . .# #.    #. .#   #   # #
### # ####### ####### ####### ### ##### #
# #   #    . .#. . . .  #. . .# #   #   #
# ##### ### ### ####### # ##### ### # ###
#       #  . . .    #   #. . .#     #. . 
### ### # ######### ##### # # ####### ###
#   #   # # #     #     # # #. . .#. .# #
# ####### # # ####### # # # ##### # ### #
#   #   #   # #     # # # #     #. .  # #
# # # # ##### # ### # # # ############# #
# #   #       #   #   # #               #
#########################################
