########################### ### #########
#   #              . .#  . .  #.#   #   #
# ### ############# # ### # ### # # # # #
#   # #. . . . . . .#. . .# #. .# # # # #
### # # ##### ############# # ### # # # #
#     #.#     #. . . . . .# #.#   # # # #
####### ####### ######### # # # ##### # #
#      . .    #. . .# #. .# #.  #     # #
# # # # # ######### # # # ### ### ##### #
# # # # #. .#. . . .  #.# #. .#   #   # #
# ### # ### # ######### # # ### ### ### #
#   # # # #. .  #. . . .# #.    #   #   #
### # # # # # # # ### ##### ##### # # ###
#   # #   # # # #. .# #. . .      # #   #
# ### ##### ### ### # # ########### #####
#   #     #   # #. .# #.        #   #   #
# # ##### ### ### ##### ##### ### ### # #
# #     #   #   #. . . .    #   # #   # #
# # ### ### ### ########### ### ####### #
# #   #   #   #     #   #     #   #   # #
# ### ### ### ##### # # ######### # # # #
#   # # #   #     #   #         # # #   #
# ### # # # ##### # ####### ### # # #####
# #   # # #     # #   #   # #   #   #   #
# # ### ##### ### ### # # # # ######### #
# #     #   #   #   # # # # # # # #     #
# ####### # # ### ### # # # ### # # #####
#       # # #   #   #   # #       # #   #
# # ##### # ### ### ####### ### ### # # #
# #       #   #   #       #   # #   # # #
# # # ##### # ### # # ####### ### ##### #
# # # #   # #   # # #       #           #
# # ### # ### # # # #####################
# #     # #   # # #     #     #         #
# ##### # # ### # ##### # # # # ####### #
#     # # # #   #     # # # # #     # # #
### # ### ########### # # # ####### # # #
# # # #   #     #   # # # #       # # # #
# # # # ### ### # # # ### ######### # # #
#   # #       #   # #               #   #
#########################################
