####################################### #
#   #       #          . . . . .# #  . .#
# # ### # # ####### ### ####### # # # # #
# #     # #     #   #  .#   #. .#   #.# #
# ####### ##### # ##### # # # ####### # #
#   #     # #   #   #. .# #  .#    . .# #
# # # ### # # ##### # # ##### # ### ### #
# # #   # # #       #.# #   #.# #. .#   #
### ### # # ### ##### ### # # ### # #####
#   #   # # #   #   #. .# # #. . .# #. . 
# ######### ##### # # # # # ##### ### ###
#   #       #     #   #.# #       #. .# #
# # # ####### ######### ########### ### #
# # #         #   #    . . .  #. . .  # #
### ####### ### # # ### ### # # ####### #
#   # #     #   # # #   #. .# #.#   #   #
# ### # ##### ### ### ### # ### # ### ###
#     # #     #       #  .# #. .# #   # #
####### # # ####### ##### # # ### # ### #
# #     # # #   #   #  . .# #.# # # # # #
# # ##### # # # ##### # ### # # # # # # #
# # #     # # # #     #.#   #. . .# # # #
# # # # ##### ### ##### ######### # # # #
# # # #     # #   #    . . .    #.# #   #
# # # ##### # ### ######### ##### # # ###
#   #   # # #   #     #. . .  #. .# # # #
####### # # ### ##### # # ##### ### # # #
#     #   #   # #     #.# #. . .    # # #
### # ######### # ##### ### ### ##### # #
#   #   #     #   #    . . .  # #       #
# ##### # ### ##### ### # ### ### #######
#   #     # #     # #   # # # #   # #   #
########### ##### # # # # # # # ### # # #
#               #   # # # #   #   #   # #
######### ##### ####### # ####### ##### #
#         #   #   #     #         #     #
# ####### ### ### # # # # ######### #####
#   # #   #   #     # # #       #   #   #
# # # # ### ######### # ######### ##### #
# # #   #             #                 #
#########################################
