####################################### #
#                                    . .#
# ######### ############# ########### # #
# #       # #         #   #  . . . . .# #
# # ####### ##### ### ### # # ### ##### #
#     #     #     #       # #. .# #   # #
####### # ### ### ####### # ### ### ### #
#   #   # #   #   #       # # #. .# #   #
# ### ### ### ##### ####### # ### # # # #
# # #   #   #   #   #   #     #. .# # # #
# # ### # # ### # ### # ####### ### # # #
# # #   # # #   # #   #        .#   # # #
# # # ##### ##### # ########### # ### # #
#   #   #   #     # #      . . .#     # #
# ##### # ######### ####### #############
#     # #   # # #       #  . . . .      #
##### # ### # # # # # # ### ##### ##### #
#     #   #   #   # # #   #     #.#   # #
##### ############# # ### ####### # ### #
#         #     #   #   #   #. . .#     #
# ####### # ### # ##### # # # ###########
# # #   #   # #   #   # # # #. .#. . . . 
# # # ####### ### # ### ### # # # #######
# #     #   #   # #   # #   # #.#. .#   #
# ##### ### ### ##### # # ### # ### ### #
#   # #     # #   # #   #   # #. .#. . .#
### # ##### # ### # # ### # # # # ##### #
# # #     # #   # #   #   # # # #.  #. .#
# # # ### # ### # ##### ### # # # ### ###
#   # #   # # # #   #   #   # # #. . .# #
##### ##### # # ### ### # ### # # # ### #
#   #   #   # #   #     # #   # # #   # #
# # ### ### # ### ######### ### # ##### #
# #   #                     # # #     # #
# ############# # ####### # # # ##### # #
#   #       #   # #       # #   #   #   #
### # # ### ##### # ####### ##### # ### #
# # # # # #   #   #   #   # #     #   # #
# # ### # ### ### # # ### # ######### # #
#       #         # #     #           # #
#########################################
