########### ####################### #####
#   # #   #.#  . . . . . .#        .    #
# ### # # # ### ######### # ####### #####
# #   # # #. .#.#     #  .#     # #. . .#
# # ### ##### # ##### ### ##### # # ### #
# # #       #.#. .  #   #. . .#   #   #.#
# # ####### # ### ##### ##### ######### #
# #       # #. .#. . .#   #  . . .#. . .#
# ####### # ### # ### ### ####### # ### #
#         # #  .# #. .  # #     #.#. .# #
# ####### # ### ### # # # # ### # # # # #
# #       #    . . .# # #   #  . .# #.# #
### ##### ##### ##### # ####### ##### # #
#   #         # #     # #      .#. . .# #
# ### ####### ### ####### ##### # ##### #
#   # #     #     # #   # #    . .#     #
##### # ### ####### # # # # ##### # #####
#     # #         # # # # #   #   # #   #
# ##### ######### # # # ##### # ### # # #
# #       #     # # # #       # #     # #
# ##### # ##### # # ########### ##### # #
#     # #     #               #     # # #
### # # ### ################# ### # ### #
#   # #   # #   #       #       # #   # #
# ##### # # # ### ####### ##### ##### # #
# #   # # # # # # #       #           # #
# # # # # # # # # # ####### ########### #
# # # # # #   #     # #     #           #
# # # ### ########### # ##### ####### ###
# # #     # #         # #     #     #   #
# # ####### # ######### # ### # ### # # #
# #       # #   #       # #   #   #   # #
# ####### # ### # # ####### ########### #
#       #   # # # # #     #         #   #
# ##### ##### # # # ##### # ####### ### #
#     #   #     # #   #   #       # #   #
##### # # ### ### ##### ######### # # ###
#   # # #   #   #       #       # # #   #
# ### ##### ### ############### ### ### #
#     #     #                       #   #
#########################################
