# #######################################
#. . .#. . . .          #. . .      #   #
# # # # ##### ########### ### ##### ### #
# # #. .#   #.#. . . . . .  #. . .#   # #
# # # ### ### # ################# ### # #
# # #     # #. .  #. . . . . . .#.  #   #
# # ####### # ##### ########### # # ### #
# # #     # #     #.#  . . . .#.#.#   # #
# # # # ### ##### # ### ##### # # ### ###
# # # #     # #   #. .#. .# #.#.#.  #   #
# ### ####### # ### # ### # # # # ##### #
#   #   #     # #   #. .#. .#. .#. .  # #
# # ### # ##### # ### # ### ####### # # #
# #   # # #     # #   #.#  . . . . .# # #
# # ### # # ##### # ### ### ####### # # #
# #     # # #   # # #  . .# #     # # # #
# ### ### # # # # # # ### # ##### ### # #
#   #     # # #   # #   #.#   # #   # # #
# # ####### # ### # ### # ### # ### ### #
# #     #   #   # # #   #. .# # #   #   #
####### ### ### # # ####### # # # ### # #
#     # #     # # #       #.# #       # #
# ### # # ### # ######### # # ######### #
# #     #   # #   #       #.#       # # #
# ##### # # # ### ######### ### ### # # #
#   #   # # #   #   #  . . .  #   # #   #
# # ##### # ####### # # ### # ### # #####
# #   #   #       # # #.#   #   # #     #
##### # ####### # # # # # ##### ####### #
#   # # #   # # # # # #.#     #     #   #
# # # # # # # ##### # # ##### ####### # #
# # # #   # # #     # #. . .#     #   # #
# ### ####### # ##### # ### ####### ### #
#   # #       # #     #   #.  #     # # #
### ####### ##### ######### # # ##### # #
# # #     # #     #    . . .# # #   #   #
# # ##### # # # ### ### ### # ##### #####
# #     #   # #   # #  . .# #   #   #   #
# ##### ### ##### # ##### # ### # ##### #
#                 #     #.#   #         #
######################### ###############
