################################# #######
# #               #        . . . .      #
# # # ########### # ####### # ### # ### #
# # # #     #. . .#   #. . .# #   # #   #
# # # # ### # ### ### # ##### # ### #####
#   # #   # #.#  . .# #. . .# #   #     #
##### # ### # ##### ### ### ##### ### ###
#   #   #   #.#   #. .#   #. .  #   #   #
# # # ### ### # ##### ##### # ##### # # #
# # #   # #  .#     #. . .# #.#     # # #
# ### # # ### ##### ##### # # # ####### #
#   # # #   #. .  # #   #.# #.# #       #
### ### ##### # # # # # # ### # # ### # #
#       #     #.# # # #. .#. .# # #   # #
######### ##### # # ### ### # ### ##### #
#         #    .# #    . .#.# #   #     #
# # ########### ######### # # # # # #####
# # #   #. . . .#        . .# # # # #   #
# # # # # ####### ######### # # ### ### #
# # # # #. .#     #   #. .# # #   #   # #
### # # # # ####### ### # # # # # ### # #
#   # # # #. . .  #. . .#.# # # #   #   #
# ##### ####### ### ##### ### ### # ### #
#       #. . .#. . .    #. .# #   #   # #
######### ### # ####### ### # # ##### ###
#   #  . .# #.#   #. .# #. .# # #   #   #
### # # ### # ##### # # # # # ### # ### #
#   # #. .#  . .#. .#.# #.# #     #   # #
# ### # # ##### # ### ### ########### ###
#     # #. .# #. .# #. .#. . . . .  #   #
########### # ### # ### # ####### # ### #
 . . . . .#.#   # # #. .# # #. .#.# #   #
######### # ### ### # ### # # # # ### # #
#     #. .#.  #   #  . .#   #.#. .#   # #
##### # ### # ### ##### ##### # # # # # #
#   #  . . .# #     #  . . . .# # # # # #
# # ######### ##### ### ######### # ### #
# #       #   #   #   # #     #   # #   #
# ####### # # # ##### ### ### # ##### # #
#       #   # #           #     #     # #
#########################################
