##### # #################################
#. . .#.#  . .#   #   #   #   # #       #
# ### # ### # ### # # # # # # # # # ### #
#.#   #. .#.#. . .# # # #   # #   #   # #
# ####### # ##### ### # ####### ### ### #
#. .  #. .#. .# #.#   #         #   #   #
# # ### ##### # # # ### ######### ### ###
# #. .#. . . .#. .# # # #   #   # #   # #
##### ######### ### # # ### # # # # ### #
#. . .  #   #. .    #       # # # #   # #
# ##### # ### ####### ####### # ##### # #
#.#     #. . .          #   # #     # # #
# # ##### ########### ### # # ##### # # #
#.# #. . .          #     # # #   # #   #
# # # ######### ### ######### # # # #####
#.# #.#   #       #       #   # # # #   #
# ### # # ######### ####### ##### ### # #
#. . .  # #       #         # #   # # # #
# # ####### # ### ########### ### # # # #
# #     #   # #         #       #   # # #
# ### ### ### # ####### # ##### # ### # #
#   #     # # #       # #     #       # #
# # ####### # ##### # ### ##### #########
# #         #     # #         #   #     #
# ##### ##### ### ########### ##### ### #
#   #       #   #           #   # # # # #
### # # ##### # ####### ### ### # # # # #
#   # #     # #       #   #   # #   # # #
##### ### # ### ##### ### ### # ##### # #
#       # #   #     #   #   # #       # #
# # # # ##### # ### # ##### # ####### # #
# # # #     # #   # #   #   #       #   #
# ### ##### # # # ##### ####### # # # ###
# #   #   # # # #     # #     # # # #   #
# # ### # # # ### ##### ##### ### # #####
# # #   # # #   # #     #         #     #
# # ### # ##### ### ########### ####### #
# # #   #   #   #   # #         #     # #
# ######### # ### # # # ######### ##### #
#         #   #   # #   #               #
#########################################
