##### ###################################
#    . .#. .  #. . . . .    #. . .      #
# ### # # # ### ##### # ##### ### ### ###
# #   #. .#. . .    # #. . . .  #.# #   #
# ################# ############# # ### #
#           #. . .#           #. .#     #
########### # ### ############# # ### # #
 . . .  #   #.#  . . . .#  . . .#   # # #
##### ### ### ######### # # ### # # ### #
# # #.#   #. .#       #.# #. .# # #   # #
# # # # ### # # ####### ### # # ### # ###
# # #.#   #.# #       #. .# #.#   # #   #
# # # ##### ######### ### ### ### # ### #
# #  . . .#. . .#     # #. .#. .# #   # #
# ####### ### # # ##### ### # # # ##### #
#   #   #. .# #.# #   #    .# #.#   #   #
### # ##### # # # # # ##### ### ### # # #
#   #. . . .# #.# # #      . . .  # # # #
# ### ######### # ##### ### ####### # ###
# # #.#      . .#   #   #   #       #   #
# # # ####### # ### # # # ### ####### # #
# #  . .#. . .# #     # # #       #   # #
# ##### # # # # ### ##### # ##### # ### #
#   # #. .# # #   # #     #   #   # # # #
### # # ### # # # ### ######### ##### # #
#   #   #   # # # #   #   #   # # #   # #
# ####### ### # # # ### # ### # # # ### #
#         #   # # #   # #   #   #       #
########### # # # # # ##### ########### #
#     #     # # # # #       #       #   #
# ##### # ### # # ### ############# # # #
# #   # # #   # #   #       #     #   # #
# # ##### # ### # # ######### # #########
# #     # #   # # #           #   # #   #
# ##### # ### # ### ##### ####### # # # #
# # #   #   # #   #     #       #   # # #
# # # ##### # # # ##### ####### # ##### #
# #         # # #     # #     # #   #   #
# ########### # ##### ### ### # ##### ###
#             #     #     #   #         #
#########################################
