############# # #########################
#       #   #.#. . . . . . .    #     # #
##### # ### # ########### # ### # ### # #
#     #   # #.#. . . . .# #. .#   # #   #
######### # # # ####### # # # ##### #####
#       # #  . .#      .# # #. . . . . .#
# ##### # ##### ####### # ############# #
# #   #     #   #     #.# #         #. .#
### # ##### # ### ### # # # ######### # #
#   #   #   # #   # # #.#   #      . .# #
# ### # ### ### ### # # ########### # # #
# # # #   #     #   #  . .#  . .#. .# # #
# # # ### ####### ####### ### # # ### # #
# # # #   # #   #       #. . .#.#.#   # #
# # ### ### # # # ############# # ##### #
# #     #     # #         #. . .#. . .# #
# ####### ####### ####### # ######### ###
#   # #   # #   # #   # #  .#  . . .#. .#
### # # ### # # ### # # ### ### ### # # #
# #         # #     #      . . .# #.# #.#
# ### ####### ######### ### ##### # ### #
#   # #       #         # # #   #  . .#.#
### # ######### ####### # # # # ##### # #
# # #           #       #   # #   # #.#.#
# # ########### ############# ### # # # #
#   #         # #     #   #   #   #  . .#
# ### ####### # # ### # ### ##### ### # #
# #   # #   #   #   #   #   #         # #
# ### # ### ####### ##### ### ######### #
# #   # #   #     # #       # #   #     #
# # ### # ####### # ##### # ### # # ### #
#   #     #     # #     # #     # #   # #
##### ##### # # # ##### ############# # #
#     #   # # #     #   #             # #
# ####### ### ##### # ### ### ####### # #
#       #   #     # # #   #   #       # #
####### ### ####### # # ##### # ####### #
#     # #         #   # #     # # #     #
# ##### ### ##### ### ### ### # # # #####
#           #             #   #   #     #
#########################################
