######### ###############################
#        . .        #     #     #       #
# ####### # ### # ### ### ### # # ##### #
#   #     #.  # # #   # # #   # # #     #
##### ##### # # # # ### # ##### # # #####
#     #. . .# # #   # #   #   # # # #   #
# ##### ##### # ##### ####### # # # ### #
#     #. .#   #               # # #   # #
######### ########### # ####### ##### # #
#. . . .#. .    #   # #         #     # #
# ##### ### ### # # # ### ####### ##### #
#. .# #. .#. .# # # #   #           #   #
# # # ### ### # # # ### ############# ###
# #.#    . .#.#   #   #   # #     #   # #
# # ####### # ### # ##### # # ##### ### #
# #. .#. .#.#.  # #     # #     #   #   #
##### # # # # # # ### # ### ### # ### # #
 . .#. .#.#.#.# #   # #       #   #   # #
### ### # # # # ### ######### ##### ### #
# #. .# #.#. .#   # #       #         # #
# ### ### ### # # # # ##### ########### #
#    . .#. .# # # # #     #     #       #
####### ### # # # # ######### ### #######
#   #  . .#.# # # #             #       #
# # ##### # # # ######### ##### # ##### #
# #      . .# #         #   #   #   #   #
############# # ##### # ### #############
#             #     # #   #       #     #
# # ################# # ##### ##### ### #
# # #   #       #     #     #         # #
# ### # # ##### # ### ### # # ######### #
#     # # #       # #   # # # #     #   #
# ##### # # ### # # ### # # ### ### # ###
#   #   # # #   # #     # # #   # #   # #
##### ##### # ### ####### ####### ##### #
#     #   # # # # #           #         #
##### # # ### # # # ####### ### # #######
#   # # #   #   # #   #     #   #   #   #
# # ### ### ##### ### # ##### ####### # #
# #     #         #   #               # #
#########################################
