######### ###############################
#        . .            #         #     #
# ### ##### ##### ### ### ####### # ### #
# #   #   #.#   #   #   # #   #   # # # #
### # # ### # # # # ### # # # ##### # # #
#   # #   #.# # # #   # # # # #       # #
# ####### # # # # ##### # # # # #########
# #     # #.# # #     # #   #           #
# # ### # # # ####### # # ############# #
#   # #   #.#         # #   #   #     # #
##### ##### ############### # ### ### # #
#  . . . . .  #   #. .    # # #   # # # #
### # ####### # ### # ### # # # ### # # #
#. .# #. . .# # #. .#.#   # # #   #   # #
# ### # ### # # # ### ##### # # #########
#.#   #.# #.#   #. .#. . . . .  #       #
# ##### # # ####### ######### ### ##### #
#. .  #.# #. . . . .  #. . .#. . . . .# #
# # ### # ##### # ### # ### ##### ### # #
# #. .#.#     # # #   #.# #. . .#   #.# #
# # # # ##### # # ##### # # ### ##### # #
# # #.#.  #   # # #. . .# # #  . . . .# #
# # # # ### ### # # ### # ### ### # ### #
# # #. .    #   # #.#   #   # #   # #   #
# ########### ##### # ##### ### ### # # #
#   #       #   #. .#   #     # #   # # #
# # # ##### ### # # ### ##### ### ### ###
# #       # # # #.#   #   # # #   #     #
# ######### # # # ####### # # # ####### #
#     #     #   #.#       #     #       #
##### # ##### ### # ############# # # # #
#   # # #   # #  .#         #   # # # # #
### ### # # # # # ######### # # ### ### #
# #     # # # # #. . . .  #   # #   #   #
# ### ### # ### # ##### # ####### # # ###
#     #   #   # # #   #.#   #     # #   #
####### ##### # # ### # ### ##### #######
#       #   #   #   # #. .#   #   #     #
# ####### ##### # # # # # ### ##### ### #
#       #       # #   # #.  #       #   #
######################### ###############
