####### #################################
#   #  .  #. .  #. . . .        #   #   #
# # # # ### # ### ##### ##### ### # ### #
# # # #. .#.#. .#.#   #.    #   # #   # #
# # # ### # ### # # # # ####### ##### # #
# # #   #.#.  #. .  # #. . .  # #     # #
# # ### # # ##### ######### # # # ##### #
# #   # #. .#. .# #. . . . .# #   #     #
# ##### # ### # ### ############### #####
#       #   #.#. . .#. . . . .    #. . . 
##### # # # # ##### # ####### ##### #####
# #   # # # #.#     #. . . .#.  #. .#   #
# # ### ### # # ########### # ### ##### #
#   #   #   #.# #     #   #.#. . .      #
##### ### ### # ##### ### # #############
#     #   #  .#       #   #.#           #
# ##### # # # ######### ### # ######### #
# # #   # # #.#. . .    # #.# #   #   # #
# # # ### # # # ### ##### # # # # # # ###
# #   #   # #. .# #.    #. .#   #   #   #
# ##### # # ##### # ##### ####### ##### #
# #     # #   #   #. . . .  #         # #
### # # # # # # ### # ####### ####### ###
#   # # # # #     # #               #   #
# ##### # ######### ### ### ##### ##### #
#     # #   #   #     #   #     #   #   #
# # # # ### # ### # # ### ##### ### # ###
# # # #   #   #   # #   #     # #   #   #
# # # ### ##### # ### ### ##### ####### #
# # #   #     # # #   #   #     #     # #
# ##### ##### # # # # # ### ##### ### # #
#     #   #   # # # # # #   # #   # # # #
# ### ##### ### ### ### ##### # ### # # #
#   # # #   #     #   # #     # #   # # #
##### # # ### ### ### ### # ### # ### # #
#   # # # # # #     # #   #     # # # # #
# # # # # # # # ##### # ######### # # # #
# #   # # #   #     # #       #   # # # #
# ##### # ######### ### # ### # ### # # #
#       #         #     #   #   #     # #
#########################################
