##### ############### ###################
#   #.#        . . . .                  #
# # # # ####### # # # ##### ### ##### ###
# # #.# #    . .# # #     #   #     #   #
# ### # ##### ##### # ### ##### ### ### #
#. . .#   #  .# #   # #   #       #   # #
# ####### ### # # ##### ### ### # ##### #
#.    #   #. .#   #     #   #   #   #   #
# ##### ### # ##### ### # # ####### # # #
#.#     #. .# #     #   # #     #   # # #
# # ##### ##### # ### ### # ### # ### ###
#.# # #. .#     # #   #   #   # # #     #
# # # # ### ##### # ### ####### # ##### #
#.#   #. .#     # # #         # # #   # #
# ####### ##### # # ### ##### # ### # # #
#. . . .#. . .# # #   # #   # #   # #   #
####### ##### # # # # # # # # ### #######
#     #.#. . .# # # # # # # #   #       #
##### # # ### # # # # # ### # # ### #####
#   #. .#.#   # # # # #     # #   #     #
# # # ### # ### # ### ######### # ##### #
# # #. . .# #   #   # #       # #     # #
# # ##### # ####### # # ##### # # ### # #
# #   #   #   #     #   # #   # #   # # #
# ##### # # # ########### # ####### # # #
#       # # #         #   #   #     # # #
##### ### # ##### ### # ####### ####### #
#   # #   #   # #   # #     #   #     # #
# # ### # # # # # # # # ### ##### ##### #
# #     # # #   # # # #   #     #     # #
# ####### # # # # # ### ############# # #
#       # # # # # #     #           # # #
### ### # # # ### # ##### ######### # # #
# #   # # # # #   #     # #     # #   # #
# ##### # # # # ####### # # ### # ##### #
# #     # # # #       #   # # # # #     #
# # ####### # ####### ##### # # # # # ###
#   #       #   #   #   #   # # # # # # #
##### ##### # # ### # ### ### # # # # # #
#     #     # #     #         # #   #   #
#########################################
