##################### ###################
#. . .#       #      . .  #     #       #
# ### ####### ####### # # # ### # ##### #
#.#  . . . .#     #   #.#     # #   # # #
# ######### ##### # ### ##### # ##### # #
#. .#   #  . .# #   #  .    # #       # #
### # # ##### # ##### # ### # ##### # # #
#. .# #      . . .#   #. .# #   # # #   #
# # # ########### ####### # ### # ##### #
#.# #   # #   #  . . . .#.#   # #     # #
# ##### # # # ######### # ### # ##### ###
#. . .# # # #   #      . .  # #     #   #
# ### # # # ### # ####### ### ### ##### #
# #. .#   # # # # #       #   # #     # #
# # # ##### # # ### ####### # # # # # # #
# #.#     #   #     #       # # # # # # #
# # ################# # # # # # # # ### #
# #. . .# #           # # # #   # #     #
# # ### # ####### ####### # # ### # #####
# #   #.#         #       # # # # # #   #
# ### # ######### # ####### # # # # # ###
# #   #.        # # #   #   #   # #   # #
# ##### ####### ### # ### ####### ##### #
#     #. . .  #   #   #   #   #   # #   #
##### ##### ##### ##### ### # ### # # ###
 . .#     #.#   #     #   # #     #   # #
### ####### # ##### # # # ######### ### #
#  . . . . .#     # # # #         # #   #
# ####### # ##### # # ##### # # ### # ###
# #   #   # #       # #   # # #     #   #
### # ##### ##### # # # # # # ######### #
#   #     #   #   # # # # # #         # #
# ####### ### # ### # ### # ########### #
# #     #     #   # # #   #       #   # #
# # ### ######### # # # ##### ##### # # #
# # # #   #   # # # #   #   #       #   #
# ### ### # # # # # # ### # # ###########
# #     #   #   # # # #   # # #     #   #
# # ########### ### # ##### # # ### ### #
#             #     #       #     #     #
#########################################
