############################### #########
#           # #                . .      #
##### ##### # # ### ####### ##### #######
#     #   # # #   # #   #   #. . .  #. . 
# ##### # # # ### # # # # ### ### ### ###
# #     # #     # #   # # #. .#   #. .  #
# ####### ### # ######### # ### ### #####
# #     #     # #         #.#   #. .#   #
### ### # ##### # ##### ### ##### ### # #
#   #   #     # #   #   #. .#. . .#   # #
# ##### ####### ### ### # ### ######### #
# #   #         #   #   #.#. .#. . .# # #
# # # ####### # ##### ### # ### ### # # #
#   # #   #   # #     #. .#.#  .# #. . .#
####### # # ### # # ### # # ### # ##### #
#       # # #     # #  .# #. . .# #. . .#
# ####### ### # ### # # ######### # #####
# #     #     # #   # #. .    #. . .    #
# # ########### # ### ### ##### ### ### #
# # #           # #     #. . . .  #   # #
# # # ########### ### # ### ### # ### ###
# #   #   #         # #   #   # #   #   #
# ##### ### ####### # ### ### # # ##### #
#   #     # #       #   # # # # #     # #
# ### ##### ### # # ### # # # ##### ### #
#         # #   # #   # # # #   #   #   #
# # ##### # # ######### # # ### ##### # #
# #   #   # # #       # # #   #     # # #
# ### ##### # ####### # # ### ### # # ###
#   # #   # #       #   #   #     # #   #
# # # # # ### # ########### ### ####### #
# # # # #   # #       #       # #     # #
# ### # ### ####### ### # # # ### ##### #
#   # # #         #   # # # # #   #     #
### ### ######### ### # # # ### ### #####
#   #   #   #   # #   # # #     #   #   #
# ### # # # # # # ##### # ####### # # # #
# # # # # # # #   #   # #   #     #   # #
# # # ### # ### ##### ### # ########### #
#   #   # #               #           # #
#########################################
