####################################### #
#     #   #               #            .#
# ##### # ### ##### ##### # ##### ##### #
# #     #     #     #     # #     #  . .#
# ############# ##### ### ### ##### # # #
#   #   #     # #   # #       #   # #.# #
### # # ### # # ### # ########### # # ###
#   # #     # #     #   #    . . .# #. .#
# ### ####### ######### # ### ### ### # #
# #   #                 # #. .# #. .# #.#
# # ### ######### ######### # # ### ### #
# #   # #         #  . . . .# #    . .#.#
# # # ### ####### # # ############### # #
# # # #   # #   # # #. . .#          .#.#
# # # # ### # # ### # # # ########### # #
# # # #   # # #     # # #. . . .#. .#. .#
# ### ### # # # ### # ### ##### # # # # #
# # #   #   # # #   #   #     #. .#.# # #
# # # ####### # # # # # ########### ### #
# #   #       # # # # #   #   #   #. .# #
# ##### # ##### # ### # ### # ### # # ###
#   #   # # #   #   # #     #     # #. . 
### # ### # # # # # ### ########### #####
#     #   # # # # #   #     #     #     #
######### # # ### # # ##### # ##### # # #
#         #   #   # #     # #     # # # #
# # ##### ##### ### ##### # ##### # ### #
# #     # # #   #   #   # #     # # #   #
# ### # # # # ### # # ### # ##### ### # #
#   # # # #   # # # # #   #       #   # #
# # # ### ##### # ### # ########### # # #
# # #   #       # #   # # #       # # # #
# # ### ##### ### # ### # ##### # # ### #
# #   #   #     #   #   #     # #   #   #
# ### ### # ### ##### # ##### # # ### # #
# #   #   # # # #   # #   #     # #   # #
### ####### # # ### # ### ### ##### #####
#   # #     #   # # #   #   # #     #   #
# ### # ######### # ### ### # # ##### # #
#     #             #   #   # #       # #
#########################################
