### #####################################
#. .    #     #. . . .            #     #
# ##### # ##### ##### ##### # ### # ### #
#. . .# #  . . .    #. .  # #   #   # # #
# # # # ### ####### ### # # ### ##### # #
# # #.#   #.#     # #. .# #   #       # #
# # # ### # # ### # # # # ######### # ###
# # #.# # #.# #   # #.# #   #     # #   #
# # # # # # ### ### # # ### ##### # ### #
# # #.#   #.#   #   #.#   #   #   # #   #
# # # ##### # ### ### ### ### ### ### # #
# # #. . . .  #   #  .  #   #   #     # #
# # ########### ##### # ####### ####### #
# #   #   #. .# #. . .# #       #       #
# ### # # # # # # ##### # ####### #######
#   # # # #.#.# #.#     # #     # #     #
# ### # ### # ### # ##### # ### # # ### #
# #   # #. .#.#. .# #   # #   #   # # # #
# # # # # ### # # # # ### ######### # # #
# # # # #.#  . .# #   #     #         # #
# # ### # ####### ##### # ### ######### #
# #     #. . .#   #   # # #         #   #
# ####### # # ####### # # # ####### # ###
#     # # # #. . . .#   # # #     # # # #
# # # # # # ####### ####### # ### # # # #
# # #   # #       #.        # #   # # # #
### ##### ####### # ######### ######### #
#       #       # #. .    #. . .      # #
# # ########### ##### ##### ### ##### # #
# #           #     #.  #. .  #. .  #   #
# ################### # # ####### ##### #
#     #   # #  . . . .# #.# #   #. .  # #
### # # # # # # ####### # # # # # # # ###
# # #   # # # #.#       #.  # # # #.#   #
# # ##### # # # ######### ### # ### ### #
#       # # # #. . . .  #.#   # #. .  # #
### ##### # # ####### ### # ### # ##### #
# #     # # # #     #. . .#   # #.# #   #
# ##### # # # ##### # ####### # # # # # #
#       #   #       #         # #.#   # #
################################# #######
