################################### #####
#     # #     #          . . . .#  . . .#
# ### # # ### # ######### ##### ####### #
# #   #     # # #    . . .#   #.#. . . .#
# # ####### ### ##### ##### ### # ### # #
# #     # #   #     #. .#   #. .#.#   # #
# ##### # ### ##### ### # ### ### ##### #
# #   #  . . . . .#   #.#   #. . .#     #
# ### ### ####### ### # ### ### ### # # #
#     #  .#     #. .# #.  #     #   # # #
######### # ### ### ### # ####### ##### #
#  . . . .# # #    . . .#   #     #     #
### ####### # ######### ##### ### # # # #
 . .#       # #     #   #     # # # # # #
##### ####### # ### # ### ##### # # # # #
#   # #   #   # # # # #   #     # # # # #
# ### # # # ### # # # # # # ##### # ### #
#     # # # #   # #   # # #       #   # #
##### # ### # # # ##### # ####### # # ###
#     #   # # # #       # #     # # #   #
# ####### # ### ##### # # # ### ### ### #
# #     #       #     # #     #   # #   #
# ##### ####### # ##### ### ##### # # # #
#     #         #     #   # #     # # # #
# ### # ################# # # ####### # #
#   # # #     #     #     # # #       # #
##### # # ### # ### # # ##### # ### # # #
#     #   #   #   #   # #     # #   # # #
### # # # # # # # ####### # ##### # ### #
#   # # # # # # # #   #   # #     # #   #
# # ### # # ### # # # # ### ### ### # # #
# # #   # #   # # # #   #   #   #   # # #
# ### ####### # # ####### # ##### ### ###
# # # #   # # # #   # #   #     # #     #
# # ### # # # ### # # # ### # # # ##### #
# #   # #   #   # # # # # # # # #     # #
# ### # ####### # # # # # # ########### #
#     # #       # # # # # # #         # #
# ##### ########### # # # ### ####### # #
#     #             #   #     #         #
#########################################
