############### ############# ###########
#         #    . . .        #.#   # #   #
# ####### ##### # # ####### # ### # # # #
#   #   #       # #.#     # #. . .#   # #
### ### ######### # # ##### ##### # ### #
# #   #         # #.# #     #   #.# # # #
# ### ######### # # # # ##### ### # # # #
#     #    . .#   #.#   #   # #. .  #   #
########### # ##### ##### # # # #########
#. . . . . .#.#  . .  #. .# #. .#       #
# ########### ### # ### # # # ### ##### #
#.#     #    . . .# #. .#.# #.# #   # # #
# ##### # ######### # ### # # # ### # # #
#. . .#   #. .#     #.  #.# #. .#   #   #
# ### ##### # ####### ### # ### # #######
# #. .  #. .#. .#. . .#. .#   #. .#     #
### # # # ##### # ##### ##### ### # ### #
#. .# # #.#   #. .#   #.#. .# #. .  #   #
# ### # # # # # ### # # # # ### ##### ###
#.#   # #.# # #   # # #. .#. . .  #   # #
# # ##### # # ### # ##### ##### # ##### #
#.# #. . .# # # #   #   #     # #       #
# ### ####### # ##### # ##### ######### #
#.#. .        #       # #     # # #   # #
# # ########### ####### ####### # # ### #
#. .                  #     #   # #     #
# # ######### ########### ### ### #######
# #         #       #   #         #     #
# ######### ##### ### # ### ####### ### #
#   #     #     #   # #   #     #     # #
# ### ### ### ##### # ### ##### # ##### #
#       #   #     # #   #     #   #   # #
######### ##### # # # ##### # ####### # #
#       # #     # #       # #         # #
# ##### # # # # # ####### # # ######### #
# #   # # # # # #       # # #     #     #
##### # # # ### ####### # ######### ### #
#   #   # #   # #     # # #   # #   #   #
# # ### # ### ### ##### # # # # # # # ###
# #         #     #     #   # #   # #   #
#########################################
