### #####################################
#  . . .          # #                   #
# # ### ####### # # # ####### ######### #
# #   #. . .  # # # # #     #         # #
### # # ### # # # # # # ### ########### #
# # # # #. .# # #   # # # #   #   #     #
# # # ### ##### ##### # # ### # # # #####
# # #   #. . .#       # #     # #   #   #
# ### # ##### ####### # # ##### ##### ###
#   # # #   #.      # # #   #   #   #   #
### ### # # # ##### # # # ### ### ### # #
# #   #   # #.  #   # # # #   #       # #
# ### ##### # ### # ##### # ### ####### #
#           #.#   # #     #   # # #. .# #
############# # ### # ######### # # # ###
#     #  . . .# #   # #         #. .#. . 
# ### # # ##### # ### # ######### #######
# # #   #.#   # # #   # #. . . . .      #
# # ##### # # # ### ### # ####### ##### #
# #    . .# # #   # #   #.  #   #     # #
# ##### ##### ### # # ### ### # ####### #
#   #  . . .#     #. . . .    # #   #   #
# # ### ### ####### ##### ##### # ### ###
# #   #   #. . . . .    # #   # # # #   #
# ### ### ### ######### ### # # # # ### #
#   #   #   #   #     #     # # # #   # #
##### # # # ##### ### ####### ### ### # #
#     # # #         #     #   #     # # #
# ### # # ### ####### ##### ### ##### # #
#   # # #   # #     #     #   # #     # #
# # ### ### ### ### ##### ### # # ##### #
# # #     #     # #   #     #     #     #
# # # # ######### ##### # # # ####### # #
# # # # #     #         # # #     #   # #
### # ####### ########### # ##### # ### #
# # #       #     # #     #   # # # #   #
# ######### ##### # # ##### # # # # #####
# #     #   #   # #   #   # # # # #     #
# # ### # # ### # ##### # ### # # # ### #
#   #     #     #       #     #   # #   #
#########################################
