########### ######################### ###
#         #.#      . .#  . .#. . .#  .  #
# ##### # # ####### # ### # # ### ### # #
#     # # #. . . .#.#. . .#.#.#  . . .# #
##### # # ####### # ####### # # ### ### #
#     # #        . .#     #.#.# #   #   #
####### ########### ##### # # ### ### ###
#       #     #     #   # #.#. .#   #   #
# ####### ### # ##### # # # # # ### ### #
# #       #   # # #   #   #.# #. .#   # #
# ####### ### # # # ####### ### # ### # #
#   #     #     # #        . .# #.#   # #
# # # ##### ### # ########### ### ##### #
# # #   #   #   # #   #     #. .#.#     #
### # # ##### ### # # # ####### # # ### #
# # # # #     # #   #   #     #.#.# #   #
# # ### # ### # ####### # ### # # # # ###
#   #   # #   #   #   # # # # #. .# #   #
# ### ### ####### # # # # # # ### # ### #
# #     #       #   # #   # #     #   # #
### # # ####### ### ####### ####### ### #
#   # #       #   #   #           # #   #
# ### ####### # # ### ########### # # # #
#   #       # # # #                 # # #
# # ##### # # # # ##### ############# # #
# #     # # # # #     # #           # # #
# ### ### # # ##### # # # ##### ### # # #
#   # #   # #     # # # #   #   #     # #
##### # ### # ### # # ##### # # ##### # #
#     # #   # #   # #     # # # # #   # #
### # # ####### ### # # ### # ### ##### #
#   # #     #   #   # # #   #     #     #
# # # ##### # ####### # # ######### ### #
# # #   #   #       # # #     #   #   # #
# ####### # ####### ######### ### # # ###
#     # # # #     #         #     # #   #
# # ### # ### ##### # ################# #
# # #   #   # #   # # #     # #         #
# # # ##### # ### # ### ### # # #########
# #       #       #       #   #         #
#########################################
