############# ###########################
#        . . .    #                     #
# ### ### ####### ### ########### ##### #
#   # #  . . .  #               #   #   #
##### # # # # # # ####### ##### ### # # #
#     # # # #.# # #     #     # # # # # #
### ##### ### # ### # ### ##### # # # # #
#   #   # #. .#     #   #     # # # # # #
# ### # # # # ####### # ##### # # # # ###
#   # # # #.#       # #     # #   # #   #
# # ### # # ####### # # ##### ##### ### #
# #     # #. . . .# # # #       #     # #
# ####### # ##### # ### # ##### ##### # #
#     #   #   # #.# #   #     #   # # # #
####### ##### # # # # # ### # ### # # ###
#       #   #   #.# # #   # #   #   #   #
# # ##### # ##### # # ### # # # ####### #
# # #     #      .# #   # # # # #       #
### # ########### ### # # ### ### ##### #
#   # #. . . . . .#   # #   #   # #   # #
# ##### ####### ### ### ### # # ### ### #
# #. . .#     # #   #   #   # #   #   # #
### ##### ### # # ### ### ##### # ### # #
#. .#     # #   # # # #   #     #   # # #
# ######### ##### # # # ####### # # # # #
#. . .    #       #   # #   #   # # # # #
# ### ### ############# ### # ### ### # #
# # #. .#   #         #   # # #   #   # #
# # ### ### # ####### ### # # # # # ### #
# #   #.  #         # #   #   # # #     #
# ### # # ### ####### # # ##### # ##### #
#     #.#   # #     # # # #   # #   #   #
####### ### ### ### # # ##### # ### #####
#    . .  # #   #     #       #   #     #
##### ##### # # # ### ######### # ##### #
 . . .# #   # # #   # #   #     #     # #
##### # # ########### # ### ########### #
# #   # # # #         # #   # #   #     #
# # ### # # # ####### # # # # # # ### # #
#   #     #   #       #   # #   #     # #
#########################################
