######### ###############################
#        . . .  #   #   #       #   #   #
# ### ### # # # # # # ### ##### # ### # #
# #   #   # #.#   # #   # #     # #   # #
# # # ### # # ##### ### ### ##### # #####
# # # #   # #. . .#   #         #   # #. 
# ### # ##### # # ### ##### ##### ### # #
# #   # #   # # #.  #     # #   # # #. .#
# # ### # # # ### # # ##### # # # # # ###
# # #   # # # #. .# #       # # #. .#.# #
### # # ### # # ### ######### ### # # # #
#   # #     # #. .#         # #. .#. .# #
# # ##### ### ### ######### # # ####### #
# # #   # #   #. .  #. . .# #. .      # #
# ### # # # ### # ### ### ### ####### # #
#     # # # #  .# #. .# #.#. .#     # # #
# ##### ### # # ### ### # # ### ### # # #
# #   #   # # #. . .  # #. .    # # #   #
# ### # # # ### ### # # # # ##### # #####
#     # # #   #   # #   # #       #     #
######### ### ### ##### # ########### ###
#           # # #     # #           #   #
######### # # # ### # ####### # ### ### #
#         # # #     # #     # #   #   # #
# ##### ### # ######### ### # # # ##### #
#   #   #   #     #     #   # # # #     #
### # ### ### ### # ####### ### # # # # #
#   # #   # #   # #   #   #     # # # # #
# ##### ### ##### ### # # ##### # ### # #
# #   #   #         # # # #   # # #   # #
# ### ### ##### # # # # # # # ### # ### #
#   #   #   #   # # # # #   #     # #   #
# # ### # # ### # ##### ########### # ###
# # #   # # #   #     # #   #       # # #
### # ##### # # ##### # # ########### # #
# # #       # # #   # #   #         #   #
# # ####### # # ### # ##### ####### #####
# #   #   # # #     #   #     #   #   # #
# ### # # ### ####### # # ####### # # # #
#     # #     #       #         #   #   #
#########################################
