########### ####################### #####
#          . .      #. . . .    # #.# # #
# ########### ####### ##### ### # # # # #
#   #. . . .#.  # #. .  #. .# # # #.# # #
##### ##### # # # # ##### ### # # # # # #
#  . .#    . .# #. .#   #. .# # # #.#   #
# # # ######### # ### # # # # # # # ### #
# #.# #. .#     #.  # # # #.#   #. .#   #
### # # # ####### ### # ### ##### ### ###
#. .# #.#. . . . .    # #. .#. . .#   # #
# ##### ####### ####### # ### ##### ### #
#.#. . .#     #       # #. . .    #     #
# # ##### ### ##### ### # ### ####### ###
#. .    #   # #   #   # #   # # #       #
# # ####### # ### ### # ### # # # ##### #
# # #       #   #   # #   # # #   #   # #
# ### ####### # ### # ### # ### ### # ###
# #         # #   #   # # #       # #   #
# # ####### ##### ##### # ######### ### #
#         #     #     # #         #   # #
# ### ### ##### ####### # ##### # ##### #
#   #   # #   # #       #     # #     # #
# # ### # ### # # ############# ##### # #
# #   # #   # #   # #     #         #   #
### # # ### # ##### # ### # # # ### #####
#   # #   # #     # # #   # # #   # #   #
# # # # # ####### # # # ##### ##### # # #
# # # # #       #   # #       #   #   # #
# # # ##### ### ### # ######### # # ### #
# # # #   #   #     #     #     # # #   #
# # # # # ##### ######### ### ### ### # #
# # #   #     #       # # #   #       # #
# # ######### ####### # # # ######### # #
# #   #     #       #   # # # #       # #
# ### # ### ####### ##### ### # ####### #
# #   # #   #     # #     #   #   #     #
# ####### ### ### # # ##### ### # ##### #
#         #   # # # # #     #   #   #   #
# ### ##### ### ### # # ########### # ###
#   #         #     # #             #   #
#########################################
