########### ##################### #######
#      . . .    #. .    #   #   #.# #   #
##### # ### ##### # ### ### # ### # # # #
#     #. .# #. . .#.  #     # #. .  # # #
# ####### ### ##### ######### # ##### # #
# #    . .#. .#   #. . . .    #.  #   # #
# ##### # # ##### # # ### ##### ### ### #
#     #.# #.  #   # #   #. .  #.#   # # #
##### # ### ### ### ####### # # # ### # #
#   # #. . .      # #. . . .# #.# # # # #
# ### # ### # # ### # ####### # # # # # #
#     #   # # # #   #.#       #.#   # # #
# # ##### # # ### ### # ####### # ### ###
# # #   # # # #   #  .# #. . . .# #   # #
### # ### # # # ### # ### ### ### # ### #
#   #     # # #   # #. . .  # #   # #   #
# # ##### # ##### ##### ### ### ### # # #
# # #   # #     #   # #   #     #     # #
# ### # # ##### ### # ### ######### ### #
#     # #     #   # #   #         # # # #
# ##### ##### # ### ### ### ##### # # # #
# #   #     # #   # #     #     # #   # #
# # # ##### # ### ### ##### # # ### ### #
#   #     # # #   #   #   # # #     #   #
# # ##### # # # ### ##### # ########### #
# # #     # # #         # # #     #   # #
# # # # ### # # ### ### # # # ### # # ###
# # # # #   # #   #   # # #   # # # #   #
# ### ### # # ### ##### # ##### # # ### #
#   # #   # #   #     #       # # # #   #
### # # ### ### ### # ######### # ### ###
#   # # #     #   # #           #     # #
##### # # # ### # ### ################# #
#     # # #   # #   #       #           #
# ##### ##### # ### ##### ### ### #######
#     #     # #   #     #   # # #     # #
# # # ##### ### # ######### # # # # # # #
# # # #   #   # #       # #   # # # # # #
# ##### # ### ######### # ##### # ##### #
#       #   #         #         #       #
#########################################
