##################################### ###
#     #       # #     #              . .#
### # ##### # # # ### ### # ### ####### #
#   #       #   #   #   # # #   #  . . .#
# # ######### ### ##### # ### # ### # # #
# # # #   # # #   #   # # #   # #. .# # #
# ### # # # # # ### ### # # ### # ### # #
# #   # #   # # # #     # # #   #.#   # #
# # ### ##### # # ####### # ### # ##### #
#   # #     # #     #     # #   #. . .# #
##### # ### # # ##### ####### ####### # #
#   #   #   #   #   # #       #. . .#.# #
# # # ### ### ### # # ##### ### ### # # #
# #   #   #     # # #     # #. .# #. .# #
# ######### ##### ####### # # # # ### # #
#       # # # #   #   #   # #.# #     # #
####### # # # # ### ####### # # ####### #
#   # # #   # #     #       #.#   #     #
# # # # ### # ##### # ####### ### ##### #
# #   #           #   #    . .  # #     #
# ############### ### # ### ##### # # ###
#               # #   # #  . . .# # # # #
########### ### # ##### # # ### # # ### #
# # #       # #         # # # #.# #   # #
# # # # ##### ####### # # # # # ##### # #
#   # #   #           # # #   #. .#   # #
# ### # # # # ######### # ####### # ### #
# # # # # # #     #     # #  . . .#     #
# # # ### ####### ### ### # # ###########
#   # #   #       #   # # # #.#. . .    #
### ### ### ####### ### # # # # ### ### #
#       # #   # #   #   # # #. .# #. .# #
######### # # # # ### ### # ##### # # ###
#   # # # # #   #     #   #       # #. . 
# # # # # ############# # ### ##### #####
# # # # #               #   #     #     #
# # # # ####### ########### ######### # #
# # #           #         # #       # # #
# ############# # ######### # # ### ### #
#               #           # #   #     #
#########################################
