######################### ##### #########
#         #   #         #.#    .    #   #
# ### ### ### # ######### # ### ### # # #
# #   #     # # #    . . .#   #.  #   # #
### ####### # # ##### ######### #########
#   #     # #        . . . . .#. . . . .#
##### ##### ################# # ##### # #
#   # #   #   #   #       #. .# #. .# #.#
# # # # # ### # ### ####### ##### # # # #
# # # # #   # # #   #. . . .#. . .#.# #.#
# # # # ##### # # ### ####### ##### ### #
# #   # #     #   #  . .# #  .#    . . .#
# ### # ### ### ####### # # # ####### # #
# # # #   # #         #. .# #.#. . .# # #
# # # ### # ######### ### # # # ### ### #
# # # # # #         #  . .# #. .  #. .# #
### # # # ######### ### ### # ####### # #
#   #                 #.#   #       #.# #
# ##### ############# # # ######### # # #
#   #   #   #       #  .# #. . .#   #.# #
### ##### ### ##### ### # # ### ##### # #
# #     #     #       #.# #.# #. .#  .# #
# ##### ####### ##### # ### # ### ### ###
# #         #       #  . . .# # #. .#. .#
# ######### ################# # ### # # #
#     #               #    . . . . .# #.#
##### ########### ### ##### ########### #
#   #   #         #        . .#  . . . .#
# # ### ### # # ############# ### ##### #
# #   #     # # #       #    . . .# #   #
# ### ####### ### ##### ### ##### # # # #
# #     #   #     #   # #   #     # # # #
### ### # ### # ### ### # ### ##### # # #
#   # # #     #   # #   # #     # # # # #
# ### # ########### # ### ### # # # # # #
#   # #           # # #     # # #   # # #
### # ##### ##### # ### # # ### # ### # #
# #   #   # #       #   # # #   #   # # #
# ##### # ### # ### ####### # ##### # # #
#       #     #   #         #     #   # #
#########################################
