############################### #########
#   #       # #      . .#      . . .    #
# # ### ### # # # ### # ####### ### ### #
# #     # # #   # #  .#. .#   #   #.  # #
# ####### # ##### # # ### # ####### # # #
#   #. . .# #     # #. .#.#    . . .# # #
##### ### # # ######### # ##### ### # # #
 . .#.# #.#   #. . . . .#. .#  . .# # # #
### # # # ##### # ######### # ### ### # #
# #.#.# #. . .#.# #     #  .#   #.#   # #
# # # # ##### # # # ### ### ##### # ### #
# #.#.#      . .# # #      . . . .#   # #
# # # ########### # ################### #
# #.#. . . .#   # #   # #               #
# # ##### # # ### # # # # # ### ##### # #
# #. . .# #.# #   # # #   # #   #     # #
# # ### ### # # ### # ##### ##### ##### #
# # #  . . .# #   # #     #     # #     #
# ### # ### # # # # ##### # ### # # ### #
#     # #   # # # # #   # #   # # #   # #
####### # ### ### # ### # ##### # # # # #
#       # #       #     # #     # # # # #
### # ### ############### # ##### ### # #
#   # #       #   #       # #     #   # #
# ##### # ### # # ####### ### ##### ### #
# #     # # # # # #       #   #     #   #
# ####### # # # # # ### # # ##### #######
#       # # # # # #   # # # #   #       #
##### # # # # # # ##### # # ### # ##### #
#   # # #   #   #   #   # #     # #     #
# # # # # ### # ### ##### ######### # # #
# # # # #   # #   #   #   #   #     # # #
# ### # ##### ####### # ### # ######### #
#     # #     #     # # # # #           #
##### ### ####### # # # # # #############
#     #   #     # # # # # # #           #
####### ### ### # # ### # # # ######### #
#       #   # # # # #   #   # #       # #
# ####### ### ### ### # ##### # ####### #
#           #         #       #         #
#########################################
