########################### ######### ###
#       #   #     # #     #.#   #    . .#
####### # # # # # # # ### # # # # ### # #
#     #   # # # # # # #   #.# # # #   #.#
# ### ### ##### # # # ##### # # # # ### #
#   #   # #     #   # #. . .  # # #   #.#
### ### # # # ##### # # ####### # ##### #
#   # #   # # #   # #  .#     # #   #. .#
# ### ### ### # ### ### ##### ##### # # #
# #     #     #        . .# #       #.# #
### ### ################# # ######### # #
#   #               #    . . . .#  . .# #
# ################# # ######### ### ### #
# #   #   #       # #   #      . .#.#   #
# ### # # # ##### # ##### ####### # #####
#     # # # #   #       # #   # #.#. . .#
####### # # ### ####### ### # # # ##### #
# # # # # # # # #       #   # #. .#. . .#
# # # # # ### # ##### ### ### # ### ### #
#   #   #     #           # # #.#  . .# #
# ##### ################### # # ##### # #
# #   #         #           #  . . . .# #
# # # ######### ### ### ### ######### # #
# # #               #   #             # #
# # ################# # ############### #
# #     #             #   #       #     #
# ##### ### ############# # # ### # # # #
# #     #   #     #       # # # # # # # #
# ####### ####### # ######### # # # # # #
#         #         #         # # # # # #
########### ######### # # ### # # ### # #
# #   #   # #         # # #   #       # #
# # ### # # # ############# ####### ### #
#       # # # #           # #   #   #   #
# ######### # ######### ### # # ##### # #
# # #       # #       #   # # #       # #
# # # ####### # ##### ### ### ######### #
# # #       # #   # # #     # #     #   #
# # ######### ### # # ##### # # ##### # #
#               #   #         #       # #
#########################################
