################### #####################
#                  .        #. . . .    #
# ############# ### ######### ##### # ###
# #   #         #  . . . . . .    #.#   #
##### # # ####### # # ##### ####### ### #
#     # # #       # #     # #. . . .#   #
# ##### # # ####### ##### # # ####### ###
# #     # # #   #     # # # #.#     # # #
# ####### # # # ##### # # # # ##### # # #
#       # # # #     # # # # #. .  #   # #
### ### # ### ####### # # ##### # ##### #
#   #     #   #       # #   # #.#       #
# ### # # # ### ####### ### # # #########
#   # # # #     #      . .#   #. . .    #
##### # # ####### ##### # ######### #####
#     # # #       # #  .#.#. . . .#. . .#
# ####### # ####### # # # # ##### # ### #
# #       # #     #   #.#.#.#   #.#   #.#
# ### ##### ##### ##### # # # ### ##### #
#   # #         #  . . .#. .# #  . . . .#
### # ##### ### ### ####### # # # ##### #
# # #     #   #   #.#     # #   # #     #
# # ### ##### ### # # ### # ##### # ### #
# # # # #     #   #.# # # # # #   # #   #
# # # # # ##### ### # # # # # # ### #####
# #   # # #     #  .#   #   # # # #     #
# ##### # # ##### # ######### # # ##### #
# #     # # #   # #. . .#. . .# #. . .# #
# ### ##### # ### # # # # ### # # ### # #
# #   #     #     # # #. .#. .# #.  #.# #
# # # # # # ####### # ##### ##### ### ###
#   # # # # #     # #     #. . . .  #. . 
####### # # # ### # ##### ####### # #####
# #     # #   # # #     #   #   # #     #
# # ##### # # # # ##### ### # # ####### #
# # #   # # #   # #   # #   # #     #   #
# # ### # # ##### # # # # ### ### # # ###
#   #   # # #     # # # # #   # # # #   #
### # ### # # ####### # ### ### # ##### #
#   #     # #         #         #     # #
#########################################
