################### #####################
#                  . . .    #. .    #   #
# ### ### ######### ### ##### # ### ### #
#   # #   #   #       #. . . .#. .#     #
##### ##### # ##### # # # ####### #######
#   # #   # #       # # #   #   #. . . .#
# # # # # # ######### # ### ### # ### # #
# #   # # # #       # #   #     #   # #.#
# # ### ### # # ### # ### ######### # # #
# # #   #   # #   #     #   #     # # #.#
# # # ### ### ### ### # # # # ##### # # #
# # #     # #   #   # # # # # #     # #.#
# ######### ### ### # # # ### ### ##### #
# #     #     #   # # # #   #     #. . .#
# # ### ##### ##### # ##### ####### #####
# #   #   #         #     # # #    .#. .#
# ### ### ####### ######### # # ### # # #
#   # # # #       #         # # #  . .#.#
# # ### # # ####### # ####### # ####### #
# # # #   # # #     # #   # # #       #.#
# # # # ### # # ####### # # # ######### #
# #   # #   # #   # #   #   #    . . .#.#
# ##### ### # # # # # ########### ### # #
# #         # # #   # #      . . .# #. .#
# ####### ### # ### # ### ### ##### # # #
#     #   #   #   # #   # #. .#     # # #
# # # ##### ##### # ### # # # # ####### #
# # #       #   # #   #   #.# #         #
# ########### # # ######### ########### #
#     #   #   # # #        . .    #   # #
######### # ### # # ######### ### # # ###
#     #   # #   # # #    . . .# # # #   #
# ### # ### ####### # ### # # # # # ### #
# # #   # #   #     # #. .# # # #   #   #
# # ##### ### # ##### # ### # # ### # # #
#       #       #     #.#   #   # # # # #
####### ####### # ##### # ####### # # ###
#     # #       # #   #.# #     # # #   #
# ##### # ####### # # # # ##### # ##### #
#         #         # #.#       #       #
####################### #################
