############################# ###########
#     # #       #            .          #
# ### # # ### # ######### ### ##### ### #
# # # # #   # #   #       #  .    # #   #
# # # # ##### ### ##### ### # ##### # ###
# # #         #     #   #   #.  #   # # #
# # ############### # ####### ### # # # #
# #         #    . .# #   #  .#   # #   #
# ######### # ### # # ### ### # #########
#   #. . . .# #. .#.#   # #. .#         #
##### ##### ### ### ### # # # ######### #
 . .#. .#  . . .#  . .#   #.# #       # #
### # # ############# ##### # ####### # #
#. .# #.#            . .#  .#         # #
# ##### # ############# ### ########### #
#.#  . .# # # #        . . .  # # #     #
# ### ### # # # ######### # # # # # #####
#. . .#   # # #   #       # #   #   #   #
# ### ##### # ##### ### ### ######### # #
# #   #     #       #   #       #     # #
# # ### ######### ### ### # # # ####### #
# # # #         # #   #   # # #   #     #
### # ######### # # ### ### # # ### #####
#   #       # # # # #   #   # # #       #
# ######### # # # # # ### ##### # #######
#       #   #     # #   # #   # # # #   #
# ### # # ####### # ### ### # # # # # # #
# #   # #         # # #     # #     # # #
# # # # ########### # ####### # ##### # #
# # # # #         # # #     # #       # #
# # # # ######### # # # ### # ##### ### #
# # # #         # #   # #         #   # #
### # ####### ### ##### ######### ##### #
#   #       #     #     #       # #     #
# # ####### ########### # ##### # ### ###
# # #   #   #           # #   # #   # # #
# # # ### ### ########### ### # ### # # #
# # #     #   #         #   # #   # #   #
# ############# ####### ### # # # # #####
#                     #       # # #     #
#########################################
