####### #################################
#      . .              # #. . .    #   #
##### # # ############# # # ### ### # # #
#     # #.#             # #.# #. .#   # #
# # ##### ############### # # ### ##### #
# # #   #. . . . . . .    #. . .#.#   # #
# ### # ### ####### # ######### # ### # #
#     #   # #     # #. . . .  #.#. .#   #
# # ##### # # ### # # ##### ### ### ### #
# #     # # #   # # # #. .#. . .# #.  # #
# ####### # ### # # ### # ##### # # # ###
# #     # #   # # # #. .#. . .#   #.#   #
# # ##### ### ### # # # ##### ##### ### #
# #         #   # # #.# #   #.#  . .  # #
# ####### ### ### # # ### # # ### ##### #
#       #   #   # # #. .# # #. .#. .#   #
####### ### # # # # ### # ##### # # # # #
#     # # # # # # #   #.#     #.# #.# # #
# ### # # # # # # ### # ##### # ### # ###
# # # # #   # #     # #. .  #  . .#.#   #
# # # # ####### ##### # # ####### # ### #
# # # #     # #   #   # #. . . .#. .  # #
# # ####### # ##### # # ##### # ### ### #
# #       # #     # # #     # #.#   #   #
# ####### # ##### # # ##### ### # ### # #
# #     #   # #   # #     # #. .# #   # #
# # ### ##### # ### ####### # # # # ### #
#     # #   #       #       #.# # #   # #
# ####### # ######### ####### # # ### # #
#     #   #           #    . .# # #   # #
# ##### ##### ############# ##### # ### #
# #     #     #    . . . . .#     # # # #
# # ######### # ### # ####### # ### # # #
# #   #   #   # #  .# #   #   # #   # # #
# ### ### # # # # # # # # # # ### # # # #
# # #   #   # # # #.# # # # # #   # #   #
# # ######### # # # ### # # ### #########
#       #     # # #. .# # # #   #       #
####### ####### # ### # ### # ######### #
#               #   #.#     #           #
##################### ###################
