############################# ###########
#   #   #              . . .#. .#. . .  #
# # # # ### ### ####### ### # # # ### # #
# # # # #   #       #. .#. .# #. .  #.# #
# # # # # ######### # ### ### ####### ###
# #   # # #         #.#. .#   #. . .#. .#
# ### ### # # ####### # ### ### ### # # #
# #   #   # # #  . . .#.#   #. .#  .# #.#
### ### ##### # # ##### ##### ##### # # #
# # #   #     # #. .# #. . . .#    .# #.#
# # # ##### # # ### # ####### ##### ### #
# # # #     # #   #.#         #   #. . .#
# # ### ######### # ########### # ### # #
# #   # #   #     #.  #   #     #     # #
# ### # # # # ##### # ### # ########### #
# #   # # #   #  . .#     # #   #       #
# # ### # ##### # ######### # ### # #####
#   #   # #     #.# #   #   #     #   # #
# ### # # ####### # # # # # ####### # # #
#   # # # #. .#. .# # #   #   #   # #   #
### ####### # # # # # ### ### # ### # # #
# # #  . . .#.#.# #   #   # # #     # # #
# # # # ##### # # # ####### # ####### ###
 . .# #.# #. .#.# # #       # # #   #   #
### # # # # ### # ### ##### # # # # ### #
# #.# #.# #.#  .#   #   # # # # # #   # #
# # ### # # # # ### ### # # # # # ##### #
# #. .#.# #.# #.  #   #   # # # #       #
# ### # # # ### ### ### ##### # # #######
#    . .#  . . .#   #       #   # #     #
############### # ### ########### ##### #
#       #     # #           #     # #   #
# ##### # ### # # # ####### ####### # ###
#     #   #     # #       # #       #   #
# ### ######### # ####### ### ##### ### #
# # #   #   #   #       #         #     #
# # # # ### ##### ####### ########### ###
# # # #   #       #     #   #       # # #
# # # ### ######### ### ##### ##### # # #
#   #   #             #       #     #   #
#########################################
