######################### ###############
# #                  . . .              #
# # ######### ####### ### # # ### # # ###
# # #. .#   # #  . . .#   # #   # # #   #
# # # # # # ### # # ### ##### # ### ### #
# # #.#.# # #   #.# #   #     #   # # # #
# # # # # ### ### # # ##### # ### # # # #
#   #.#.#     #  .# # #     # #   # #   #
##### # ####### # # # # # ##### ### #####
#. . .#. .  #   #.# # # #     #   #     #
# ####### ### ### ### ####### ### ##### #
#.# #   #.#   #. .#   #   # # #   #     #
# # # # # # ### # # ### # # # ##### # # #
#.#   # #.# #. .# #   # #   #   #   # # #
# ##### # # # ### # # # ##### # # ##### #
#. .#  . .# #.#   # #   #     # #     # #
# # ### ##### # # ##### # ##### ### # # #
# #. .#. . . .# # #   # # #       # # # #
# # # ##### ### # # # ### # ### # ### ###
# # #.#     #   # # #     # #   #   #   #
# # # ####### # ### ####### # ##### # # #
# # #. .  #   # #   #     # # #   # # # #
# ##### # # ##### ####### # # # ### # ###
# #. . .# # #   # #     # # # #     #   #
### ### # # ### # # ### # # # ######### #
 . .#   # #     # # # #   # #   #       #
### ##### ####### # # ##### # # #########
#   #     # #     #     #   # #         #
# ### ##### # ##### ##### ### ######### #
# #       #   # #   #   # #   #     #   #
# ### ### ##### # ### # # ##### ### # ###
#   #   #       #   # # # #       # # # #
# # ##### # ##### ### # # # ##### # # # #
# #     # #           # #       # # # # #
# # ### ##### ######### ######### # # # #
# #   # #   #   # # # # #   #     # #   #
# ##### # # ### # # # # # # # # # # #####
# #   #   #   #   # #   # # # # # # #   #
# # # ####### ##### ####### ##### # # # #
#   #       #               #     #   # #
#########################################
