##################### ###################
#           #    . . .  #. . .          #
# ######### # ### ### ### ### ######### #
#     #     # # #.#   #. .  #. . .    # #
##### # ##### # # ##### ### ##### ### # #
#     # #     # #. . . .  #     #.# # # #
####### ### ### ######### ####### # # # #
 . . .#   #   #   #. . .# #. . .#.#   # #
##### ### ### ### # ### ### ### # ##### #
#   #. . .# #   # #.# #. .#.# #. .    # #
# # ##### # ### # # # ### # # # # ##### #
# # #   #. . .#   #.#   #. .#   #   #   #
# ### # ##### ##### ### ### ####### # # #
# #   #      . . .#.#   #   #       # # #
# # ############# # # ### ### ####### # #
#   #   #     #  . .# #   #   #       # #
####### # ### # ### # ##### ### # ### # #
#   #   # #     #   #       #   # # # # #
# # # ### ####### ####### ####### # # # #
# # #   #     #   #       #       #   # #
# ##### ####### ########### # ### ##### #
#   #           #   #       # #   #     #
### # ### # ##### # ### # ### # ### #####
# # # #   # #   # #   # # #   # #   #   #
# # ### # ### # ##### # # # # # # # # # #
#   #   #     #     #   # # # # # # # # #
# ### # # ####### # ####### # # # # ### #
# #   # #   #   # # #       # # # #   # #
# # ### # # # # # # # ######### # ### # #
#   #   # # # # # # # #         #   #   #
# ### ### # # # # ### ####### ######### #
# #   #   #   # #   # #   # #   #     # #
### ### ##### # ### # ### # # # # ### ###
#   #   #   # #   # #   # #   #     #   #
# ####### ##### # # # ### ##### ####### #
#     # #     # # # #   #     # #       #
# ### # ##### ### # # # ##### # # #######
# #   #           # # #       # # #     #
# # ############### ################### #
# #               #                     #
#########################################
