########################### #############
#   #          . . . . .#  .            #
# # ### ### ### ####### # # # ###########
# # #   #   #  .#   #  .# #.#     #     #
# # # ### # # # # # ### ### ##### # ### #
# # #   # # # #.# #    . . .#   #   #   #
# ##### # # # # ######### # ### ##### # #
#       # # # #. .  #. .# #     # #   # #
########### # ### ### # ######### # #####
#     #     #   #. . .#. .  # #. .#     #
##### # # # # # ######### # # # # ##### #
#   #   # # # #   # #   #.#   #.#.#     #
# # ##### # ### # # # # # ##### # # #####
# #       #   # # #   # #. . . .#.# #. .#
# ########### # # ##### # ####### ### # #
#   # #       # #       #   #   #. . .#.#
# # # # ######### # ### ### ### ### ### #
# # # #   #     # #   #   #   #   # #. .#
# # # ### # ### # ### ##### # ### # # # #
# # #   # # #   # #   #   # #   # # #.# #
# # ### # # # ### ##### # # # ### ### # #
# #   #   # #   #       # # # #   #. .# #
# # ######### ########### # # # ### ### #
# # #         #       #   # #   #. .#   #
# ### ######### # ### ########### # # # #
#     #     # # #   #        . . .# # # #
# ######### # # ### ######### ##### # ###
#     #   # # #   # #        .#   # #   #
####### # # # ##### # # ##### # # # # # #
#     # #     #     # # # #  .# # # # # #
# ### ####### ### # # ### ### # ### # # #
#   #     #       # #   #   #.#     # # #
######### ### ##### # # ### # ######### #
#       #     #     # #   # #. .    #   #
# ############# ### # # # # # # ##### # #
# #     #       #   # # # # # #.  #   # #
# # ### # ### # ##### # ### ### ### #####
# # #   # #   # #   # #   #   #.#   #   #
# ### # ### ##### # # # # ### # # ##### #
#     #     #     #   # #     #.#       #
############################### #########
