##################################### ###
#       #               #            .  #
##### # ##### ##### ### # ##### ##### ###
#     #       #   #   #   #   # #    . .#
# # ####### ### ### # ##### # # # ##### #
# # #       #   #   #   #   # # #   #. .#
# ### ####### ### ##### # ### ##### # # #
#   #     #   #   #     # #         #.# #
### ####### ### ### # # # ########### # #
# #       #     #   # # # #     #  . .# #
# # ##### ####### ### # # # ### # # # # #
# #     #       # # # # #     # # #.# # #
# ##### # ####### # # ########### # ### #
# #     # #     # # # #     #   # #. .# #
# ######### ### # # # # ### # ### ### # #
#     #     #   #   # #   # #   #   #.# #
##### ### ##### ########### ### ##### # #
#   #     #            . . . . .#  . .# #
### # # ############# # ####### # # #####
#   # # #             #. .#   #.# #. . .#
# ##### # ####### ####### # # # ### ### #
#       # #       #  . . .# # #. .# #. .#
######### ####### # # ##### # ### # # # #
#         #       # #.#   # # # #.# #.# #
# ### ##### ### ### # ### # # # # ### # #
# # # #     #   #   #. .#   # #  . .#.# #
# # # # ### ##### ### # ##### ##### # # #
# # # # #   #   # #   #. .  # #    . .# #
# # # # # ### # # # ##### # # ### ##### #
#   # # #   # #   # #   #.# # #   #. .# #
##### # # # ####### # ### # # # ### # ###
#     # # #       #   #. .# #   # #.#. . 
# ### # ### ### # ##### # # ##### # #####
# #   #   #   # # #    .# #   #. .#. .# #
# ####### ##### # # ### ####### # ### # #
# #     # #     # # #  . . . . .#. . .  #
# # ##### # ##### # ########### #########
#     #   # #   # #   #       # #       #
####### ### # ### # # # ##### ######### #
#       #   #     # #       #           #
#########################################
