########################### #############
#            . . . . .#    .  #. . .    #
# ######### # ####### ##### ### ### ### #
# #         #.#      . .#  .#. .  #.  # #
# ### ####### # ####### # # # ##### ### #
# #   # #. . .# #     #.# #. .#. . .#   #
# # ### # ####### ##### ### ### ### # ###
# # #   #.#. . .#      . .#   #.#   #   #
# # # ### # ### ######### ##### # ##### #
# # # #  . .  #. .    #  . . . .#   #   #
# # # # # # # ### ### # ########### # # #
# #   # # # #   #. .# #   #. . .#   # # #
######### # ####### ####### ### ##### # #
#       # #       #. . . . .# #.#     # #
# ##### # ####### # ### ##### # # ##### #
# # #   # #     # #   #     # #.# #   # #
# # # ### # ### # ### ####### # # # ### #
# #   #   # # #     #     #   #.# #     #
# # ### ### # ########### # ### # #######
# # #   #   #. .# #     #   #. .# #     #
### # ### ### # # # ######### # # # #####
# #   #   #  .#.# #   #      .# #       #
# ##### ### # # # ### # ##### ##### ### #
#       #   #.#.#   # #     #. .  # # # #
############# # ### # ######### # # # # #
#        . .#.#. . .#  . . . . .# #   # #
# ####### # # ##### ### # # ### # ##### #
# #. . . .#. .#    .#. .# # #   #   #   #
# # ##### ######### # ##### # ### # # ###
# #.#     #        . .#     # #   # #   #
# # ####### ####### ### ##### # # ##### #
# #.#. . .#   #     #   #     # #   #   #
# # # ### ### # ##### ### ######### # # #
# #. .  #.  # # #     # #       #   # # #
# ### ### # # ### ##### ####### # ### # #
#   # #. .# #   # #     #       # # # # #
### # # ####### # ### ########### # # # #
# # # #.#   #   #   #   #         #   # #
# # # # # # ####### ### # ####### ##### #
#   # #.# #         #     #       #     #
####### #################################
