# #######################################
#.          #     #       #       #     #
# ### # ### # ### # ##### # ### ### ### #
#.  # #   # #   # # #   # #   #   #   # #
# # ##### ### ### # # ##### ##### ##### #
#.#     #       #     #     #     # #   #
# ##### # ### # # ##### ##### ##### # ###
#.    # #   # # #       #     #       # #
# ##### ### ### ############### ####### #
#. . .#   # #     #           # #   # # #
# # # # # # # ##### ####### ### # # # # #
# # #.# # # #             #     # # # # #
# ### # # # ################# ### # # # #
#   #.# # #                 # #   #   # #
### # # # ##### ### ####### # ####### # #
#   #.# #     #   #     #   # #       # #
# ### # ##### ####### # # # # # ####### #
#   #.#     #       # # # # #   #       #
### # ### # ##### # # ### ####### #######
#   #. .# # #   # # #   #       #   #   #
####### # ### # ### # # ####### ### ### #
#. . .#.#   # #     # #     #   # # #   #
# ### # ### # # ### # # ### # ### # ### #
#.#  . .  # # # #   # # #   # #     # # #
# ####### # # ### ### ### # ### # ### # #
#. .#     # #   # #   #   # #   #     # #
# # # ##### ### ### ######### ##### ### #
# #.#   #     # #   # #       #   # #   #
# # ##### # # ### ### # ######### # # ###
# #.#     # #   # #               # # # #
### ########### ### ################# # #
#. .#. .      #       #             #   #
# # # # ##### ######### ########### ### #
#.# #.#.#   #         #           #   # #
# ### # ### # ####### # ####### ### ### #
#. . .#. .#   #       # #     #   #     #
# # ##### ############# ##### ### #######
# #     #. .    #     #     #   #   #   #
# ######### ### # ### ### ##### # # ### #
#         #. .#     #           # #     #
############# ###########################
