################### #####################
#              . . .  #   #             #
# # # ### ##### ### # # # # ########### #
# # #   # #  . .#   #   # #   #       # #
### # # ### # # ##### ### ##### ####### #
#   # # #   #.# #   #   #   #           #
# ##### # ### # # # ### # ### ##### #####
# # #   # #  .# # # #   # #   #   #     #
# # # # # ### # # ### ### # ##### #######
#   # # # #. .# #   # #   # # #   #     #
##### # # # ### ### ### ### # # ### ### #
#     # # #. .#   # #   #   # # # #. .# #
# ### ### # # ### # # ### ### # # # # ###
# #   #   # #. .# #   #. . . .  # #.#. . 
# # ### ####### # ##### ##### ### # #####
# #   #       #.# #. . .#   #.  #. .    #
# ############# # # ####### # ### #######
#   #    . . . .# #.#       #. .#.#     #
# # # ### ######### # ####### # # # ### #
# # # #  . .#. . . .  #     # #. .# #   #
### # ### # # ######### ### ### ##### ###
#   #   # #. .      #   # #   #   #   # #
### ### # # ####### # ### # ##### # ### #
#   #   # #   #   # #     #     #     # #
# ### ### ##### # ### ######### ####### #
# #     #       # #   #       #         #
# # # # ######### # ### ### #############
# # # #         #     #   #       #     #
# # ######### ########### ##### # # ### #
# #     #   #             # #   # #   # #
# ####### # # ##### ####### # ##### #####
#     #   # # #   #         #   #   #   #
# ##### ### # ### # # ####### # # ### # #
#       # # #     # #       # #   #   # #
# ### ### # ####### ####### ### ####### #
#   #   # # #     #     # #   #   #     #
# # ##### # ##### ### # # # # ##### #####
# #     # #     # #   #   # #     # #   #
# ##### # # # ### # # ########### # ### #
#     #   # #   #   #           #       #
#########################################
