################### #####################
#   # #            .            #       #
# # # # ########### ####### ### ####### #
# #   #         #. .    #     #     #   #
# ############### # ### # # ##### ### ###
#    . . . . . . .#   # # #     #       #
##### # ######### # # # # ############# #
# #  .# #. . .#   # # # #     #       # #
# # # ### ### # ##### # # ##### ### # ###
#   #.#. .  #.# #   # # #       #   #   #
##### # ##### # ### # # ### ##### # ### #
#    . .#. .#.#     # #   # #   # #   # #
# ### # # # # ####### ### ### # # ##### #
# #   # #.#. .  #   #   #   # # #   #   #
# # ##### ##### # # ### ### ### # # # # #
# #     #.#. .# # #   #   #     # # # # #
####### # # # # # ### # ######### ### # #
#     # #.#.#.# #   # #   #     # #   # #
##### # # # # # ##### ### # ##### # # # #
#   # # #. .#.#       #   # #     # # # #
# ### # ##### ######### # # ### ### # # #
#     #   #. .    # #   # #     #   # # #
# ####### # # ### # # # ######### ##### #
#         #.#   # # # #     #     #   # #
########### ### # # ##### # # ##### # # #
#      . .#.  # # #       # # #     # # #
# ##### # # # # ########### # # ##### # #
#   #. .#. .# #     #     # # #     # # #
# # # ### # # ##### # ### # # ##### ### #
# # #.# # # #   # # # # # # #     #     #
### # # # # # # # # # # # ### ###########
#   #.#   # # #   #     #   #     #     #
# ### ##### # ##### # ##### ########### #
#   #. .#   #     # # #   #       #   # #
### ### # ####### # ##### # # # # # # # #
# #   #.#   #   # #     # # # # # # # # #
# # # # ### # # ######### # # # ### # # #
# # # #.  #   #       #   # # # #   # # #
# ### # # ########### # ### ##### ### # #
#     #.#           #     #         #   #
####### #################################
