### #####################################
#  . .  #   # #. . . . .    #           #
# ### # ### # # ####### ### # ##### ### #
# #. .#     # #.#     #. .# #. .  #   # #
# # ######### # ##### ### ### # # ### ###
# #. .        #. . .#   #. . .#.#   #   #
# # # ############# ### ##### # ### ### #
# # #. .#. . .    #. . .#   # #. .#   # #
# ##### # ### ######### # # # ### ### # #
#     #. .  #.  #. . . .# # #   #.#   # #
##### # ### # ### ######### ### # ##### #
#   # #   # #. . .#     #   #   #. . .# #
# # # ### ### ##### ### # ### # # ### ###
# #   # #   #         #   #   # # # #. . 
# ### # ### ########### ### ### # # # ###
#   # #           #   # #   #   #   #   #
# # ##### # ##### # # ### ############# #
# #     # #     # # #   # #     #     # #
# ### # # ### ### # ### # ##### ##### # #
# #   # #   #   # #   # #             # #
### ### ####### # ##### # # ########### #
#   #     #     #       # #       #     #
##### ##### ############# ####### # # # #
#     #     #         # #       # # # # #
# ### # # ### ######### # ### # # ### # #
# # # # # #   #       # # #   # #   # # #
# # # # ### ### ##### # ### ### # # # # #
# #   #     #       # #     # # # # # # #
# ########### ####### ####### # ### # # #
#         #         #       # # #   # # #
# # ### ### ### ### ######### # # ### ###
# #   #     # # #   #     #   # # #     #
# ### ####### # # ### ### # ### # # # # #
#   # #       # #   # #   #   # # # # # #
# # ### ########### # ####### ### ### # #
# #   #   #   #   # # #   #       #   # #
##### ### # # # ### # # # ######### ### #
#   #     # #   # #   # #   #   #   #   #
# ######### ##### ##### ### ### ####### #
#                       #               #
#########################################
