######################### ###############
# #            . . . .#  .#. . .        #
# # # ####### # ##### ### # ### ##### ###
#   # #       #.#    . . .#.  #. .  #   #
### # # ### ### ####### ### ##### ##### #
# # # #   #   #. . . .# #. .    #. .  # #
# # # # # ### # ### # # # ######### # # #
#   # # #   # #   # #.# #.# #. . . .# # #
##### ##### # ### ### ### # # ##### ### #
#     #     #   #   #. . .  #.#. .# #   #
### ### ####### ### ##### ### # # # # ###
#   #   #       # #     #   #. .#.# # # #
# ### # # ####### # ### ### ### # ### # #
#   # # # #       #   #   #   # #.#   # #
### # # # # ########### # ### # # # ### #
#   # # # #             # #   # #.# #. . 
# ##### # ############# # # ### # ### ###
# #     #       #       # #   # #. . .  #
# # ##### # # # ######### ### # ####### #
# # #   # # # #         #   # #       # #
# # # # # # # ######### ##### ####### # #
# # # # # # #       #   #       #   # # #
# # ### # ##### ### # ### ####### ### ###
# #   # #     #   # # #   #       # #   #
# ### # # ### # ### # # # # ####### # # #
# #   # #   # # #   # # #       #   # # #
# # ### ##### # # ### ### ##### # ### # #
# # #   #     # # #     #     # # #   # #
# # # ### ##### # ### # ##### ### # ### #
# # #     #     #   # #     #     # #   #
# # ############# # # # # ######### # # #
# #   #         # # # # #     #     # # #
# ### # ####### ### # ### ### ####### # #
#   # # # #   # #   #   # #   #       # #
##### # # ### # # # ### # # ### ####### #
# #   # #   # #   #   # # # #   #   #   #
# # ### ### # # ##### # ### ##### # # ###
#   #   #   #   #   # # # # #   # # #   #
##### ### ####### # ### # ### # # # ### #
#     #           #     #     #   #     #
#########################################
