################################### #####
#       # #       #   #   #        . .  #
# ##### # ####### # ### # ### ### ### # #
#     # # #   #   # #   # #   #     #.# #
####### # # ### ### # ### # ####### # # #
#     # # #     # #   #   # #       #.# #
# ### # # # ##### # ####### ### ##### ###
# #     #   #   # # #   #   #   #    . .#
### ##### ### ### # # # # ### ### ##### #
#   #     #       # # # # #   #   #. . .#
# ### ##### ####### # ### # ### ### # # #
#   # #   # #   #   #     # #   #. .# # #
# ### # # # # ### ######### # ### ### # #
# #   # # # # #   #   #     # #  .#   # #
# # ##### # # # ##### # ### # # # ##### #
# # #   # # # # #     # #   # # #. . .# #
# # ### # # # # # ### ### ### # ##### ###
# #   #     # # # #       # # #     #. .#
# ### # ##### # # ### ##### # ##### ### #
#   # #   # #   # #   #   # #     # #. .#
### # ### # ### ### ### # # # ### # # # #
# #     #     #   # #   # # #   # # #.# #
# ### ####### ### # # ### # ##### # # # #
#   #   #   # # # # #   #   #   # # #.# #
# # ### # ### # # ##### ##### # # # # ###
# # #   #   # # # #   # #     #   # #. .#
# ### ##### # # # # # # ####### ### # # #
#     #     # #   # # #       # #   # #.#
# ####### # # ### # # ####### ### ### # #
# #       # #   #   #  . . . .#   # # #.#
# ##### ### ### ####### ##### # # # # # #
#       # #    . . .#  .#    .# # # # #.#
####### # # ### ### # # ##### # ### # # #
#       # # #  .# #.# #. . .#.#   # # #.#
######### ### # # # ##### # # ### # # # #
#         #   #.#  . . .# #.#. .#   # #.#
# ######### ### ####### ### ### ##### # #
#         # #. .#     #. . .#  . .#   #.#
######### # # # # ############### ##### #
#           #.# #                . . . .#
############# ###########################
