################################# #######
#       #              . . . . .#. .    #
# # ### # ### # ##### # ####### ### ### #
# # # # #   # # #   # #. . . .#.#. .#   #
# # # # ### # # # # # ####### # # #######
# # #     # # #   # #   #   #.#. .#. . .#
# # ##### # # # ### # # # ### ##### ### #
# #   # # # # #   # # # #   #.#. . .  #.#
# # # # # ### ##### # # ### # # ####### #
# # # # #     #     # #   # #.#. . .#. .#
# ### # ######### # # # ### # ##### # # #
#   # #           # # #     #. . . .#.# #
### # ####### # ### # # ### # ##### # ###
# # # #       # #   # #   # #     # #. .#
# # ### ### # ### ### ### ####### # ### #
#   #   #   # #   #     #   #     # #. .#
##### ### ### # ### ### ### # # ##### # #
#     # # #   #   #   #   # # # #  . .# #
### # # # ####### # # ### # # ### # # # #
#   # # # #   #   # #   # # #   # #.# # #
# ##### ### # # ### ### ### ### # # ### #
#       #   #   #   #   #   #   # #.#   #
######### ####### ### ### ### ### # # # #
#         #     # #   #   #   #   #.# # #
### # ##### ### # ### # ### # # ### # ###
#   # #     # #   #   # #   # # # #.#   #
####### ##### # ### ### # # ### # # ### #
# #     #   #   #   # # # #   # # #.  # #
# # ### ### ##### # # # # ### # # # ### #
# # #   # # #     # #   #   # #   #.#   #
# # ##### # # ##### ####### # ##### # ###
# #       # # #   #       # # #  . .#   #
# ######### # # # # ####### # # # #######
# #   #     #   # #   #     # # #. . . . 
# # # # ############# # ##### # ##### ###
# # # # #     #     # # # #   #     #   #
# # # # # ##### ### ### # ######### #####
# # #     #     # #   #   #       #     #
# ### ######### # ### ##### ##### ##### #
#               #               #       #
#########################################
