####################################### #
#                    . .#. . . . .#    .#
# ##### ### ######### # # ####### ##### #
#   #   #   #     #  .#. .#      . . . .#
### # # ##### ##### # ##### #############
# # # #     # #     #. . .# # #. . . . .#
# # ##### # # # ### # # # # # # ####### #
# # #     # #   #   # # #.#   #. .    #.#
# # # # # # ##### ### ### ####### ##### #
#   # # # # #     #   #. .#. . . .#. . .#
##### ### # # ##### ### # # ####### # # #
# #     # # # #     #  .# #.#   #. .# # #
# # ### # # # # ##### # ### # # # # ### #
# # # # # # # #     # #. . .  # #.# #   #
# # # # # # ### ### # ######### # ### # #
# #   # # #   #   # #         # #.#   # #
# ##### ##### ### # ######### ### # #####
#           #   # #         # #. .# #   #
############### # # ##### # # # ### # # #
#         #     # # #   # # # #.#   # # #
# # ##### # # ### # ### ### # # ##### ###
# #   #     # #   #     #   # #. . .#. . 
##### # ##### # # ### ### # # # ### # ###
#   # # #     # #   # #   # # #   #. .# #
# ####### ##### ### ### # ### ##### ### #
#         #     #   #   #   #     # #   #
########### ##### ### # # ####### # # ###
#   #       #   # #   # #       # # # # #
### # ### ### # # # # ########### # # # #
# #   #   #   #   # #     #       # #   #
# ##### # # ####### # ### ##### # # ### #
#   #   # # # # #   #   # # #   # #   # #
### ##### ### # # ####### # ### # # # # #
#         #   #   #       #   # # # # # #
####### # # ####### # ####### # ### ### #
#     # # #     #   #       # #   #   # #
# ### # # ##### ##### ##### # # ##### # #
# # # # # #   #     #     #   #     # # #
# # # ### # # ##### ############### # # #
#   #     # #                       #   #
#########################################
