####################### ### #############
#   #                 #.# #. .  #       #
# # ############### # # # # # # # ### ###
# #         #       #  .#   #.#   # #   #
# ######### ### ####### ##### ##### ### #
# #       #     #     #. .#  . . .#     #
# ####### ####### ### ### ### ### #######
#     #     #     #   # #. .#   #.#. . .#
####### ### ### ##### # ### ### # # ### #
#   #   # #     #   # #   #.#   #. .  #.#
# ##### # ####### # # ### # ######### # #
#   #   #         # #   #. .#. . . .# #.#
### ############### ### # ### ##### # # #
#   #   #     #       # #.#  . .#. .# #.#
# ### # ##### # ### # # # ##### # ### # #
# #   # #     # #   # # #. . . .#.#   #.#
# ### # # ### # # ### # ######### # ### #
#     # # #   # #   # #   # #. . .#   #.#
####### # ### ##### # ### # # ####### # #
#   # # # #         # #  . . .# #     #.#
### # # ### ######### ### ##### # ##### #
#   # #     #     # #    .#. . .#   #. .#
# ### ####### ### # ##### # ### ##### # #
#     #   #   # #        . .#  . . . .# #
# ##### # ### # ### ####### # ####### # #
# #     #     #     #   #   # #   # # # #
# ### # ### ##### ##### # ### # # # # # #
#     # # # #     # #   # #   # # # # # #
### # ### ### # ### # # ### ### # # # # #
#   # #   #   #   # # #     #   # # # # #
##### # ### # # # # # ######### # # # # #
#     # #   # # #   # #         # #   # #
# ##### # # # # # ### ########### ##### #
# # #   # # # # # #       #       #     #
# # # ### # ### ### ##### ####### ### # #
# # # #   #   # #   #   #   #   #     # #
# # # ##### # # # ### ### # ### # # ### #
# #       # # # # # #   # #     # # #   #
# ####### ### # # # ### ########### # ###
#       #     # #   #               #   #
#########################################
