################# #######################
#     #          .            #         #
# ### # ######### ### ####### ######### #
#   # #     #. . .#         #   #       #
### ######### ### # # ######### ####### #
# #      . . .#   # # #       #     #   #
# ####### # ####### # # ### ####### # ###
#    . . .# #       # # # # #     # # # #
##### ####### ######### # # # ### ### # #
#    .#. . .#   #     # # #     #     # #
# ### # ### ### ##### # # ############# #
# #  . .# #. .#     # #. .    #         #
# ### ### # # ##### # # # ### # #########
#   #     # #. .#   # #.#. .#   #     # #
# # ######### # ##### # ### ### # ### # #
# #         # #. .  #. .  #.  # # # #   #
# ### ##### ##### ### ##### # ### # # ###
#   #     #     #. . .  #. .#   # # # # #
# # ########### ######### # ### # # # # #
# # #       #   #. . . . .#   #   # #   #
# # # ##### # ### # ############# # #####
# # #   # # # #. .# #. . . . .  # #     #
# # ### # # # # ##### ####### # ####### #
# #   #   # # #. . .#.#     #.#     #   #
# ### ### # # # ### # ##### # ##### # ###
#   #     # # # #. .#. .# # #.    #     #
############# ### ##### # # # ### #######
#               #. .  #. . .#. .#   #   #
# ########### # # # ####### ### ### ### #
# #         # # # #. .    #.  #. .# #   #
# # ####### # ### ### ##### ##### # # ###
# # # #     #   #   #. . . .#. . .# # # #
# # # # ### ### ### ### ##### # # # # # #
# #   # # #   #   #   # #. . .# # #   # #
# ##### # ### ####### # # ### ### # ### #
# #     #             # #.#   #   #   # #
# # # ####### ### ##### # ##### ####### #
# # #   #   # #   #   # #.#     #     # #
# ##### # # ### ### ### # # ##### ### # #
#     # # #     #       #.#         #   #
######################### ###############
