######################### ###############
#                   #    . . . . . .  # #
# ######### ##### # # ### # # ##### # # #
# #   #     #   # #   #   # #   #. .# # #
# # # ### ##### # # ##### # ### # # # # #
# # #   #       # # #     #   # #.# #   #
### ### # ####### ### # ##### # # #######
#   # # #   #     #   # #   # # #. . . .#
# ### # ### # ### # ### # # # ### ##### #
# #   #   # #   # # #   # # #   # #. . .#
# # ##### # ### # # # # # # ### ### ### #
# #   #   # #   # # # # # #     #. .# # #
# ### ### ### ### ### # # ####### # # # #
# #     #     #   #   # # #      .# #   #
# ##### ####### # # ### # ####### # #####
#     # #   #   # # #   #       #.#     #
####### ### ##### # ########### # #######
#     #       #   #     #     # #. . . .#
# ### ####### # # # # # # ### # # ##### #
# #   #         # # # # #   # # # #. . .#
# ### # ######### # # # ##### ##### # # #
#   # # #         # # #     #    . .# # #
# # # ### # ####### # ##### ##### # ### #
# # #     # #       #   #   #    .# #   #
# # ######### ##### ##### ### ### ### ###
# # #   #     #   #   #   # # #  . .#   #
# # # # ####### # ### ### # # # ### ### #
# # # #   #   # #   # #   #   # #. .# # #
# # # ### # # # ##### ######### # ### # #
# # # #   # # # #     #         #.#   # #
# ### ### ### # # ##### ######### # ### #
#   #   #   #   #     #   #. . . .#     #
####### ### # ########### # # ### # #####
#   # #   #         #     #.# #   # #   #
# # # ####### ##### # ##### # # ### # # #
# # #     #   #       # #  .# #   # # # #
# # # ### # ### ##### # # # ##### ### ###
# # # # #   #   #     # # #. . .#   #   #
# # # # ##### ### ##### # # ### ### ### #
# #   #         #     #   #   #.  #     #
############################### #########
