##################################### ###
#. . . . . . .#  . . . . . .#. .#  . .# #
# ########### ### ######### # # ### # # #
#.#     #    . . .#   #    . .#. . .#   #
# ##### ##### # # # ### ######### # # ###
#. . .# #   # # # #     #         # #   #
# ### # # # ### # ####### ######### ### #
# # #.#   #     # #         #         # #
# # # ########### # ####### ### # # ### #
# # #.  #   #     # #       #   # # #   #
# # # # # # ### ### ### # ### ##### # ###
#   #.# # #     #   #   # #   #     # # #
##### # # ####### ### ### # # ####### # #
#. . .# #     #   #   # # # #       #   #
# # ### # # # ##### # # # # ##### # #####
#.# #   # # #   #   # # # #   #   # #   #
# # # # # ### # ##### # # ### # ### # # #
#.# # # #   # #   #   #   # # # #   # # #
# # # ##### ### # # # ##### # # # ##### #
#.# #     #   # # # #       # # #     # #
# # ### # ### # # ### # # ### # ##### # #
#.# #   #   # # #   # # # #   #     #   #
# # # ##### # # ### # ### # ### ### ### #
 .# #     # # #   # # #   #   # #     # #
### ##### # # ### ### ####### # # # # ###
#   #   # # #   # # #   #   # # # # #   #
# ### ### ##### # # # # # # # # # # # # #
# #   #   #   # #   # #   # # # # # # # #
# # ### # # # # ########### # ##### ### #
#   #   # # #     #     # # #   # # #   #
####### ### # ##### ### # ### # # # # # #
#       #   # # #   # #     # # #   # # #
####### # ##### # ### ##### ### ##### # #
#       # #     # #     #         #   # #
# ####### # ##### ##### ####### ### # # #
#   #   # # #   # #   #   #     #   # # #
# # ### # # # # # # # ### ####### ##### #
# #   # # # # #   # #             #     #
# ### # # # # ##################### ### #
#   #   # #   #                     #   #
#########################################
