### ############# #######################
#. .    # #     #.# #       #   # #     #
# # # # # # ### # # # ##### # # # # #####
#.# # #   # # # #.# # #   # # #   #     #
# ### ##### # # # # ##### # ##### ##### #
#. .#         # #.# #   #     # # #   # #
# # ########### # # # # ##### # # # # # #
# #.      # #   #. .# #     #   # # # # #
### ##### # # ##### # ######### # # # # #
#. .#   #   # #   #.  # #     # # # #   #
# ##### ##### # ### ### # ### # # ### # #
#. .  #       #. . .    # # #     #   # #
# # # ######### ####### # # ####### ### #
# #.#     # #. .#     #   #         #   #
# # ##### # # ### ### ############### ###
# #. .#   #. .# #   #   #   # #         #
# # # # ### ### ### ### # # # # #########
# # #.#   #.#. . .# # # # #   # #   #   #
# # # ### # # ### # # # # ##### # # # # #
# # #.#   #.#.# #.#   # #       # #   # #
# # # # ### # # # ##### # ####### ##### #
# # #.# # #. .# #. .#   # #   #       # #
# ### # # ##### ### # ### # # # ##### ###
# #. .#   #. . .  #. .#     #   #   #   #
### # ##### ### ##### # ######### # ### #
#. .# #. . .# #. . . .# # #     # # #   #
# ### # ##### ######### # # ### # # #####
#. .# #. .    #           # # #   #     #
# # ##### ##### ####### ### # # ####### #
# #. .#. .#     #     #       #       # #
# # # # ### ##### ### ############### # #
# # #. .        # # #             #   # #
# ############# # # ### ####### # # ### #
#   #         # # # #   #   #   # # #   #
# # # ### ### # # # # # # ### ##### # # #
# #   # #   # # # # # # #   # # #   # # #
# ### # ### # ### # # ##### # # # ##### #
#   # #   # #     # # # # #   # # #     #
# # ##### # ####### # # # ### # # # #####
# #       #         #     #   #   #     #
#########################################
