######################### ###############
#  . . . . .#        . . .#           # #
### # ##### ######### # # # ######### # #
#. .# #    . . .#. . .# #   # #     #   #
# # ### ####### # # ### # # # # ### # ###
#.# #   #     #. .# #   # #   #   # #   #
# # # ### ####### ### # # ######### #####
#.# #   #         #   # #         #     #
# ##### ########### # # ####### # ##### #
#. . .#     #       # #   #   # #     # #
##### ####### ### ####### ### # ####### #
#. . .#   #   #   #   #   #   #         #
# # # # # # ####### # ##### ########### #
#.# #   # #         #     #           # #
# ############### ######### # ####### ###
#. . . .#. . .  #         # #   #   #   #
# ### # # ### # ######### # ### ### ### #
#   # #. .# #.#         # # # #   #   # #
### # ##### # ##### ### # # # # # ### # #
#   #       #.    #   # # #   # #   #   #
# ########### ### ### # ### ##### #######
# #   #  . . .  # # # #         #       #
# # # # # ##### # # # # ####### ####### #
# # # # #. .# # # #   # #     #       # #
# ### # ### # # # ##### # ### ##### ### #
#     #   #.# # #     #   # #     #   # #
########### # # # # # ##### # ### ### # #
 . . . . . .#   # # # #     #   #   # # #
##### ### # ##### # ### ### ### ### # # #
#     #   #   #   #   #   #   #   # # # #
# ##### ##### # ### # # ### ##### # # # #
# #     #   # #   # #   #   # #   # # # #
# # ####### # ### # ##### ### # ### # ###
# #     #   #   # #     #   # # #   #   #
# ####### ### # # ##### ### # # # ##### #
# #   #   #   # #     #   # # # # #   # #
# # ### ####### ##### ####### # # # ### #
# #           #   #     #     # # # #   #
# ########### ### # ##### ##### ### # ###
#           #     #       #         #   #
#########################################
