### #####################################
#  .  #. . . . . .                      #
# # ### ######### ############### ##### #
# #.#. .  #     #. .    #. . .  # #   # #
# # # ##### ### # # ### # ### # ### # # #
# #. .    #   # # #. .# #.  #.# #   # # #
# # # ### # ### # ### ### ### # # ### # #
# # #   #   #   #   #.#. .#. .#   #   # #
# # ######### ####### # ### ########### #
# # #       # #     #. .  #. . . .#   # #
# ### ##### # ##### # ########### # # # #
#   # # #   #       #       #   #.# #   #
# # # # # ################# # ### # ### #
# #     #       #    . . .#   #. .# #   #
# ### ### ##### # ### ### ##### # #######
#   #   #     # # #. .#  . . . .#       #
### ### ########### # # ########### ### #
#     # # #      . .# # #. .# #   #   # #
# ##### # # # ### ### # # # # # # ##### #
# #     #   #   #.#   # #.#.#   #       #
# ############### # ### # # #############
#     #        . .# #   #.#. . .      # #
##### # # ##### # ### ### ##### ##### # #
#     # # #  . .# #   # #. .# #. . .# # #
# ##### # # # ##### ### ### # ##### # # #
#   #   # # #.# #   #   # #. . .# #.#   #
##### ##### # # # # # ### ##### # # #####
#     # #   #.#   # # #. . . .#. .#. . . 
### # # # ### ####### # ##### ### ##### #
# # # #   # #. . .    #.#   #.#. .#   # #
# # ####### # # # ##### # ### # ##### # #
# #     # #   # #.  #. .#   #. .  #   # #
# ##### # # ### # ### ##### # # ### ### #
#   #   # # #   #. . .  #   # # #   #   #
### # ### ### # # # ##### ### ### ### ###
#     #   #   # # #         #     # #   #
####### ### # # # ################# #####
#       #   # # #   #           #       #
# ####### ##### # ### # ######### ##### #
#         #     #     #           #     #
#########################################
