################### ####### #############
#       #         #.# #    .            #
# # ### ######### # # # ### ########### #
# # #     #   # # #. .# #  .  #. . .  # #
# # ##### # # # # ### # # # ### ### ### #
# # #   #   # # # #  .# # #. . .# #. .# #
# # # # ##### # # ### # ####### # # # # #
# # # #   # # # #   #.# #     #   # #.# #
### # ### # # # ### # # # ### ##### # # #
#   #   # #       #  .#   # # #   # #.# #
### ### # ####### ### ##### # # # # # ###
#   # # #            . .#   # # # # #. .#
# ### # ############### # ### # # # ### #
# # # # #         #   #.#   #   # # #. .#
### # # # # ##### # # # ### ##### # # # #
#   # # # # #   # # #  . . .#   # # #.# #
# ### # ### ### # # ####### # # # # # # #
# #   # #   #     # #     #.# # # # #.# #
# # # ### ### ### ### ### # ### ##### ###
#   # #   #   #       # # #. . . . .#. .#
##### # ### ########### # ######### # # #
# # #   #   #       #   #     #   #.# #.#
# # ##### # # ##### ### ##### # # # ### #
#       # # # #   #       # # # #. .#. .#
####### ### ### # ####### # # ### ### # #
#     #   # #   #     #     #    . . .# #
# ####### ### # ##### ##### ######### # #
#             # #         # # #   #   # #
################# ####### # # # ### ### #
# #       #       #     # # # #     #   #
# # # ### # ####### ### # # # ####### # #
#   # # #   #         # #   #     #   # #
##### # ############### ### # ### ##### #
#     #                   #   #         #
# ##### ############# ### # ### ##### # #
# # #   #   #         # # # #   #   # # #
# # # # ### # ######### # ### ### # # # #
# # # # #   # #       #     #   # # # # #
# # # ### ### # ##### ##### ##### # ### #
#   #     #   #     #             #     #
#########################################
