######################### ###############
#     #   #     # #      .    #. . . . .#
# ### ### # ### # # # ### ### # ####### #
#   #     # #   # # # #  .#   #.#     #.#
### ####### # ### # # # # ##### # ### # #
#   #       #     # # # #. . . .    # #.#
# ### ##### ####### # # ##### ####### # #
# #   #             # #     #   # #   #.#
# ##### ############# ##### ### # # ### #
#       #           # #   # #   #   #  .#
######### ### ##### # # # # # ######### #
#       # # # #       # #   # #      . .#
# ##### # # # # ##### # # # # # ##### # #
#   # # #   # #     # # # # # # #  . .# #
##### # ##### ####### # ### # # ### ### #
# #   # #   #       # # #   # #   #.#   #
# # # # # ### # ### # # # ### ### # #####
# # #   #     # # # # # # #   #   #. .  #
# # ########### # # # # ### ######### # #
#   #     #     # # # # #   #. . . . .# #
# ##### # # ##### # # # # ### ######### #
# #     # #       # # # # #  . . . .#   #
# ####### ########### # # ### ### # #####
#     #   #         # # # # #   # #. . .#
##### ### # ####### # # ### ### ##### # #
#           #         #       #     # #.#
############# ############### # ### # # #
#   #       # #   #         # # #   # #.#
# # ##### ### # # # ### ### # ### # # # #
# #     # #   # # #   # #   # #   # # #.#
####### # # ### ##### # ### ### ### # # #
#     #     #         #   #   # #   # #.#
##### ####################### # # ### # #
#   # #       #                 # #   #. 
### # # ##### # # ############### # # # #
#   # #   #     #   #     #     # # # # #
# ### ### ######### # ### # # # ### # # #
# #     #   #       # # # # # #     # # #
# ##### ### # # ####### # ### ######### #
#           # #         #     #         #
#########################################
