################################# #######
#   #       #        . . .# #    .      #
# # ### ### # ####### ### # # ### ##### #
# #   # #   # #    . .#. .# #   #.    # #
##### # ##### # ### ### ### ### # ##### #
#     # #     #   #.# #. . . .# #. . .# #
# ##### # ######### # # ##### ####### # #
#    . .#         #.# # #    . . . .#.# #
##### # ######### # # ### # # ##### # # #
 . . .#. .#. . .# #.#   # # # #    . .# #
######### # ### ### ### # ### # ### ### #
#      . .#.# #. . .#   #   # # #   #   #
# ##### ### # ### # # ##### # # ##### # #
# #    . . .#     # #       # #     # # #
### ##### ######### ####### # # ### # # #
#   #   # #   #     #       # #   # # # #
# ##### # # # ### ### ####### ##### # # #
#   #   # # #     #   #       #     # # #
### # ### # ########### ######### ### ###
# #   #   #   #   #     #       #   #   #
# ####### ### # ### # # # ##### ####### #
# #       # #   #   # # #   #           #
# # # ##### ##### # ### ##### # # ### # #
# # # #           # #   #   # # # #   # #
# ### # # ######### # ### # ##### # ### #
#   # # # #   #   # # # # #     # # #   #
### # # # ### # # # # # # ##### ### # # #
#   # # #   #   #   # # # #   #   # # # #
# ### # ############# # # ### ##### # # #
# #   #   #           #       #     # # #
# ### ### # ################# ### ### # #
#     #   # #   #       #   #     #   # #
####### ### # # # ### ### ######### # # #
# #     #   # # # # #     #   #     # # #
# # ##### # ### # # ####### # # ##### # #
# # #     # #   # #         # #   #   # #
# # # # ### # ### ########### ##### ### #
# # # #   # # # #             #     #   #
# # ##### # # # ############# # ##### # #
#   #     # #                   #     # #
#########################################
