############### ############### #########
#         #  . .        #     #.#   #   #
######### # # # ####### # ##### ### # # #
#. . . .#   #.#     #   #. . .#. .# # # #
# ##### ##### ##### # ### ### ### # # # #
#.#    . . . .#     # #. .# #.  #.# # # #
# ##################### ### # ### # # # #
#.#. . . . . . . .#. . .    #. . .  # # #
# # ### ######### # ######### ### ### # #
#. .  #         #. .#   #   #   #     # #
# # # ######### # ##### # # ### ####### #
# # #       #   #       # #   #   #   # #
# # # ##### # ########### ####### # # # #
# # #     # #   #           #   # # # # #
# # ##### # ### # ####### ### # # ### # #
# #     # #   #   #     # #   # #     # #
# ##### # # ####### ### ### ### # ##### #
#     # # #           # #   # # #   #   #
# ### # ### ####### # # # ### # ### # # #
#   # #   #   #   # # #       #   # # # #
### # ### ##### # ### ########### # # ###
# # #   #     # #   #     #       # #   #
# # # # ##### # ### # ### # ##### # ### #
# # # # #     # #   #   # # #     #   # #
# # ### ####### # ### # # ### ####### ###
# #   #         # #   # #   # #     #   #
# ### ######### # ##### ### # # ### ### #
#   #   #   #   # #   # # # # #   # #   #
### # # # ### # # # # # # # # ### # # # #
# # # #   #   # #   # # # # # # # #   # #
# # # ##### # # # ### # # # # # # ### # #
#   # #     # # #   # # #   # # # # # # #
# ##### # ### # ##### # ### # # # # # # #
#       # #   #   #   # #   #   # #   # #
########### ##### # ### ############### #
#           #     # #   #             # #
####### ####### ### # ### ########### # #
#       #   #   #   # #       # #   # # #
# ####### # # ######### ### ### # ### # #
#         # #             #     #     # #
#########################################
