######### ###############################
#   #    .  #. .          #     # #     #
# # # ### ### # # ####### ##### # # #####
# # # #  . . .#.#   #   #     # #   #   #
# ### ######### ### # # ##### # ### # # #
#   # #. .#. . .  #   #     #   #   # # #
### # # # # ### # ### # ######### ##### #
# #   #.#.#.# # #   # #         #   #   #
# ##### # # # # ### ####### ### # ### ###
#   #  .#. .# #   #     # #   #       # #
### # # ### # ### ##### # ############# #
 . .# #. .# #     #   # #           # # #
### ### # ######### # # ########### # # #
#  . .# #. .#       #   #         #   # #
##### ### # ############# ####### ### # #
#    . .# #. .  #. . .    #     #   # # #
# ##### # ### ### ### ##### ### ### # # #
# # # #.# #. .#. .  #. .  #. .#   #     #
# # # # ### ### ####### ### # ###########
# # # #.#. .#. .#     #.#. .#. . .      #
### # # # # # ### ### # # ####### ##### #
#   #. .#.# #.  # # # #. .  #. . .    # #
# ### ### ### ### # # ####### ######### #
# #  . .#. . .    # #   #. .#. .#       #
# ##### ### ####### ##### # # # # # ### #
#   # #. .#   #. . . . . .#.# #.# # #   #
### # ### ##### # ######### ### # ### ###
#   #    .#  . .# #     #  . .#.# #   # #
# ####### ### # ### ### ##### # # # ### #
# #      . . .# #   # # #    . .# # # # #
# ########### ### # # # # ##### # # # # #
# #           #   # # # # #     # # #   #
# # ########### ### # # # # # ### ##### #
# # #           #   # # # # #   #     # #
# # # ##### # ####### # # # ### ### # # #
#   # #   # # #     #     #   #   # #   #
##### # # # ### ### ############# ##### #
#     # # # #   #   #     #     #     # #
# ##### ##### ##### # ### ### ####### # #
#     #       #       #               # #
#########################################
