################################### #####
#   #                    . . . . .#.    #
# # # ### ### ### ####### ####### # # # #
# # # #   # # #   #  . . .#. . .#. .# # #
# # # # ### # # ### # ### # ### ##### ###
# # # #     # # #   #.#   #.# #. .# #   #
# ### ####### # # ### ##### # # # # # # #
# #   #       # # #  . .  #.# # #.# # # #
# # ### ### ### # ### # # # # ### # ### #
#   #   #   #   #   # #.# #.  #. .#     #
##### # # # ##### # ### ### ### # #######
#     # # #     # #   #. . .#. .#   #   #
# ####### # # # ##### ####### ##### ### #
#   # #   # # #   # #   #. . .#     #   #
# # # # ### # ### # ### # ### ####### ###
# # #   #   #   #   # # #. .# #. . .  # #
# # ######### ####### # # # ### ### ### #
# #       #     #   # # # #. .#.#. .    #
# ####### ##### # ### # # # # # # #######
# #   # #     #       # # # #. .#. . .  #
# # ### ##### ######### # # ######### ###
# # #   #   # #       # # # #       #. . 
# # ### # ### # ##### # # # # ##### # ###
# # #   # #   # #       # # # #   # #   #
# # ### # # ########### # # # ### # ### #
# #   # # # #       #   # #       #   # #
##### # # ### ##### ##### ########### # #
#   # #       #   #       # #   #     # #
# # # # ####### # # ### # # # # # # ### #
# # # # #   #   #   #   # # # #   # #   #
# ### ### # # ####### ### # ### # # # # #
#   #     #   #       #   #   # # # # # #
### ########### ######### ### ### # # ###
# #       #     # #     #   # #   # #   #
# ####### ### # # # ### # ### # ### ### #
#             # #   # # #     #   # #   #
############### # # # # ########### # # #
#         #     # # # #   # #     # # # #
# ####### # ####### # ### # ### # ### # #
#       #   #       #           #     # #
#########################################
