##################################### ###
#     #   #            . .#      . . .  #
# ### # # ### ##### ### # # ##### # #####
# #   # #     #     #. .#.# #  . .# #. .#
# ### # ######### ### ### # ### ##### # #
#   # # #         #. .# #.#   #. . . .#.#
# # # # # ##### ### ### # ### ######### #
# # #   # #     #  .#   #.# #         #.#
####### # ##### # # # ### # ########### #
#   #   #   #   # #.#    . .#  . . . . .#
# # # ##### # # # # ####### ### # ##### #
# # # #     # # # #. .#    . . .# #. .# #
# ### # # ##### # ### # ##### ##### # # #
#     # # #     #   #.# #. .# #. . .#.# #
####### # ### # # # # ### # ### ##### ###
#   #   # #   # # # #. . .#.#. .#   #. . 
# # # ### # ### ### # ##### # ##### # ###
# # # #   # #   #   #   #. .#. .    #   #
### # ### # # ### ####### ##### ####### #
#   #   # # # #   #   #. .#. . .#     # #
# # ### # # # # ### # # ### ##### ### # #
# #   # # # # #   # # #. . .      #   # #
##### ### # ##### ### # # ############# #
#         #     #     # #             # #
# ### ##### # ######### ############# ###
# #   #     # #       #       #     #   #
### ### ##### # ####### # ### # ####### #
#   #     #   #       # #   # # #       #
# ### # # ### ####### # # ### # # ##### #
#   # # #   #       # # # #   # # #     #
# # # # ### ####### # ### # ### # # #####
# # # #   #       # #     #     # # #   #
### ##### ####### ####### ####### ### ###
#   #   #     # #   #     #   #   #   # #
# ### # ##### # # # # ####### # # # ### #
#   # # #   #   # # # #     #   # #   # #
### # ### ####### # # ##### ### # ### # #
#   # # #         # #     #     #   # # #
# ### # ########### ##### ########### # #
#     #                 #               #
#########################################
