################################# #######
#         #               #      . .    #
# ####### ### ### ####### ### ### # # ###
# #     #   # # # #     # #   #   #.#   #
# # ### ##### # # ##### # # ##### # ### #
# # # # #   #   #   #   #   #     #.# # #
# # # # ### ####### # ####### # ### # # #
#   # #   # #       #         # #. .#   #
##### ### # ### # # ########### # #######
#       # # #   # #   #       # #. . . .#
####### # # # ####### # ##### # ####### #
#   #   # # # #     # # #   # # #   #. .#
# ### ### # ### ### ### # ### # # # # # #
#       #       #     # #  . .#   # #.# #
##### ############### # ### # ##### # ###
#   # #   #     #   #   #. .#. .# # #. .#
# # # # ### ##### # ##### ##### # # ### #
# # # #           #      . .#. .#   #. .#
# # # ##################### # ####### # #
# #     #     #      . . . .#.#  . . .# #
####### ### # # ##### ####### ### ##### #
#   # #     #   #. . .#      . . .#   # #
# # # ########### # # ########### # # # #
# #  . . .#  . . .# # #           # #   #
# ### ### ### ####### # ########### ### #
# #. .#  . . .#   #   # #           #   #
# # ####### # # ### ### # # # ####### # #
# #. . .#   # #     #   # # # #     # # #
####### ##### ####### ### # # # ##### # #
 . . . .#     #   #   # # # # # #   # # #
####### # ##### # # # # # # ### # # # # #
#   #   # # #   #   # # # #     # # # # #
# ### ### # # ####### # ### ####### # # #
#     #   #   #       #   #     #   # # #
######### ####### ### ### ##### # ### # #
#           #     # # #     # #   #   # #
# ##### ##### # # # # ##### # ##### # # #
# #   # #   # # # #   #   # #       # # #
# ### # ### # # ####### # # # ######### #
#     #     # #         # #   #         #
#########################################
