################# #######################
#  . . . . . .#. .      #         # #   #
# # ######### # # # ### # ##### # # # # #
# #.#   # #. .#.# #   # #     # # #   # #
# # # # # # ### ##### # ##### # # ##### #
# #.# # #. .#  . .  # # #     # #     # #
### ### # ##### # # # ### ##### ##### # #
 . .#   #.#     #.# #       #   #     # #
##### ### # ##### # # # ####### ####### #
#. . . . .#   #. .# # #   #   # #       #
# ############# # # # ### # # ### #######
#. . .#    . . .# # #   # # #           #
##### ##### # ##### ### ### ######### # #
#    . .#  .# #       #   # #       # # #
# ##### ### ### # # ##### # ####### # # #
# #    . . .#   # #     # #   #     # # #
# # ####### # ### ##### # ### # ##### # #
# # #       # # # # #   #       # #   # #
### # # ##### # # # # ### ####### # ### #
#   # # #     #   # # #   #     # # #   #
# ##### # # ####### # ##### ### # # # ###
# #   # # #       # #     #   # # # # # #
# # # # ### ### # # ### ##### # # # # # #
#   # #   #   # #   # #     # # # # # # #
# ####### ### # ### # ### # # ### # # # #
# #         # #   # #     # # #   # # # #
### # ##### # ### ####### ### # ### # # #
#   # #   # #   #       # #   #   # # # #
# ### # # ### # ####### ### ##### # # # #
# #   # # #   #       #         #   # # #
# ### # # # # ####### # # ########### # #
# #   # # # # #   #   # #       # #   # #
# # ##### # ### ### ### ####### # # ### #
# #     #   #   # # # #       # #   #   #
# # ### ##### ### # # ### # # # ##### ###
# #   #     # # # # #   # # # # #     # #
# ##### ##### # # # ### ### # # # ##### #
# #       #     #   # #     # # # #     #
# ######### ######### ####### # # # #####
#                     #       #         #
#########################################
