############################# ###########
#     #       #        . . . .  #. . . .#
# ### ### ##### # ##### ##### ### ##### #
#   # #         # # #  . .#   #. .#. . .#
##### # ######### # # ### ##### ### ### #
#     # #         # # # #. . . .#. .#   #
# ##### # ### ##### # # ##### ### ### ###
#       # #       # # #     #   #.#   # #
# ####### ### # # # # ##### ##### # ### #
# #         # # # # #       #. .#.#     #
### ####### # ### # ######### # # #######
#   #       # #   # #    . . .#. .#. .  #
# ### ######### ### # ### ##### ### # # #
# #     #       # # #   #. . .# #. .#.# #
# # ### # ####### # ### # ### # # ### # #
# # #   #   #  . .#     # #. .# #.# #.# #
# ### ##### ### # ######### ##### # # ###
# #   #   #   #.#. . . . . .#. . .  #. . 
### ### # # ### ##### ##### # ######### #
#   #   # # #  .#. .# #. .# #.  #     # #
# ##### # # # # # # ### # # # ### ### # #
# #     # # # #.#.#. . .#.# #.#   #   # #
# ### ### ### # # ####### ### # ### ### #
#   # # #     #. .      #. . .  #   #   #
# # # # ##### # # ##### ######### #######
# # #   #     # #     #         #       #
# ####### ##### # ### ######### ####### #
#   #     #     # #   #       #       # #
##### ##### # # # ##### ### # ### ##### #
#     #   # # # #   #     # # # #     # #
# ##### # # # # ### # ##### # # # ### # #
#       # # # #   #     # # #   # # # # #
######### ### ### # # ### # ####### # # #
# #   #   #   #   # # #   #     #   # # #
# # # # ### # # ### ### ### # # # ### # #
# # # # #   # # #   #     # # # #     # #
# # # ### ##### ##### ##### # ######### #
# # # #   #     #     # #   #     #   # #
# # ### # # ##### ##### # ##### # # # # #
#       # #           #   #     #   # # #
#########################################
