####################### #################
#        . . .#    . . .          #     #
# ####### ### ##### # # # # ##### # ### #
# #      .# #. . .#.# # # #     # #   # #
# # ##### # ##### # ### # # # # # ### ###
# # #. . .#    . .#.#   # # # # #   #   #
# ### # ####### ### # # # ### ##### ### #
#   #.# #      . . .# # #   #   # #   # #
# # # # # ##### ### # # ### # # # ### # #
# # #.# # #   # #   # #   # # # #     # #
### # ### # ### # ### ##### ### ### ### #
#   #. .# #     # # #     # #     # #   #
# ##### # ####### # ##### ### # # ### ###
# #   #.# #     # #   #   #   # #       #
# ### # # # ### # ### # ### # # #########
#   # #.# # # #   #   #   # # # #       #
# # # # # # # ####### ##### ### # ##### #
# #   #.# #   #     #       #   # #   # #
####### # ######### ######### ### ### # #
#    . .# #         #         #       # #
# ### ### # ################### ####### #
# #  .#   #. . . . .    #           #   #
# # # ##### ####### ### # ######### #####
# # #. . . .      #.#   # # #   # #     #
# ######### ####### # # # # # # # ##### #
#         # #. .#. .# # #   # #   # # # #
####### # # # # # # # ##### # ### # # # #
#     # # # #.#. .# #       #   # #   # #
##### ### # # ##### ##### ##### # ### # #
 . .#   # # #. . .#     #     # #   # # #
### ### # ### ### ##### ##### ##### # ###
# #. . .#   #   #. . .#     #     # #   #
# ##### ### ######### ### # ### ### ### #
#     #. .#         #.  # #   #     #   #
##### ### ######### # # # ### ####### ###
#   # #  . . .#     #.# #   #           #
### # # ##### ####### # ### #############
# # #   #   #. . . . .#   #     #       #
# # ##### # ############# ##### ####### #
#         #                   #         #
#########################################
