####################################### #
#         #       #     #          . . .#
##### ### ### ### ### # # ######### ### #
#     #       # #   # # # # #      . .# #
# ############# ### # # # # # ##### # ###
# #           #   #   # # # # #     #. .#
# ####### ### ### ### ### # # # ##### # #
#   #     # #             #   # #     #.#
### ##### # ########### # ##### # ##### #
#   #     #             # #     # #   #.#
# ### # ### ############# # ### # ### # #
# #   # #         #   #   #   # #   # #.#
# # # ### ####### ### ### # # ##### # # #
# # #   # #     #     #   # #     #   #.#
### # # # # ########### # # ##### ##### #
#   # # # # #           # # #     #  . .#
# ##### ### # ######### ### # ### # # # #
# #   #   # # #       # #   # # # # #.# #
# # # ### # # # ######### ### # # # # ###
#   #   # # # #   #   #   #   #   # #. .#
####### # # # ### ### # ### # ##### # # #
#     # # # #         # #   # #     # #.#
# ### # # # ### ####### ### # ##### # # #
#   # # # # # #   #     #   #   #   # #.#
### # # # # # ### ##### # ##### # ##### #
#   # # # # # #   #     # #   # # #  . .#
# ### ##### # # ### ####### # ### # # # #
# #   #     # # #   #       #     # #.# #
### ### ##### ### ### ##### ####### # ###
#   #   # # # #   #   #     #     # #. .#
# ### ### # # # ### # ####### ### # # # #
# # #     # #   # # # #       # #   # #.#
# # # # ### ##### # # # ####### ##### # #
# #   #     #     # # # #. . . .# #   #.#
# # ############# # ### # ##### # # ### #
#         #     # # #   #.#    . .# #. .#
######### ##### # ### ### ####### ### # #
#       #   # #       #. .#     #. . .# #
# ######### # ######### # # ### ####### #
#                      .# #   #         #
####################### #################
