############################# ###########
#   #     #         #        . .    #   #
# # # ### # # ##### # # # ##### ### ### #
# #   # # # # #   # # # # #  . .  #     #
####### # # # ### # ### ### # ###########
 . . .# # # #   #     #   # #. . . . . .#
##### # # ##### ##### ### ############# #
#   #. .#     #   # #     #. . . . . .#.#
# ##### ##### ##### ####### ######### # #
#      .#. . .#    . .#    . .#     #. .#
####### # ### ##### # ####### ##### # # #
#      . .#  . . .#.#. .#. .#. .  #   # #
# ### # ######### # ### # # ### ####### #
# #   # #       #. .#  . .#. . .#       #
# # ##### ##### ############# # # ##### #
# # #   # #                   # # #     #
# # # # # ##################### # # ### #
# #   # # #   #               # # #   # #
# ##### # # # # ############# # # ### # #
#     # #   # #   #   #     #   #   # # #
##### # # ### # # # # ##### ####### # # #
#     # #   # # # # #   #   #       # # #
# ##### ### # # # ##### ### # # ### # ###
# #     #   # # #     #     # # # # #   #
### ########### ##### ##### ### # # # # #
#   #         #     #     #     #   # # #
# ########### ########### # ### # ### # #
#       # #       #     # # #   # #   # #
# # ### # ####### # ### ### # ##### ### #
# #   # #     #     #     # # #     #   #
# # ### ##### ########### ### ######### #
# #   #     #         # #     #   #     #
# ######### ######### # ### ### # ### # #
# #       #           #     #   #     # #
# ### ##### ##### ########### # ####### #
#     #   #     #       #     # #     # #
# # ### # ##### ######### ####### ### # #
# #   # #   # # #       # #   #   #   # #
# ##### ### # # # ##### # # ### ####### #
#       #   #   #     #   #             #
#########################################
