######### ############################# #
#. . . . .#            . .#    . . . . .#
# ##################### # ##### ####### #
#.#   #  . . . . . . .#.#. . . .# #     #
# ### # # ########### # ######### # # # #
#.#. .# #. .#     #  . .#         # # # #
# # # ### # # ### # ### # ######### # # #
#. .#. .# #.#   # #   # #           # # #
# # ### ### ### # ##### ########### ### #
# # # #. . .  # #       #           #   #
### # # ####### ### ### # ########### # #
#   # # #       #   #   #   #       # # #
# ### ### ### ### ### ##### # ##### # # #
# # #     #   #   #   #   # # # #   # # #
# # ##### ##### # # # ### ### # # ### # #
# #       #   # # # # #       #       # #
# ######### # # # # # ################# #
#   #       #   # # #   #       #   #   #
# # # ##### ##### # # # # ##### # ### # #
# # # # #   #   # # # # # #   # #   # # #
# # # # # ### # ### # # # ### # ### # # #
# # # #   #   #     # #       #   #   # #
# # # ##### ####### # ### ##### # #######
# # #     #     #   #   # #     #     # #
# ##### # ### # ####### ### ### # ### # #
#     # #   # #       #   #   # # #   # #
##### # ### ### ##### ### # ### # # # # #
#     #   #   # #   # # # # #   # # # # #
# ### # ##### ### ### # # # # ### # # # #
#   # #     #     #   # # # # #   # # # #
### # ################# # # # # ### ### #
# # #           #       # # # # #   #   #
# # ####### ### # ####### # # ### ### ###
#   #     #   # # #     # # #   #   # # #
##### ### ### # # # ### # ##### # # # # #
#   # # #     # # # #     #     # #   # #
# ### # # ### # # # ##### # ### # ##### #
# #   # # #   #   # #     # #   #     # #
# # # # ### ####### # ##### ########### #
#   # #     #       #     #             #
#########################################
