### ##################### ###############
#  .#. .        #       #.#       #     #
# # # # # ##### # ##### # # ##### # # ###
# #. .#.#     # # #     #. .#   # # #   #
####### ### ### # ######### # # ### ### #
#. . .#. .#   # # #. . . . .# # #   # # #
# ### ### ### ### # ########### # ### # #
#.#  . .#.  #   #  .#           # #   # #
# ##### # # ### ### # ########### ### # #
#. .#  . .#   #   #.#   #       #   # # #
# # ######### ### # ### ### ### ### # ###
# #.#     #   #   #. .#   #   #. . .#   #
# # # ### # ### ##### ### ### # ### ### #
# #.#   # # # # #   #. . .#   #. .#. .# #
# # ##### # # # ### ##### ####### ### # #
# #. . .#   # #     #   #. . . .#. .#.# #
# ##### ##### ####### ######### ### # # #
#   #. .    #. . .#. . .  #. .#. . .#.# #
# # # # ##### ### # ### # # # ####### # #
# # #.#   #. .# #. .#. .# #.#. .  #. .# #
# # # ##### ### # ### # # # ### ### ### #
# # #. . .#. .  #   #.# # #. .#. . .# # #
# # # ### ### ####### # # ### ####### # #
# # #   #.#. .#. . . .# #   #. .#. . .# #
# # ### # # ### ########### ### # ### # #
# # #   #. .# #. .#         #  . .# #.# #
# # ##### # # # # ################# # # #
# #     # #   # #. .#. .  #       #. .# #
# # # # # ######### # # # # ####### ### #
# # # # #         #. .#.# #. . . . .  # #
# # # ####### ### ##### # # ########### #
# # #       #   #     #.# #.#           #
# # ##### # ##### ### # ### # ###########
# #     # #     # # # #. . .  # #       #
# ##### # ##### # # # # ### ### # ### # #
#     # #   #   #   # #   # #       # # #
##### # ### ######### ### ### ####### # #
# #   #   #   #       # # #       #   # #
# # # ### ### # ####### # # ####### ### #
#   #   #   # #         #   #       #   #
#########################################
