####################### #################
#       #       #   #  . . .    #. . .  #
# ##### ##### # # ### # ### ##### ### # #
#   #       # # # #   #   #. . . .  #.# #
### ####### # ### # ############### # # #
# #   #   # #   #   #. . . . . . .# #.# #
# ### ### # ### ##### ########### # # ###
 . .#   #. . . . . .#. . .# #. . .# #. .#
### ### # ######### ##### # # ##### ### #
# #.# # #.#   #   #. . . .#. .#   #   #.#
# # # # # ### # ########### ##### ### # #
#  .#   #.#   #. . .  #. . .      #   #.#
### ##### # ### ### ### ########### ### #
#  . . . .#   #. .#. .#. .#         #  .#
# ##### ##### ### ### ### # ##### ##### #
# #     #   #    . .#. . .# #     #  . .#
# # ##### # ####### ####### ####### # # #
# # # #   #       #. .#   #       # #.# #
# # # # ######### ### # # ####### # # # #
# # # # #     #   # #.# #   #     # #.# #
### # # ##### # ### # ##### # ####### ###
#   # #     # # #. .#.#. . .# #. . .#. .#
# # # ##### # # # # # # ### ### ### ### #
# # # # #   # # #.#. .#.#  . . .# #.#. .#
# ### # ##### # # ##### # ####### # # # #
#     #   # # # #. .#  .#   #. .# #.#.# #
######### # # # ### ### ##### # # # # ###
#       # #   #    . .#. . .#.#.# #.#. .#
# ####### # ######### ##### # # # # # # #
#   #   #   #       #. . .#. .#.#. .# #.#
### ### # ### ##### ##### ##### # ##### #
# #   # # #   #   #      . . . .#.#  . .#
# ### # # ### # # ############### # # # #
#     #       # #   # #   #. . . .# #.# #
# ############### # # # ### ####### # # #
# #               # # #   #.#. . .# #.# #
# ### ####### ##### # ### # # ### ### # #
# #   # #     #     #   #  . .#  . .#.# #
# # # # # ### ##### # # ########### # # #
#   # #   #       #   #            . .# #
#########################################
