################### #####################
#     #            . .    #             #
# ### ### ##### ##### # ### # ### ### ###
# #       #     #  . .#     #   #   #   #
# # ############# # # ####### # ##### # #
# # #         #   #.#     #   # #   # # #
# ### ##### # # ### ####### ### # # # # #
#     #   # # # # #. .  #   #   # # # # #
######### ##### # ### # # ### ##### # # #
#    . .#   #   # #. .# #   #       # # #
##### # ### # ### # # # # # ########### #
#. . .#. .# #     #.# # # #         #   #
# ####### # ####### ### ####### ##### ###
#.#. . .#. .#    . .#   #   # # #   # # #
# # ### ### ##### # # ### # # # # ### # #
#. .  #.#  . . .#.# # #   #   # # #   # #
# ##### ####### # # # # ####### # ### # #
# #. . .#   #. .#.# #   #       #   # # #
### ### # # # ### # ##### ##### ### # # #
 . .#   # # #. . .# #     #   # # #   # #
##### ### # ### # # ####### ### # ##### #
# #   # # # #   # #   #   #     # #     #
# # ### # ### ### # # # # ####### # #####
# # # # #     #   # # # #       #       #
# # # # ####### ### # # ##### ### #######
# # # #   #       # #       #       #   #
# # # ### ##### # # ####### # ### ### # #
# # # #         # #     #   #   # #   # #
# # # ##### ##### ##### ##### # # # ### #
#   #   #   #         #     # # # #   # #
# # ### # ### ### # # # # # ### ##### # #
# # # # # #   # # # # # # #   #       # #
### # # ### ### # # # # # ### ######### #
#   #       # #   # # # #   #     # #   #
# ########### ##### # ### # ####### # ###
# #   #     #       #   # #       #   # #
### # ##### ##### # # # ######### ##### #
#   #   #     #   # # #     #   #   #   #
# ##### ##### ### # ####### ### # # # ###
#     #           #       #     # #     #
#########################################
