############# ###########################
# #   #    . .    #. . . .  #. . .  #   #
# # ### ### ##### # ##### ### ### # ### #
# # #   # #.#     #.#. .#. . .  #.#   # #
# # # ### # ####### # # # ##### # ### # #
 . .#     #. . . . .#.#.#     # #. .#   #
### ################# # ##### # ### ### #
#  . . . . . . . .#. .#. .#   # #. .  # #
################# # ##### ##### # # # ###
#   #            . .#    . .#   #.# #   #
# ### ########### ######### ##### # ### #
#     #   #     # #       #. . .#.#   # #
####### # ### # ### ##### ##### # ##### #
#       #     #     #          . .  #   #
# # ######### ################### ### # #
# # #         #                   #   # #
# ############# ######### ######### # # #
# #             #     #   #   #     # # #
# # ##### ######### # # # ### ##### # # #
# #   #   #         # # #     #   # # # #
# # # ##### ##### ### ######### # # # # #
# # #     #   #   # #           #   # # #
# ### # ####### ### ### ##### # ##### # #
#   # #     #   #   #   #     # #     # #
### ### ### # ### ### ### ### ### ##### #
# #   # # # #   #     # # #   #   #     #
# ### # # # # # ####### # # ### ##### # #
# #   # # # # #         # #   #   #   # #
# # # # # # # # ##### ### ### ##### ### #
# # # #   # # #   #     #   # # #   # # #
# # # ####### ### ######### # # # ### ###
# # # #       # #         # # # #   #   #
# # # # ####### ########### # # # # ### #
#   # # #     # #           #   # #   # #
# ### # ##### # # # ############# # # # #
# #   #     # # # # #           # # #   #
### ####### # # # # # ######### # # #####
#   #     # # # # # # #         # #     #
# ### ### # # # ### # ### ####### ##### #
#   #   #   #       #   #         #     #
#########################################
