######### ###############################
#        .                          # # #
# ####### ####### # ######### ####### # #
#   #. .#. . .  # #         # #         #
##### # # ### # ##### ####### # #########
#. . .#.#   #.#   # #     #   # #       #
# ##### ##### ### # ### ### ### # ##### #
#.#. .#. .#. .  # #   # #   #     #   # #
# # # ### # # # # ### # # ### ##### # # #
#. .#. .#. .# # #     # #       #   # # #
####### # # # # # ##### ##### ### ### # #
 . . .#.# # # # # #         # #   #   # #
##### # ### # # ### # ##### ### ### ### #
# #. .#.#   # #   # #     #   # #   # # #
# # ### # ### ### ##### # # # ### ### # #
# #.#  .# #   # #     # # # #   #   #   #
# # # # ### ### ####### # # # # # ##### #
#. .# #.#   # #         # # # #     #   #
# ##### # # # ##### ##### # ##### # #####
#. .#. .# # #       # #   #     # #     #
### # # # ######### # # # ##### ##### # #
#  .#.# #       #   #   #     # #   # # #
### # # ### ### ############# # # ### # #
#  . .#   #   #           #   # # #   # #
# ### ### ##### ##### ### # ### # # ### #
#   #   #     #     #   # #   # #   #   #
### ### ##### ##### ### # ### # #########
# #   #   #   #   # #   #   # #         #
# ####### # # ### # # # ### # # # ##### #
#   #     # #   # # # # #   # # #   #   #
### # ##### ### # # ##### # # ### ### ###
# # #   #     #   # # #   # #   #   #   #
# # ##### # # ##### # # ####### ### ### #
#       # # # #     #   # #     #     # #
####### # # # # ######### # # ### ##### #
#     #   # # # #       #   # #       # #
# ### ##### # # # ##### ####### # ### # #
# #       # # #   #   #       # # # # # #
# ####### # # ##### ##### ### # # # # ###
#       #   #       #     #   # #   #   #
#########################################
