########### ############# ###############
#          . . .  #. .  #.#  . . .#  . .#
# ### # ### ### ### # # # ### ### # # # #
# #   # #   # #. . .#.# #. .#.#  .# #.#.#
# # ### # ### # ##### ##### # ### ### # #
# # #   # #   #     #. .  #.#. .#. . .#.#
# # ##### # ######### # ### ### ####### #
# #     #   #       # #. .#. . .#. . . .#
# # # # ##### ####### # # ####### #######
# # # # #     #       # #. . . . .      #
# ### ### ##### ### # # ### ### ####### #
#   #   # #   # #   # #   #   #       # #
### # # # # ### # ### ### ### ### # ### #
# # # #     #   #   #   #   #   # #   # #
# # ##### ### # ######### # # # # ### # #
# # #   # #   # #   #     # # # #   # # #
# # # # # # # ### # # # ##### # ##### # #
# # # # # # # #   # # # #     # #     # #
# # ### # # # # ##### # # ### ### ### # #
# #     # # # # #   # # # #   #   #   # #
# ##### # # ### # # # ### # ### ####### #
#     # # #     # # # #   # #   #       #
##### ### # # # # # # # ### # # #########
#         # # # # #   # # # # # #       #
# ##### ### # ### ##### # # # ### #######
# #   # #   #   #   # # #   # #   #     #
### # # # ##### ### # # ##### # ### ### #
#   #   #     # #   # #     #   #   # # #
# ######### # # ##### # ############# # #
# #   #     # #     # #             #   #
# ### # # ### # # # # # ### ### ### # ###
#     # #   # # # #   #   # #     # # # #
# ####### # # # ######### # # # ### # # #
# #     # # # #         # # # # #   # # #
### # # ### # ########### # ### # ### # #
#   # #   # #     #       #   # #       #
# ### ### # ##### ### # ##### ###########
#   #   #     #   #   # #   # #         #
# # ### ####### ### ##### # ### ### ### #
# #   # #       #         #       # #   #
#########################################
