################################# #######
#   #           #     #          . . . .#
# # ### ##### # # ##### ### ##### ##### #
# #     #     # # #     #   #   # # #. .#
# ######### ### # # ##### ##### # # # # #
# #     #   # #     #           #   #.# #
### ### # ### ##### # ### ### ####### # #
#   #     #         #   #   # #    . .# #
# ######### ######### # ### ### ### #####
# #     #   #   #   # # #   #   #. .#. .#
# # ####### # # # ### # # ### ### # # # #
#   #       # # # #   # #   #   #.# #.#.#
####### ##### ### ##### ### # # # ### # #
# #     #         #   #   # # # #. .#.#.#
# # # ### ######### # ### # # # # # # # #
# # #   # #     #   # #   # # # # #. .#.#
# # ### # ##### # ### # ### # # ### ### #
# # #   #     # #   # # #   # #   #   #.#
# ### ####### # # ### # # ####### ##### #
#     #   #     # #   # # #       #. . .#
####### ### ##### # ### # ### ##### ### #
# #   #     #     # # # # #   #    .#   #
# ### ##### # ##### # # ### ### ### #####
# # # #   # # # # # # # #   #   #  . . .#
# # # # # # # # # # # # # ####### # # # #
# # # # # # #     #   # #       # # # #.#
# # # # ### ### ####### # ##### # # ### #
# #   #   #   # #   #   # #   # # # #. .#
# # ##### ### # # # ### ### ##### ### # #
#   #   #   # # # #   #     #     #. .# #
# ### ##### # # # ### ####### ##### ### #
# # #     # #   # #           #  . .# # #
# # ##### # ### ### ### # ####### # # # #
# #     #     #     #   # #    . .# # # #
# ##### ### # ##### ##### # ### ### # # #
# #       # #   # # #   # # #  . .# #   #
# ### ### ##### # # # # # # ### # # #####
#     # # #     #   # # # # #   #.# #   #
##### # # ##### ##### # ### # ### # ### #
#     #               #     #   #.#     #
################################# #######
