############# ###########################
#        . . .#. . .  #. . . . . . . .  #
# ### ### ##### ### # # ############# ###
# #   #  . .#. .  #.# #.        #   #. .#
# ### # ### # ### # ### ######### # # # #
#   # #   #. .  # #. . .          # # #.#
### # ####### # # ### ############# ### #
#   # #     # # #   #   #. . . .#   #. .#
# ### # ### # # ### ##### ##### ##### ###
# #   # # # # #   #     #. .#  . . .#. .#
# # ### # # ### ####### ### ####### ### #
# # #     #   #   #   #   #.#. .#  . . .#
# # # ##### # ### # # ##### # # ####### #
# #   #   # #   # # #  . . .#.#. .#   # #
# # ##### # # # # # ### ### # ### # # # #
# #       # # # # # #. .#   #.# #.# # # #
# ######### # ### # # # # ### # # # ### #
# # #       # #   # #.# #   #.# #.#     #
# # ########### ### # ##### # # # #######
# #   #         #   #. .#   #.  #. .    #
# ### ### # # ### ### # ##### ##### #####
# #     # # # #   #   #. . . .    #. . . 
# ##### # ### # ####### # ####### #######
# #   #   #   # #     # #       #       #
# # # # # # ### # ### # ####### ####### #
# # #   # #   #     # #       #     # # #
# ####### ### ##### # ##### # ##### # # #
#       #   #   #   #     # #     # # # #
# # ########### # ##### # # ##### # # # #
# #     #       # #     # #     # # #   #
# ####### # ##### ##### # # # ### # #####
#     #   # #   #     # # # # #   #     #
##### # # # # ####### ### # # # ##### # #
#   # # # # #   # # # #   # # # #   # # #
# # ### # # ### # # # # ##### # ### # # #
# #     # # # # # #   #   #   #     # # #
# ######### # # # ####### # ######### # #
# #     #   # # # #       # #   #     # #
### ### # # # # # ######### # ##### ### #
#   #     # #               #       #   #
#########################################
