####### ############# ###################
#. . .#. .          #.# # #   #       # #
# ### # # ########### # # # ### ##### # #
#.# #.# #. . .  # #. .# # #     #     # #
# # # ####### # # # ### # ####### ##### #
#.#  . . . .#.# #. .    #       # #   # #
# ######### # ### ####### ####### # ### #
#.#. .#    . .#. .      # #   #   #     #
# # # ##### # # ####### # # # # ##### # #
#. .#.#. .# # #.# #   # # # # # #     # #
# # # # # ### # # # # # # # ### # # ### #
# # #.#.#. .# #.# # # # #   #   # # # # #
# ### # ### ### # # # ##### # ##### # # #
#   #.#.  #. .#.# # #     #   # #   # # #
### # # ##### # # # ### ### ### ##### # #
#   #. .    #.#.  #   #     #           #
# ##### ### # # ### ######### ###########
#     # #   #. .    #         #         #
# ### # ##### ####### ######### #########
#   # #     #         #         #       #
##### ##### ######### # ##### ### ##### #
#   #     #     #   # # #   #         # #
# ### # ### ### # ### # # ########### # #
# #   #   #   # #     # #         # # # #
# ####### ### ######### # ######### ### #
#           #   #           #     #   # #
####### # # ### # ######### # ### ### # #
# #     # #   #           # #   #   #   #
# # # ### ### ########### ### ##### #####
# # # #     #           # #   #   # #   #
# # ### # ############# ### ### # # ### #
#   #   # #         # #         # #     #
# ### ### # ##### # # ########### #######
# #   #         # # #       #   #     # #
### ############# # ####### # # ### # # #
#   #   #   #     #         # #   # # # #
# ##### # # # ### # ### ##### ##### # # #
# #   #   #   #   #   # #   #     # # # #
# ### ######### # ### ### # ##### # # # #
#     #         #   #     #     #   #   #
#########################################
