### #####################################
#  .#. . . . .  #. .      # #. .      # #
# # # ##### # ### # ##### # # # ##### # #
# #. .#. .# #. . .#.  #   # #.#. .  #   #
####### # # ####### # # ### # ### #######
 . . .#.#.#   #   #.# #   #. .  #. . .  #
##### # # ### ### # ####### ####### # # #
#   #. .#.  #   # #. . . . .  #. .# #.# #
# ####### ##### # # # ######### # ### # #
# #. . . .#   #   # # #   #   #.#.#. .# #
# # ####### ####### ### # # # # # # # # #
# #. .#   #       #     #   # #.#. .# # #
# ### # ######### ########### # ##### # #
# #  .#  . . .# #      . . .# #.#   # # #
# ### ### ### # ####### ### ### # # # # #
#    . . .#  . . .#  . .# #. . .# # # # #
####### ##### ### ### # # # ### # # ### #
# #     #   # #  . . .# #   #   # #     #
# # # ### # ### # ########### ### # ### #
#   # # # # #   # #     #     #   # # # #
##### # # ### ### # ### ### ### # # # # #
#   # # #     # # #   #     #   # # # # #
# # # # ####### # ### ####### ### ### # #
# # # #   #   # #   # #       #       # #
# # # ### ### # ### # # ####### # ### # #
# # #   #   # #   # # #   #     #   # # #
### # # ### # ### # # ### ######### ### #
#   # # # # # #   # #   #     #   #   # #
# ### # # # # # ### # # ##### # ##### # #
#   # # # # #   #   # #   # # #   #   # #
### # # # # # ### ####### # # ### # ### #
# #   # #   # #   #     #   # # #   #   #
# ##### # ### # # ##### ##### # ####### #
#       #       # #   #       # #       #
############# ### # ########### # ### # #
#     # #     #   #   #     # #   #   # #
# ### # # ### # # ### ##### # ##### # # #
# #     #   # # # #   #   #     #   # # #
# ##### ##### # ### ### # ##### # ##### #
#     #       #     #   #         #     #
#########################################
