################################### #####
#       #         # #     #      . .    #
### ### ### ##### # # ### # ##### # # # #
#   # #     #   # # # #   # #    .# # # #
# # # ######### # # # ##### # ### # ### #
# # #         # # #       # # #. .# #   #
# # ######### # # ####### # # # ### # ###
# #   #     # # #           # #. .# #   #
# ### # ##### # ############# ### # ### #
#   # # #     #   #         #   #.# #   #
##### # # ####### # # ##### ### # ### ###
#   #   #           # #   #     #. .#   #
# # ################### # ####### # ### #
# # #     #         #   #. .#. .# #.  # #
# # ### # ##### ##### ### # # # ### # # #
# #   # #     # #     # #.#. .#. . .# # #
##### # ##### # # ##### # # ### ##### # #
#   #   # #   # #       #.# #   #     # #
# # ##### # ### ######### ### ### ##### #
# #     # #          . . .#   #   #     #
# ##### # ########### ##### ### ### ### #
#     #     #    . . .#     #   #   #   #
# ### ##### # # # ### # ##### ####### # #
#   #   #   # # #. .# #   #   #       # #
### ### ### ### # # ##### # # # # ##### #
# #   # #       # #. . .# # # # # #     #
# ####### ####### # ### # ### ##### #####
#         #     # #   #.#   #   #   #   #
### ####### ### # ##### ### # # ####### #
#   #   #   #     #. . .  # # #       # #
# # # # # ######### ### # # ### # ### # #
# #   # #     # #  .#   # #   # #   #   #
# ##### # ### # # # ######### ##### #####
# #     # #   #   #. .  #. .#     #     #
### ####### # ### # # ### # ####### #####
#   #       # #   # #. . .#. . . .#     #
# ### ### # # ##### ######### # # #######
#   #   # # #     # #       # # #. . .  #
# # ##### ####### # ####### # ####### # #
# #     #       # #         #       #.# #
##################################### ###
