################# ##### #################
# # #          . .    #.#     # #       #
# # # ##### ### # ### # # ### # # ### ###
#   # #     #  .#   # #.# #   #   # #   #
# ### ### # # # ##### # ### ### ### ### #
# # #   # # # #. . .# #. . .#   #   # # #
# # ### # # # ##### # ##### # ### ### # #
# # #   # # #   # #.#   #. .  #       # #
# # # ### ##### # # ### # ########### ###
#   # # #     # # #.#   #.#         #   #
# ### # # ### # # # ##### # ####### ### #
# #   # # #   #   #. .  #.  #   #   # # #
# # ### # # ######### # # ### # # ### # #
# # #   # #         #.# #.#   # #   #   #
# # # ### # ####### # # # # ### ##### ###
# #   #   # #       #.# #.  # #     # # #
# ######### # ####### ### ### ##### # # #
# #       # # #. .#. .#. .#     #   # # #
# # ##### ##### # # ### ### ### # ### # #
#   #   # #    .#. .#. .#   #   # #     #
##### ### # ### ### # ### ### ##### #####
#   #       #  . .# #. . .#   #         #
# ####### # # # # ####### ##### ####### #
#     #   # # # #.#. . . .      #   #   #
##### # ### # # # # ##### ####### # #####
#   #   #   # # #. .#   #         #     #
# ####### ### # ##### # ##### ######### #
#   #       # # #     #   # #   #     # #
### ####### # # # ##### ### ### ##### # #
#   #       # # #     #       #     #   #
# ### ####### # ##### ######### # #######
# # # #       #       #   #   # #       #
# # # ### ##### # ### # ### # ##### ### #
# # # #   #   # #   # # #   #       #   #
# # ### ### ### ### ### # ######### # ###
# #   #   # #     # #   #       #   # # #
# ### # # # # ##### # ### # ##### ### # #
# #   # # # # #     #   # # #   # # # # #
# ### ### # # # ####### # ### # # # # # #
#         #   #         #     # #   #   #
#########################################
