######################### ###############
#   # #      . . .#  . .#.  #. .        #
### # # ### # ### ### # # ### # ##### # #
#   #   #   #.#  . . .#.#. . .#. .# # # #
# ####### ### # ####### # # ##### # # # #
#     #   #  .# #     #.# # #   #.#   # #
##### ### # # # # ##### # ### # # #######
#         # #.# #     #.#   # # #. .    #
########### # ####### # ### # # ### ### #
#       #   #.#. . .#  . .#   # #. .  # #
# ####### ### # ### ##### ####### # ### #
# #       #  . .  #. . .#. . . . .# #   #
# # ##### ### # ####### ### ######### # #
#   #     #   # #     #. .# #   #     # #
##### ##### ### # ### ### # # ### ### # #
#   # #     #   #   # #. .# #     #   # #
# ### # # ######### # # # # ### ####### #
#     # #           # #.# # #   #       #
######### ########### # # # # ### #######
#       #   #   #     #.# # #   # #     #
# ##### ##### ### # ### # # ##### ##### #
# #   #     #   # # #  .# #   #   # # # #
# # ####### ### ##### # # # # # ### # # #
#   #. . .#   #       #.# # # # # #     #
##### ### ### ######### # # # # # ##### #
 . . .#  .#. . . . . . .# # # #   #     #
######### # # ### ### ### # # ##### #####
#       #. .# #   #   #   # #     # #   #
####### # ### # ### ### # # ### # # ### #
#   #   # #   # #   #   # #   # #       #
# # # ### # ### ### # ### ### ###########
# # #   # #   #   # #   #   #   #     # #
# ##### ######### # # # ### ### ##### # #
# #           #   # # # # # #   #       #
# ########### ##### # # # # # ### #######
#         #         # # # # #     #     #
######### ####### ### # # # ########### #
# #   #     #     #   # #   #   # #     #
# # # ##### ####### ### ##### ### # #####
#   #               #                   #
#########################################
