############### #########################
#   #          .            #       #   #
# # ### ##### # ### ####### ####### ### #
# #     #     #.#     #   #     # #     #
# ####### ##### # ##### # # ### # ##### #
#   #   #   #  .# #     # # #   # #     #
### # ##### # # # ####### ### ### # #####
# # #     # # #.#       #     #   # #   #
# # ##### # ### ####### ####### ### # ###
# #       #   #. .  # #     # # #   #   #
# ########### # # # # # ### # # # ### # #
# #     #     # #.#   #   # #     #   # #
# ### ##### ##### ####### # # ##### ### #
#         # #  . .#. .  # # # # #   # # #
######### # # # ### # # # ### # # ### # #
# # #   # # # #. .#.#.# #       # # # # #
# # # # # # # # # # # ##### ##### # # # #
# # # # #   # # #. .#. .  #     # # # # #
# # # ### # # # # ##### # ### # # # # # #
#   #   # # # # # #   #.#   # # #   # # #
### ### ### # # ### # # ### # ### ### # #
#   # #     # #     # #.# # #       # # #
# ### ####### ######### # # ### ### # # #
# #       # #     #. . .# #   # #   # # #
# ####### # # # # # ### # # # # ##### # #
#     # # #   # # #.#   #   # #       # #
##### # # ####### # # ### ### ######### #
# #   #   #       #.#   # #     #   #   #
# # ##### ### ##### ### # # ### # # # # #
# # #         #    .  # # # #   # #   # #
# # ############### ### # # # ### ##### #
#   #      . . . . .#   # # # # # #     #
# ### ##### ####### # # ### # # # #######
#     #  . .#     # # # #   #   #       #
# ##### # # # ### ### # # # ########### #
# #   # #.# #   # #   # # # #       # # #
# # # # # # ##### # ### # # # # ### # # #
# # # # #.# #. .# # # # # # # #   #   # #
# # ### # ### # # # # # # ### ### ##### #
# #     #. . .#.#   #   #       #     # #
############### #########################
