############################# ###########
#          . . .#    . .#. .#. . .      #
# # ####### ### ##### # # # ### # # #####
# # #      . .#. .#  .#. .#. .# #.#     #
# ### ####### ### # # ####### ### ##### #
#   # #     #.# #.# #.#      . .#.    # #
### ### ### # # # ### ######### # ##### #
# #     #   #.#  . .#.#     #  .#.#     #
# ####### ### ##### # # ### ### # # ### #
 . . . .# #. .#    . .#   #    . .# # # #
####### ### # # ##### ########### # # # #
#      . . .# # # #   #       #   # #   #
# ######### # # # # ##### ### ##### #####
#   #       # # # # #   #   #           #
### # # ##### # # # # # # # ##### # ### #
# # # # #     #   # # # # # #     #   # #
# # # ### ### # ### # # ### ####### ### #
# # #   # #   # #   # #   # #       #   #
# ##### ### ##### # # ### ### ####### ###
# #     #   #   # # # #     # # # # #   #
# # ##### ##### # # # ##### # # # # # # #
# #   # #     #   # #     #   #   # # # #
# ### # # # # ##### ########### ### ### #
#   # # # # #   #         #         #   #
### # # # ### # ####### ### ######### # #
#     # #   # #       #   # #     #   # #
####### # # ### # ### # # # # ### # # # #
#       # #   # # #   # #   # #   # # # #
# ####### ### # ### # # ### ### ##### # #
#     #   #   #   # # #   # #   #     # #
##### ##### # ### # ##### # # ##### ### #
#           #   # #     # # # #     #   #
####### ######### # ### # ### ### ### ###
#       #       # # #   #   # #   #   # #
# ####### ##### # # # ##### # # ### ### #
# #       #     # # # #   #   # # # #   #
# ######### ##### # # # # ##### # # # ###
#     #   # #     # # # #   #   #   # # #
##### # ### ### # # ### ### ######### # #
#     #         # #       #             #
#########################################
