############### #########################
# #   #      . .  #. . . . .            #
# # # ### ### ### # ####### # ##### ### #
# # # #   #. .#   #.  #   #.#     #   # #
# # ### ### ####### ### ### ### ##### ###
# # #   #  . . . . .    #. .  #     #   #
# # # ##### # ########### ####### ##### #
#   #   #   #   #. . .#. .#     #   #   #
# ##### # ####### ### # # # ### ### # ###
#     # # #. . . .# #.#.# # # #     #   #
##### # ### # ##### # # ### # ###########
 . .#   #. .# #     #.#. .# #. . .      #
### ##### ##### ##### # # ### ### ##### #
#  . . . .#   # #  . .# #. . .  #. .#   #
# ######### ### ### ############### # ###
# #           #   #.#  . . . .#. .#.#   #
# # ############# # ### ##### # # # ### #
# #     #       #  . .#.#. . .#.#. .# # #
# ##### ####### ##### # # ##### # # # # #
# #                 #. .#.#. . .# # #   #
# ################# ##### # # # # # # # #
#     #       #   #     #.#.# # # # # # #
# # # ####### # # ##### # # ### # # ### #
# # #       # # #     #  . .#   # #   # #
# # ####### # # ############# ### # # ###
# #     #   #   #             #   # #   #
# ### # # ##### # ### ######### ####### #
#   # # #     # # #   #         #   #   #
# # ### # ### # ### ### ### ##### # # # #
# # #   #   # #     #   #   #     #   # #
# ### # ##### ######### ##### ### ##### #
#   # # #   # #     # #     # #   #   # #
### # ### # # # ### # ##### # # ### # # #
# # #     # # # #   # #     # #   # #   #
# # ####### # # ##### # # # # # # #######
# #   #     # #         # # # # #       #
# ### ####### ########### # # ### #######
# #   #     # #       #   # #   # #     #
# ##### ### ### ##### # ### ### ### ### #
#       #       #       #     #     #   #
#########################################
