################################# #######
#     #           #       #      .      #
# ### ### ### ### ### ### ##### # ##### #
# # # #   #   # #     #     #   #.#   # #
# # # # ### # # ##### ##### # ### ### # #
# #     #   # #       #   #   #  . .# # #
# ####### # # ######### # # ### ### # # #
#   #     # # #     #   # # #   #. .# # #
### # ##### # ##### # ### ### ### # # # #
# # #   #   #     # # # # #   #  .# #   #
# # ##### ### ### # # # # # # # # #######
#   #     #   #   # #   # # # # #. . . .#
##### ######### # # ### ### # # # ##### #
#     #         # #         # # #     #.#
# ####### ##### ####### ##### # ##### # #
# #     # #     #       #     #     # #.#
### ### # # ##### ####### ##### ##### # #
#   # #   # #     #       # #       # #.#
# ### ##### # ##### ####### # ##### # # #
#   #       #   #   #       #     # # #.#
# ############# # ##### ### ####### # # #
# #       #     #   #   #       #   # #.#
### ##### # ##### # # ##### ### # ##### #
#   #       #     # # #     #     #  . .#
# ### ############# # ####### # ### # ###
# #   #             # #       # #   #. .#
### ### ### ######### # ### ##### ##### #
#   #   #   #       # # #   #   #   #. .#
# ### ############# ### ##### # ##### # #
# #   #               #     # # #  . .# #
### ### ############# ##### # # # # ### #
#   #       # #   # # # #   # # # #.# # #
# ######### # # # # # # # ### ### # # # #
# #   #   #   # # #     #     #   #.#   #
# ### # ####### # ##### ####### ### #####
#     #         #     #   #     #. .#. .#
########### ######### ### ### ### ### # #
# #         #       #   # #   #  . . .#.#
# ####### # # ######### # # ########### #
#         # #               #. . . . . .#
############################# ###########
