################### #####################
#         #        .  #. . .        #. .#
### ### # # ####### # # ### ######### # #
#   #   #   #    . .# #.  #. .#. . . .#.#
# ##### # # # ### ##### ### # # ####### #
# #     # # # #  . . . .  # #.#. . . .#.#
# # # ### # # # # ####### ### ####### # #
# # #   # # # # # #     #   #. .#. .#.#.#
# # ### ### # # # # ### ### ### # # # # #
# #   #   # # # #     #   #   #. .#. .#.#
# ##### # # # # ####### # ### ######### #
# #   # # # # #   #     #   # #   #. . .#
# ### ### # # ##### ### ##### ### # # # #
#   #     # #   #   #   #   #     #.# # #
# # ####### # # # ####### ######### ### #
# # #   #   # # # #         #   #  . .# #
### # # # ##### # # ######### # # # # ###
#   # # # #     #   #   #   # #   # #. . 
# ##### # # # # ### # ### # # # # # #####
#       # # # #   # # #   #   # # # #   #
######### # # ### ### # ##### ### # # ###
# #       # #   #     # #     #   # #   #
# # ####### # # ####### ####### ### ### #
# #       # # #   #           # #   #   #
# # ##### # # ### ####### # # # ### # ###
# # #     # #   #       # # # #   #     #
# ### ##### # # # ##### ### # ### # ### #
#   # #     # # #   #   #   # #   # #   #
### ######### # ##### ### ##### # # # ###
# # #         #   #   #     #   # # #   #
# # ####### ##### # # ### ### # # # #####
# #         #     # # #   #   # # #     #
# ########### ##### # # ### # ### # ### #
#             #     # # #   # #   #   # #
##### ########### # ### # # ### ####### #
#     #           # #   # # #   # #     #
# # ######### ####### ##### # ### # #####
# # #   #     #       #     #     # #   #
# ### ##### ### ######### # ####### ### #
#     #     #   #         #       #     #
#########################################
