################# #######################
#        . . .#. .    #     #           #
# ####### ### # ##### ##### # ####### # #
# #  . . .#  .#. .  #         #     # # #
# # # ####### ### # ####### ### # # # ###
# # #. .#   #. .#.#       # #   # # #   #
# ##### # # ### # ##### # ### ### # ### #
#   # #.# #    . .    # #       # # # # #
### # # ######### ### ########### # # # #
# # # #. . . .# #   #       #     #   # #
# # # # ##### # ### ######### # # # ### #
# #   #     #.#   # # #       # # # #   #
# ########### ### # # ######### # ### # #
#. . . . . . .  # # #           #   # # #
# ####### ### # # # ############### ### #
#. .#     #   # #     # #     #     #   #
# # ####### # ####### # # ##### ##### ###
# #. . .  # # #     # #   #     #     # #
# ##### # # ### ### # # ### # # # # ### #
# #   #.# #       # # # # # # # # #   # #
# ### # # ######### # # # # # # # # # # #
# #   #.#     # #   # #   # # # # # # # #
# # ### ##### # # # ##### ### # # ### # #
#   #  .    # # # # #   #     # #   # # #
####### ### # # # ##### ########### # # #
 . . . .  # #   #     # #       #   # # #
####### # # ### # ### # # ##### ####### #
#       # #   # #   #     #   #         #
# ##### # ### # ### # ##### # ###########
# #   # #   # # # # # #     #       #   #
# ### ####### # # # # # ######### # ### #
#   #         #   # # # #       # # # # #
### ##### ### ##### ### # ##### # # # # #
#   #     # # #   #     #   # # # #   # #
# ##### # # # # ########### # # # ##### #
# #   # # #   # #       #   # # #     # #
# # # # # ##### # ####### ### # ##### # #
# # # # #     #   #       #   #   # #   #
# # # # ####### ### ####### ### ### #####
#   # #                     #           #
#########################################
