##### ######################### #########
#   #. . . . .#. . .#    . . . .        #
# # ######### # ### ##### ### # ### ### #
# # #. . . . .#. .#.#. . .#   #   #   # #
# ### ########### # # ########### ### # #
#. . .#  . . . . .#. .# #         #   # #
# ####### # ####### # # # ############# #
#.#  . . .# #       # #   #     #       #
# ### # ### # ####### ### # ### # # # # #
#. . .# #   #   #     #   # # #   # # # #
######### ####### ##### ### # ##### ### #
#   #     #       #   # #   #         # #
# ### # ##### ##### # ### ########### # #
# #   # #     #     #   # # # #       # #
# # # ### # # # ####### # # # ### ### # #
#   # #   # # # # #   #   #     # #   # #
### ### ### # # # ### ######### # # ### #
#   #   #   # # #     #           #   # #
##### ### # # ####### ################# #
#     #   # # #     #     #             #
# ##### # ### # ######### # # ######### #
#     # # #   #             # #   #     #
####### # # # ########### ### # # # # # #
#     # # # # #         # #   # # # # # #
##### # # # ### ####### ### ### ### ### #
#   #   # #         # #   # #       #   #
# ### ### # ### ### # ### # ####### # # #
#     #   #   # # #   #   #   #     # # #
####### # ### # # ##### ##### ####### ###
#       #   # # #       #   #   #   #   #
# ### # ##### # ######### # # # # # ### #
# #   #   #   # #     #   # # # # #     #
# ### ##### ### # ### # ####### # ##### #
# #   #   #   #   # # # #       #     # #
### ### # ### ##### # # ##### # ##### # #
#   #   #     #   # # #       #     # # #
# ############# ### # ##### # ####### # #
# #           # #   # #   # #   # #   # #
# # ########### # ### # # ##### # # ### #
#               #     # #       #   #   #
#########################################
