########### #############################
#     #  . .    #     #         #       #
# ##### # # # # # ### # # ### ### # ### #
#       #.# # # #   #   #   #     #   # #
######### # # # ### ##### # ######### ###
# #    . .# # # # # #   # #   #   # #   #
# # ### # # # # # # # ####### ### # ### #
#   #. .# # # # #     #   # #   #   #   #
##### # ### # ### ##### # # ### # # # # #
#. . .# #   #     # #   # #     # # # # #
# ####### # # # ### # ### ####### ### # #
#.#       # # #     #   #           # # #
# ########### ####### ############### # #
#. . .      #                   #     # #
# ### ##### ### ################# # ### #
#   #.    #   #       #     #     # #   #
### # ### # # ######### ### # ##### # ###
#   #.  # # #           #   # #     # # #
# ### # # # ############# ##### ##### # #
# #. .# # # #       #   # #     #   # # #
# # # ### # # ### # ### # ####### # ### #
# #.# #   #     # #     #     #   #     #
### # # # # ##### ########### # ##### ###
#. .# # # #     #   #     #   # #   #   #
# ### # ##### # # # # ##### ### # # #####
#.#   #     # # # # # #   # #   # #     #
# ####### # ### # # # # ### # ######### #
#. .  #   # #   # #     #   #   #   #   #
# # # # ##### ##### ##### ### ### # # ###
# #.# # #     #   #     # #   #   # # # #
# # # # ####### # ##### ### ### ##### # #
# #.# #         #     #     #   #     # #
# # ##### ##### ############### # ##### #
# #. .  # #   # #             # # #   # #
# ### # ### # # # ######### ### # ### # #
#   #.#     # # #       # #     #   # # #
##### ####### ######### # ### ##### # # #
#. . .#       #   #     #   # #       # #
# ############# ### ####### # # ####### #
#. . . . . . . .            #           #
############### #########################
