########################### #############
#   #         #        . . .        #   #
# # # # ##### ####### # # ######### # # #
# #   # #             #.# #. . .# #   # #
# ##### ####### ####### ### ### # ##### #
# #   #     # # #     #. . .  #.# #     #
# ### # ### # # # ### # ####### # # #####
#   # #   # # # # #     #     #.#   #. .#
# # # ### # # # # ##### ##### # ##### # #
# #     # # #   #   #   #     #. . . .#.#
######### # ####### ##### ##### # ##### #
#       # #       #       #   # #     #.#
# ##### # # # ### ##### ##### # ####### #
# #   # # # #   # #   #   #   #     #. .#
### # # # # # # # # # ##### ####### # # #
# # #   # # # # #   #   #   #     # #.# #
# # ##### # ### ####### # ##### ### # ###
# #       #   #   #   # #     #   # #. .#
# ### # # # # ##### # # ##### ### # # # #
#     # # # #       # #     # #     # #.#
####### # # ##### ### ####### ######### #
#       # # #   #   #       #      . . .#
### ##### # ### ### ### ### # ##### #####
#   #     #   # # #   # #   # #  . .#. .#
# ##### ##### # # ### ### ##### # # # # #
# #     #   #   #     #   #     #.# #.#.#
### # # # ############# ### # ### ### # #
#   # # # #   #     #   #   # #  . . .#. 
# ##### # # ### # # ##### ### # # #######
# # #   #   #   # #       #   # # #     #
# # # ### ### ### ########### # # ##### #
# #   # # #   #   #   #       # #     # #
# ##### # # ##### # # # # # # ##### ### #
#         #   #   # # # # # # #   #   # #
############### ### # # # ### # ##### # #
#   #           #   # # #   # # #   # # #
# # # ####### # # ##### ### # # # # # # #
# #   # #     # #       #   # # # # #   #
# ##### # ############### ##### ### # ###
#     #   #                         #   #
#########################################
