# #######################################
#.            #. . .                    #
# ############# ### ############# # #####
#.#. . . . . . .  #. .    # #   # #     #
# # ##### ########### ### # # # ### ### #
#. .#   #           #. .#   # #   # #   #
# ##### ##### ######### ######### ### ###
# #     #   # #  . . . .  #. . .#     # #
# # ##### # # # # # # ##### ### ####### #
#   #   # # # # #.# # #. . .# #.    #   #
# # # ### # ### # ### # ##### # ### # ###
# #   #   #     #. .# #.  #   #. .# #   #
# ##### ########### # # ### ##### # ### #
#   #   #      . . .# #.    #  . .#   # #
# # # # ####### ####### ##### # ##### # #
# # # #     #  . . . . .    # #. .  #   #
# # ##### # ####### ####### # ### #######
# #     # #     # #   #     #   #. .    #
# # ### ### ### # ### ######### # # ### #
# #   #   #   #     #         # # #.# # #
# ### ### ### ##### # ### ### # ### # # #
#   #   #   #     # # #   #   # #. .#   #
# ##### ### ##### # ### # ##### # # #####
#   # #   # #   # # #   # #     #.# #. . 
### # ### # # ### # # # # # ##### # # ###
#   #   # # #     # # # # # #   #.# #.  #
####### # # ####### # ### # # # # ### ###
#     # # # #     # #   # # # # #. . .  #
# ### # ### ##### # ### # # # # ### ### #
# #   #     #   # # #   # #   #   #   # #
### ##### ### # # # # ### ####### ### # #
#     #   #   #   # #   #       #   # # #
##### ##### ####### # # ####### ##### # #
#   # #   #     #   # #       #   #   # #
# ### # # ##### # ##### ########### ### #
#       #   #   #   #   #           #   #
########### ### ##### ### ########### # #
#       #   #     #   #   #     #   # # #
# ##### # ####### ##### # # ##### # # # #
#     #                 # #       #   # #
#########################################
