##### ############################# #####
# #  . .          #   #   #. . .  #.#   #
# # # # ####### ### # # ### ### ### # ###
#   # #.    # #     # #. . .  #. .#.#   #
### # # ### # ####### # ####### # # ### #
#   # #. .# #. .#     #.#     # #. .  # #
# ### # # # # # # ##### # ### ### # ### #
# #   # #.# #.#.# #. . .    #   # # #   #
### # # # ### # ### ########### # ### ###
#   # # #. .#.#. . .#   # #   # #       #
# ### # ### # ######### # # # # #########
# #   #   #.#.  #     # # # # #   #     #
# ####### # # ### ### # # # # # # # ### #
#       # #.#.#   # #     # # # # # # # #
# ##### # # # # ### ####### ### # ### # #
#     # # #.#.# #   #   #   #   # #     #
####### # # # # ### # ### ### ##### #####
#       # #.#.# # #   #   #   #     #   #
# ### # # # # # # # ### ### # # ##### # #
# #   # # #. .  # # #   #   # # # #   # #
# ##### # # ##### # # ##### # # # # ### #
#     # # #       #   #   # # # #   #   #
# ### ### ####### ### # # # # # ##### ###
#   # #     #   #   # # #   # #   #   # #
####### # # ### # # # ########### # ### #
#       # #     # # #           # #   # #
# ####### ####### # ##### ### ### # ### #
# #     #   #     #         #     # #   #
# # ####### # ########### # ####### # ###
#         # #           # #             #
# ####### # ########### ############# # #
#       # #     #     #       #     # # #
# # ### # # # ### ### ##### # ##### # ###
# #   # # # #     # #   #   #       #   #
# ### # # ##### # # ### # # ########### #
# #   # # #   # # #   # # # #   #       #
# ##### ### # # ##### # # ### ### ##### #
# #   #     # # #   #   #   #   # #   # #
### # ####### # # # ####### ### # # ### #
#   #         #   #   #       #   #     #
#########################################
