############# ###########################
#. . .#      .#. . . .              #   #
# ### ####### # ##### ##### ### ### ### #
#.#  . . .#  .#.#   #.    # #   #   #   #
# ####### # # # # ### ### # # ######### #
#. . .#  .# #. .#   #.  # # #         # #
# ### ### ### ##### # ### # ### # ### # #
#   #. .#. .#       #. .# #   # #   # # #
# # # # ### ########### ### # # ##### # #
# # # #. .#. .#. .#  . .#   # # #     # #
# # ### # ### # # ### # # # # ### # ### #
# #   # #.#  . .#. . .# # # #   # # #   #
# ### # # ####### ### ### ##### # # # ###
#   # # #. .#     #   #   #   # # # # # #
##### # ### # ##### ### # # ##### # # # #
#     # #. .# #     #   # #       # # # #
# # ### # ##### ####### # ####### ### # #
# # #   #.#   #   #     #   #     #   # #
### # ### # # ### # # # # # # ##### ### #
#   # #. .# # #   # # # # # #   #     # #
# ##### ### # # ### # # ### ##### ##### #
# # #. .#   #   #   # #   #           # #
# # # # # # ##### ### ### # # ####### # #
#   #.# # # #   # #   #   # #       #   #
##### # # ### # # # ### ### ####### #####
 . . .# # #   #   #   # # #       #     #
##### # # # ####### # # # ##### # # #####
#   # # # #   #     # # #       # # #   #
# ### # # ### ######### ########### # # #
#   # # #   #   # #   # #     #     # # #
### # # # ##### # # ### # ### # ##### # #
# #   # #   # # #       #   # #       # #
# ##### ### # # ### ######### ###########
#   #     #   #   # #         #   # #   #
### ### # ####### # # ######### # # # # #
# # #   #     #   # # #   # #   # # # # #
# # # # # ### ####### # ### ##### # # ###
# #   # #   #         # #         # #   #
# ######### # # ####### # ######### ### #
#           # #                         #
#########################################
