# #######################################
#. . .  #. . .                    #     #
# # # ### ### ### ##### ####### # ##### #
# # #. .#.# #.# # #       #   # #       #
# ##### # # # # # # ### # ### ###########
#     #. .# #.# # #   # #     #         #
####### ### # # # ### ######### ####### #
#. . .#     #.#     # #         #     # #
# ### ####### ### ### # ##### ### ##### #
#.# #.#. . . .  #   #   #   #     #   # #
# # # # ### # # ### # # # # ######### # #
#.#  . .#   # # #   # # # #       #   # #
# ### ####### # # # # ### ####### # ### #
#. .# #     # # # # #   #       # #   # #
# # ### ### # # # ##### ##### ### ### # #
# #. .#   # # # #     #       #     #   #
# ### ### # # # ### ########### # # #####
#   #. .# # # #   #           # # #     #
### ### # # ### # ### ### ### # # ##### #
#   #. .# #   # #   #   # #   # #     # #
##### # # ### # ### ### # ############# #
 . .#.# # #       #   # #           # # #
### # # # ##### # # # ### # ####### # # #
#  .#.# # #   # # # #   # # #     # # # #
### # # ### ### # # ### ### ##### # # ###
#  . .#   #     # #   #   #     #   #   #
# # # ### ####### ### # # ### ######### #
# # #   #     #     # # #   #         # #
# ####### ### # # # # ##### # # ##### # #
# #       #   # # # # #   # # # #     # #
# # ### ####### # # # # # # # # # ##### #
# # #   #     # # # #   # # # # # # # # #
# # ##### ### # # # ##### # ### ### # # #
# #       # # # # #   #   #   # #   # # #
# ### ### # # # # ##### # # # ### ### # #
#   # # # #   # # #     # # #         # #
### ### ####### # ### ### # ########### #
# # #   #   #   # #   #   #     #     # #
# # # ### # # ### # ########### # # ### #
#   #     #   #   #           #   #     #
#########################################
