################################# #######
# #   #             #   #   #    .    # #
# # # ##### ### ### ### # # # ### ### # #
# # #       #   #     #   # #   #. .#   #
# # ######### ####### ##### ##### # #####
# # #       #     # #      . . .# #.  # #
# # # ##### ##### # ####### ### ### # # #
# #       #     # #     #  .#  . . .#   #
# # # ### ##### # ##### # # ##### # ### #
# # #   #   #   #     # # #. .#   #   # #
# # ############# # ### # # # ####### ###
# # #     #       #   #   # #. . .  #   #
# # # ### # ####### # ### # # ### # ### #
# # # # #   #     # #   # # # #. .# #   #
# ### # ##### ### ### # ### ### ##### # #
#     #     # #   #   # #   #. .#     # #
########### # ##### # ### ### # # ##### #
# #       #       # # #   # #.# # #     #
# # # ### ####### ### # ### # # # #######
#   # #       #     # # #   #.# #       #
##### ####### ##### ### # ### # ####### #
# #     #   #     # #   # #. .# # #     #
# # # # # # ##### # # ### # ### # # # # #
# # # # # #    . .# #     #.#   # # # # #
# # # # ####### # # ####### # # # # ### #
#   # #   #    .#. .#. . . .# # # #   # #
# ### ### # ### ### # ##### # ### # # # #
# #   #   # #  .#  . .#   # #     # # # #
### ### # # ### # ##### # # #############
#   #   # #   #.#   #   # # #           #
# ### # ##### # ### # ##### # ######### #
# # # #     # #.#   #       #   #   #   #
# # # ####### # # ########### ### ### ###
# # #     #   #.# #. . .        #     # #
### ####### ### ### ### ### ### ####### #
#   #       #  . . .# #.  #   #     #   #
# ### ##### # # ##### # # ### ##### # ###
# #   #     # #   #   #.#   #     # #   #
# # ######### # # # ### ### ##### # ### #
#   #         # #   #  .#   #     #     #
####################### #################
