######### ######### #####################
# #     #. . . . .#. . . .            # #
# # # # ######### # ##### ####### ### # #
#   # #        . .# #   #. . .  # #   # #
##### ######### ### # # ##### # # # ### #
#     #   #   #. .#   #     #.# # #     #
# ##### ### # ### ########### # # ##### #
# #   #     #   #.#  . . .#. .# #     # #
# # ### ######### # # ### # # # ### # # #
#   #   #  . . . .# #.# #. .# #   # # # #
##### ##### ######### # ######### # # ###
#     #   #.#    . . .#           # #   #
# ####### # ##### # # ############# ### #
#       #  . .#. .# # #     #     # #   #
####### ##### # ### # ##### ### # # # # #
#   # #      . .#   # #         #   # # #
# # # ####### # ##### ##### # ##### # ###
# #         # # #     #   # # #     #   #
# ### ##### ### # ### # # ### # ####### #
# #     #     # # #   # #   # # #       #
# ### # ##### # # ##### ### ### # ### # #
#   # #   #   # # #     # #     # #   # #
# # ### ##### ### # ##### ####### # ### #
# #   # #   #     # #             #   # #
##### ### # ### # # ##### ####### ##### #
#     # # # #   # #   #   #   #   #     #
# ### # # # # ### # # # ### # ####### # #
#   # # # # #   # # # # #   #   #     # #
### ### # ##### # # # # # ##### ### # # #
# # #   #       # # # # # #   #   # # # #
# # # ########### # # # # # ##### # # # #
# #   # #         # # # # #   # #   # # #
# ##### # ##### # # ### # ### # ####### #
#       #   #   # # # # #   # #     #   #
### ######### ### # # # # ### ##### # ###
# # #         #   # # # #   #   #   # # #
# # # ##### # # ### # # ### ### # ### # #
# # #   #   # #   # # #   #   # #     # #
# # ##### ####### # # # ####### ####### #
#         #       #   #                 #
#########################################
