####### #################################
#      .      #         #               #
### ### ##### # # ####### ### ####### # #
#   #  . .  #   #     #   #     # # # # #
# ##### # ######### ### ### # # # # # ###
# #     #. .      #     #   # # # # #   #
# ######### ##### # ### ####### # # ### #
#     #   #. .  # #   # #     #   # # # #
### ##### # # ### ### ### ### ##### # # #
# #     # # #. .#   #       #     #   # #
# ### ### ##### # ######### ### ##### # #
#   #   #     #.#         #   #     # # #
### ### ##### # ### ##### ####### # # # #
# #   #       #.  #     # #     # #   # #
# ### ######### ##### # # ##### ####### #
#. .# #     #  . . .# # #   #       #   #
# # # # ### ### # # # ##### ####### # # #
#.#. .# #       # #.#     #     #     # #
# ### # ########### ### ####### ##### # #
#.# #.#     #  . . .  #       #   # # # #
# # # ##### # # # # # # ### # # # # # # #
#.# #.    # # #.# # # #   # # # # #   # #
# # # ##### ### ### # ### # # # # ##### #
#.# #.#     #. .#   # #   # # # # #     #
# # # # ##### ### ### # ### # ### # ### #
 .# #.#   #. .#   #   #   # # #   # #   #
### # ##### ### ##### ##### # # # # #####
#   #. . . .#   #   # #     # # # #     #
# ##### ### # ##### # ### ##### # ### # #
#     # #   #       # #   #     # #   # #
##### # # ########### # ### ##### # #####
# # # # # # #         # #   #     # #   #
# # # ### # # ### ##### # ######### ### #
# #   #   #   #     #   # #       #   # #
# # ### ######### # # ##### ##### ### # #
# #     #       # # #       # # # #   # #
# ### ### ##### # # ######### # # # ### #
# #   #   # #   # #         # # # # #   #
# ##### # # # ### # ### ##### # # ##### #
#       # #       #   #         #       #
#########################################
