############################# ###########
#. . .#           #  . . .#  .          #
# ### # ########### # ### ### ######### #
#.# #.#   #         #.#  . . .  #     # #
# # # ### # ######### ##### # ### ### # #
#.#  . . .#   #. . . .#     # #   #     #
# ####### ##### ####### ##### # ##### # #
#. .#    . . .#.#   #   #     # #   # # #
# # ######### # # ### ##### ### ### ### #
# #. . .#   #. .#     #     #     #     #
# ##### # ##### ####### ##### ### #######
# #   #.# #     #         #   #     #   #
# ### # # # ########### # # ### ##### # #
#     #.#   #         # # # #       # # #
####### ### # ### ### # # # ### ##### ###
#. . . .  # # #     # # # #   # #   #   #
# ### # # # # # ### # ### ### ### # ### #
#.#   # # # # #   # #       #     #     #
# # ### # # # ##### # # # ### ###########
 .# #   # # #     # # # #   #           #
### ### # ####### # ### # # #############
#   #   # #       # #   # #       #     #
# ### ### # ######### # # ### ### # ### #
#   # #   #     #     # #   # # # #   # #
##### # ####### # # ######### # # ##### #
#     #     # # # # #       # #   # #   #
# ######### # # # ### ##### # ##### # ###
#   #       # # # #   #   # #   #       #
# # ######### # # # ##### # # ### ### ###
# # #       #   #     #     #       #   #
# # # ### ####### ### ##### # ### # ### #
# #     #       # # #   #   #   # #   # #
# # ####### ### ### ### ####### ### # # #
# #       #   #   #   #       #   # # # #
# ####### # # ### # ######### ### # ### #
#   #     # # #   # #     #   #   #   # #
# # ############### # ######### ##### # #
# #   #       #     # #     #     # # # #
# ### # ##### # ##### # ### ##### # # # #
#   #       #       #   #         #   # #
#########################################
