# #######################################
#.  #     #. . .      #     #           #
# # # ### # ### ### # # ### ##### ##### #
#.#   #   #.#. .# # # # # #           # #
# ######### # # # # ### # ####### # ### #
#. . . . . .#.#   #       #     # #   # #
############# ####### ##### ### # ### ###
 . . . . . .#. . .  #     # # # # # #   #
########### # ### # ### ### # # # # ### #
#   #   #. .#   #.#   #       # #   #   #
### # # # ####### # ########### ##### ###
#   # # #.#  . . .#     #   #       #   #
# ### ### ### # # # # # ### # # ####### #
# #  . . .#. .# # # # #   # # #       # #
# ### ##### # ### ### ### # ### # ### ###
#   #. . . .# # # #   # # #   # #   #   #
### ##### ### # # # ### # ### # ### ### #
# #       #   # # #   #   # # #   #   # #
# # # ##### ### ##### ### # # ### ##### #
# # # #     #   #   #   #   # # # # #   #
# ### # # ### ### # # # ##### # # # # # #
#     # # # #     #   #     # # # #   # #
####### # # ### # ### # # ### # # ##### #
#       # #     # #   # #     #     #   #
# ##### # ####### # ######### ##### # # #
# # #   #     #   # #   #   #   # # # # #
# # # ### ##### ### ### # # ### # # # ###
#   #   #   #   # #   #   #   # #   #   #
####### ### # # # ### ####### # ####### #
#       #   # # #   #       # # #       #
# ####### # # # ### ### # ### ### #######
# # #     # # #   #   # #     #   #     #
# # ### # # # ####### # # ##### ### ### #
# #   # # # # #       # #   # #       # #
# ### # ### # # ####### ### # # ####### #
# #   #   # #         #   # # # #   #   #
# # ##### # ########### ### # # ### # # #
#   #     # #   #     #   #   # #   # # #
##### ##### # ### ### ### ##### # ##### #
#     #     #     #           #   #     #
#########################################
