################################# #######
#          . .#  . .#  . .#  . . .    # #
# ######### # ### # # # # ### # # ### # #
#     #  . .#. . .#.# #.#. . .# #   #   #
##### # # # ####### ### ### ##### # #####
#   # # #.# #      . . .#   #     # #   #
# ### ### ### ####### # # ### ### # ### #
#     #. .#   #       # #   #   # #   # #
####### ### ##### ##### # # # # ##### # #
#. . . .#   #     #     # # # #   #   # #
# ############# ### ####### ##### # ### #
#.#     #     # # #       # #   # #     #
# ##### # ### # # ####### # # # # #######
#. . .#   # #   # #. . .# #   # #       #
# ### ##### ##### # ### # ##### ### # ###
#   #. . . .      #.#. .# #   #   # #   #
### # ##### ####### # ### ### ### # ### #
#   #     #.#. . . .#.# #   #   # #   # #
# # ##### # # ####### # ### ### # ##### #
# #     # #. .#     #.#     # # # #     #
# ####### ### # ### # ####### # # ### # #
#       #   # # #   #.#. . . .  # #   # #
# ### # ### ### # ### # ##### ### # ### #
#   # #   #     # #  . .    #. .# #   # #
# # # # ######### ##### ### ### # # ### #
# # # #         #     #   # #. .# #   # #
### # ### ### # ##### ### ### # # ### # #
#   #   #   # #     #   # #. .# #   # # #
# ##### ##### ########### # ### ### # # #
#     #     #   #   #     #. .#   # # # #
# # # ##### # ### ### ####### ### ##### #
# # # # #   #     #   #  . . .  #     # #
# ### # # ### ### # # # # ########### # #
#   # #   #   # # # # # #.#       #   # #
### # ######### # # ### # # ####### ### #
#   #     #     # # # # #.# # #     #   #
# ### # ### ####### # ### # # # ### # # #
#   # #   # #       #   #.#   # #   # # #
# # ##### # # # ####### # ### ### ### # #
# #     #   # #         #.  #     #   # #
######################### ###############
