############# ###########################
#   #      . .  #                       #
# # # ##### # # ### ################### #
# # # # #. .# #     #             #     #
# # # # # # # ##### # ########### #######
# # #   #.# #     # # # #       #       #
# ####### # ### # ### # # # ########### #
# #      .# # # # #   #   #       #   # #
# # ##### # # # # ##### ####### # ### # #
# # #    .# # # #   #   #     # #   # # #
# # ##### # # # ##### ####### # ### # # #
# #   #  .#   #       #     # #   #   # #
# ### # # ############# ### # # ####### #
#   # # #. . . .  # #. .  #   # #       #
### # # ####### # # # # # ####### ##### #
#     #   #. . .# # #.#.#   #. . .    # #
######### # # ### # # # ### # ### ### ###
#     #   #.# #   # #.#. .# #.# #.  #   #
# ##### ### ### ### # ### # # # # ##### #
#       #  . .# #   #.#. .# #.# #. .  # #
######### # # # # ### # ### # # # # ### #
#   #     # #.#   #. .#.# # #.# # #. .# #
# ### ##### # ##### ### # # # # ##### # #
# #   #     #.  #. .# #.#   #.  #. . .# #
# # ####### # ### ### # ##### ### ##### #
# # #       #. .#. .# #. . . .#. .# #   #
# # # # ##### # ### # ######### # # # ###
# # # # #   # #. .#. .#   #. . .# #   # #
# # ### ### # # # ### # ### ### ####### #
# # #   #   # # #. .#.# #. .#   #. .    #
# # # ### ### # ### # # # ####### # #####
# # #   #     # #. .#. .#. .#. . .#. . . 
# # # # ####### # ##### ### # ###########
#   # # #     # #. . .#. .#. .#         #
####### # ### # ##### ### ##### ####### #
#   #   # #     #   #.  #.#     #       #
# # # # # ##### # # # ### # ##### #######
# #   # #   #   # # #. . .#   #     #   #
# ##### ### ##### # ### ####### ##### # #
#     #   #       #   #               # #
#########################################
