####### #################################
#      . .                #         #   #
# ##### # ### ##### ####### ##### # # ###
# #     #.  #     #   #     # #   # #   #
# ##### # ##### # # ### ##### # # ##### #
# #     #. .  # # #   # # #   # # #     #
# # ##### # # ### ### # # ### ##### #####
# # # #   #.#   #   # # # #   # #   #   #
# # # # ### ### ### # # # # ### # ##### #
# # #   #. .#   # # #   #       #       #
### ##### # # ### # ##### ####### #######
#   #. . .# # #   #     #   #     #     #
# ### ##### # # ### ### # ### ##### ### #
# #  . .#   #     #   #       #   # # # #
# ##### ############### ####### ### # # #
#     #. . .          #     #     #   # #
######### # ######### ##### # ### ### # #
#  . . .# #.#. .    #     #   # #   # # #
# # ### # # # # ######### ##### # ### # #
# #.# #.# #. .#. . .    #     # #   # # #
### # # ####### ### ### # ### # ### # ###
 . .#. .#. . .#   #.  # #   # #     # # #
##### ### ### ##### # # ##### ####### # #
#   #.#  .# #. . . .# #     #       #   #
# # # ### # ####### # ##### # ##### # ###
# # #.#. .#         #     # #     #     #
# # # # # ############### # ##### # # ###
# # #.#.# #               #     # # #   #
# ### # # # ######### ######### # # ### #
#   #. .# #     # #   #   #   # # # #   #
### ### # ##### # # ### ### # # # # # ###
# #     #   # # #   #   #   #   # # # # #
# ####### # # # ##### ### # # ### # ### #
#         #   # # #   #   # # #   # #   #
############### # # ### ### # # ### # ###
#   #             # #   #   # #   # #   #
### # # ####### ### ### ##### # # ##### #
#   # # # #     # #   # #     # #     # #
# ### # # # ##### ### ### ### # ##### # #
#     #   #       #       #   #     #   #
#########################################
