####################### #################
#     #     #          . .      #     # #
# ### # ### # ########### ### ### ### # #
# # # # #     # #    . . .  #     #   # #
# # ### ### ### # ### ### # ########### #
# #   #   # #   # #  . .# #   # #. .    #
# ### # # ### ### ##### ##### # # # #####
#   # # # #   #   #   #. .#   # #.#. . .#
### # ### # ### ### # ### # ### # ##### #
#   #     # #   #   #   #.# #   #.#   #.#
# ######### # ### ##### # # # ### # ### #
#      . .# #     #     #.#   # #.#   #.#
####### # # ############# ##### # ### # #
 . .#  .#. .#      . . .#.  #. . .    #.#
### ### ### ####### ### # ### ######### #
#  . . .# #. .#  . .# #.#. . .      #  .#
# ##### # ### ### ### # # ######### ### #
# #     #   #. . .# #. .# #. .#     #. .#
# # ####### ####### # ### # # # ##### # #
# #   #   # #      . .#   #.#.# #. . .# #
# ### ### # # ##### ####### # # # # ### #
#   #     # # #   #. . . . .#.# #.# #   #
# # ####### ### # ########### # # # # ###
# # #     # #   #         #  .# #.# #   #
# # # ##### # ########### ### ### # # # #
# # #         #   # #   #    . .#.# # # #
# # ####### # # ### ### ####### # # # # #
# #     #   # #       #       #. .# # # #
##### # # ### ####### ### ### # ### ### #
#     # #   # # # # # #   # # # #   #   #
# ######### # # # # # ### # # ### ### # #
#   #   #   # #   # #     # #     #   # #
# # # # # ### # ### ####### ######### # #
# # # # #   # # # # #             #   # #
# # # # ##### # # # ####### ##### # ### #
# # # #       # # #         #       # # #
# # ########### # ########### ### ### # #
# #         # # #           #   # #   # #
# ####### # # # ######### # ### # # ### #
#       # #   #           #     # #     #
#########################################
