##################### ###################
#        . .#    . . .    #             #
######### # # ### # # # # # ####### ### #
#. . . . .#.# #. .# # # # #   #   #   # #
# ##### ### ### # # # # # ### # # ##### #
#.#   # #  . . .# # # # #     # #     # #
# # # ### ######### # ############### # #
#.# #     #. . . .# #       #   #   # # #
# ######### ##### ######### # # # ### # #
#. . . . .#.#. .#. .#     # # #   #   # #
# ####### # # # # # ##### # # ### # ### #
#       #. .#.#.# #. . .#   #   # # #   #
############# # ### ### ######### # #####
 . . . . . .#.#. .#   #. .  #     #     #
########### # ### ####### # # ######### #
#   # #. .#.#.# #.#  . .#.#       #     #
# # # # # # # # # ### # # ######### #####
# #   #.#. .#.#  . . .#.#. . .  #       #
# ##### ##### ##### ### ##### # # #######
# #   #.#    . . .# #  . . .#.#         #
# # ### ##### ### ### # ### # ######### #
# #    . . .#   #. .# # #  . .      #   #
# ######### ### ### # ### ### ##### #####
#          . .#   #.#   #   #   # #     #
############# ### # ### ####### # ### # #
#   #       #.#   #.  # #       #   # # #
# # ### ### # ##### # # # ##### ### ### #
# #   # #   #. . . .# # # #   # # #   # #
# ### # ############# # # # # # # ### # #
#   # #       #   #   # # # #   #   #   #
### # ####### # # # ### # ##### ### #####
#   #           #   #   #     #   # #   #
# ##################### ### # ##### ### #
#   #                   #   #       #   #
##### ######### # ####### # ######### ###
#     #   #     # #       # #           #
# ####### # ### ### ##### # # ###########
# #   # #   #   #   #   # #   #     #   #
# ### # ##### # # ### # # ##### ####### #
#     #       # #     # #               #
#########################################
