####################################### #
#     #     #                 #        .#
# ### # ### # ################# ####### #
# # # #   #   #   # #     #     #      .#
# # # ##### ### # # # # ### # ### ##### #
# #       # #   # #   #   # # #   #    .#
# ####### # ##### # ##### ### # ####### #
# #   #. . .#   #   #   # #   #     #  .#
# # # # ### # # # ### ### # ####### # # #
# # # #.# #.# # # # #     # #   #   # #.#
# # ### # # ### # # ####### ### # ### # #
# # #. .#  . . .# # # #   #     # # # #.#
# # # ######### # # # # # ####### # # # #
#   #. . .#   #. .#     # #     # #   #.#
######### # ##### # ####### ##### ##### #
 . . . .#.#   # #.  #   #   #       #  .#
####### # ### # # ### ### ### ####### # #
#   #. .#.  # # #.#     # #   #   #   #.#
# # # ### ### # # # ### # ### # ### ### #
# # #.#  . .# #. .# # #   #   # #   #. .#
# ### ##### # # ### # ##### # # # ### # #
#   #. . . .# #.  # #       # #   #  .# #
### ######### # ### ##### ##### ### # # #
# #   #. . . . .#   # #   #   # #   #.# #
# ### # ##### ### ### # ### # ### ### # #
#   #. .#   #   #   # # #   #     #  .# #
# # # ##### ####### # # # ######### # # #
# # #.#     #     #   # # #     #   #.# #
# # # # ##### ### ### # # # ### ##### ###
# # #.#   #   # #   # # #   # #     #. .#
# # # ### ### # ### # ##### # # ### ### #
# # #. .#   # #. . .# #   # # #   #   #.#
# # ### ### # # ### # # # ### ### ##### #
# #   #. .#   #.# #. .# #   #   #   #  .#
# ####### ##### # ### ##### ### ##### # #
# #      . . . .#   #. . . . . .#     #.#
# ### ######### ### ### ####### # ##### #
#   # #       # #   #   #     #.#     #.#
### # # ####### # ####### ### # ####### #
#     #         #         #    . . . . .#
#########################################
