############################### #########
# #     #   #     #     #      .      # #
# # ##### # ##### # # # ### ### ##### # #
# #       #   # # # # #   # #  .    # # #
# ### ####### # # ### ### # # # ### # # #
# #   #     #     #   #     # #. .# # # #
# # ### ### ### ### # ### # # # # # # # #
# # #   #     #     # #   # # # #.# # # #
# ### ### ### ### ### # ### # # # ### # #
#   #   # # # #   #   # #   # # #. .#   #
### # # # # # ##### ### # ### ### # #####
# # # # # # #     # #   # #     # #. . .#
# # ### # # ##### # ### # ### # ### ### #
# #     # #     #   #   #   # #   #   #.#
# ####### ##### ##### ### # ##### ##### #
#   #     #           #   # #   # #  . .#
### # # ### # ############# # ### # # ###
# # # # #   #   #     #     # #   # #. .#
# # # # ##### # # ### # ##### # ### ### #
#   # #     # # #   # # #     # #   #. .#
# ### ####### # ### ### # ##### ##### # #
#     #       #   #   #   #       #  .# #
### ### ####### # ### ##### ### # # # ###
#   #   #   # # #   #       #   # # #. .#
##### # ### # ### ########### ### ##### #
#   # #   #       # #         #   #. . .#
# # ### # ### ##### # ######### ### # # #
# #   # #   # #   # # #   #     #  .# # #
# ### # ### ### # # # # ### ####### # # #
# #   #   #   # #   # #   # #    . .# # #
# # ####### # # ##### ### # # ### ##### #
# # #     # #   #         # #   #.#     #
# ### ### ##################### # #######
#     #               #   #   # #. . .  #
# ############# ##### ### # # # ##### ###
# #   #         #   #   # # # #     #. .#
### ### ####### ### ### # # ########### #
#   #   #     #     #   #   #      . .#.#
# ### ### ### ######### ### # ##### # # #
#     #     #                 #. . .#. .#
############################### #########
