################################# #######
#   #          . . .#    . .#    . . .  #
# ### ####### # ### ##### # ##### ### # #
# #   #       #.#  . . . .#. . .#   #.# #
# # ### # ##### ############### ### # ###
#   # # # #  . .#. . .#       #. .# #. .#
##### # # # # ### ### # ######### ### # #
# #   # # # #.#. .  #.#         #. .# #.#
# ### ### # # # ##### ######### ### # # #
# # #   # # #. .  #. .#. . .  # # #.# #.#
# # ### # ######### # # ### ### # # # # #
#     # # #   # #. .# #.# #. .# #. .# #.#
# ### # # # # # # ### # # ### # # ##### #
# # # # #   #   #.#   #. .# #.#  . . . .#
# # # # ######### ####### # # ###########
# # #   #    . . .#. . . .  #.#. . . . . 
# # ##### ### ### # ######### # #########
#         #  .#   #.#       #. .      # #
### ### ### # ##### # ##### ######### # #
#   #   #   #.#. . .#     #         # # #
##### ### ### # ######### ########### # #
#     #   #  . .        # #     #     # #
# ##### ##### # ### ##### # ### # # ### #
# #   # #   # #   #   #   # # # # # #   #
# ### # # # # ####### # ### # # # ### ###
#     # # # #       #   #     # #   #   #
####### ### ##### # ##### ######### ### #
#   #           # #     #         #     #
# # ### # # ##### ####### ####### # #####
# # #   # #     #   #           # #   # #
# ### # # ##### ### # ######### # ### # #
# #   # #     #   #     #     # #   #   #
# # ##### ####### ##### ##### # ### #####
#   #     #     #   #   #   #     #     #
### # # ### # ##### ##### # ####### ### #
#   # # #   #     #     # #     #     # #
# ### ### ##### # ##### # ##### # # ### #
# # # #       # # #   # # #   # # # #   #
# # # # ####### # ### # # # # ### # # ###
#   #     #     #     #   # #     # #   #
#########################################
