######### ##################### #########
#   #   #. .#. . . . . . .#    . .      #
# # # # ### # ########### # ##### # ### #
# # # #   #.#.#   #. . .#.# #. . .# #   #
### # ##### # # ### ### # # # ##### #####
#   # #. . .#.#   #.# #. .# #.#   #     #
### # # ##### ### # # ####### # ####### #
# # # #. . . .  # #.#. . . . .#         #
# # # ##### # ### # # ####### # ### ### #
#   #   #   #   #  . .#       # #   #   #
# ##### # ### # ##### # ######### ### # #
# #   #   #   # #     # #     #   #   # #
# ### ######### # # ### ##### # ### ### #
#             # # # #       # # #     # #
### # ####### # # # # ##### # # ### # ###
# # # #   #   # # # # #     # #   # #   #
# # # ### ### # # # # # ##### ### # ### #
#   # # #   #   # # # # #   #     # #   #
##### # ### ### # # ### # ######### # # #
#   #   # # #   # #   # #       #   # # #
# ####### # # ### ### # ####### ##### # #
#   #       # #   #   #       #       # #
### # ####### # ### ##### ### ######### #
#   #   #     # #   #   #   #   #   #   #
# ##### # ##### # # ### # # ### # # # # #
# #   # # #     # #   # # #   # # #   # #
# # # # # # ##### # # # # ##### # ##### #
# # #     # #     # # # # #     #     # #
# # ####### # ##### # # # # # # ##### ###
# #   #     # #     #   # # # #     #   #
# ##### # # # ########### # ########### #
# #     # # # #   #   #   #       #     #
# ### ### ### # ### ##### # ##### # #####
# #   #   #   # # # #     #     # # #   #
# # ### ### ### # # # ########### # # ###
#   #   #   #   #   #   #       # # #   #
##### # # # # ### ### # ####### # # ### #
# #   # # # # # #   # # #   #     #   # #
# # # # # ### # ### ### # # # # # ##### #
#   # # #     #         # #   # #       #
#########################################
