################# #######################
# #  . . . . .#  .    #. .              #
# # # ####### # # ##### # ####### # ### #
#   #.#. . .#.# #. . . .#.      # #   # #
##### # ### # # ##### ### ##### # ### # #
#. . .#.# #.#.#     #   #. .#   # #   # #
# ##### # # # ##### ### ### ##### # ### #
#. . . .  #.#. .# #   #   #.#   # # #   #
# # ####### ### # ### ##### # # # # #####
# # #. .#. .# #. .# # #. . .# #   #     #
# ### # # ### ### # # # ### # ######### #
# #. .#.#. .# #  .#   #. .# #         # #
### ### ### # ### ####### # # ####### # #
 . .#  . . .#   #. . . . .# #       # # #
### ##### # ### ##### # # # ####### # # #
# # #     # #         # # #       # # # #
# # # ##### # ######### # ### ### # # ###
#   # #     # #         #   #   # # #   #
##### # # ### # ### # ##### ##### #######
#     # # # # # #   # #   #   #   #     #
# ##### # # # # # # ### # ### # ### ### #
#   #   # #   # # # #   # #   #     #   #
### # ### ##### # ### ### # ##### ### # #
# # # # #   #   #       # #     #   # # #
# # # # # ### ########### # # # ##### # #
# # #   #   #   #   # #   # # # #     # #
# # ##### # ### # # # # ### # # ##### # #
# #     # #   #   #   # #   # #   # # # #
# ##### # ### ######### # ### # # # # # #
#       #   #   #   #   # #   # # #   # #
############# # # # ### # # ##### ##### #
#   #         # # # #   # # #   #     # #
# # # ### ### ### ### ### # ### # ### ###
# # # #   #   #   #   #   #     #   #   #
# ### # ### ### ### ### ####### ### ### #
# #   # #   #       #   #     #   #   # #
# # ### ############### ##### ### ### # #
# # #   #   #   #       #   #   #   # # #
# # # # # ### # # ####### # ### ##### # #
#   # #       # #         #   #       # #
#########################################
