######### ##################### #########
#   #   #. . .#   #    . . .#  . .      #
# # # ####### # # # ### ### # ### ##### #
# # #   #    . .# # #  .#. .#   #.# #   #
### ### ####### ### # # # ####### # # # #
#   # #     # #.#   # #.#.#  . . .# # # #
# ### ##### # # # ##### # ### # # # # # #
#   #   #   #. .#     #.#. . .# # #   # #
### ### # ### ####### # ### ##### ### # #
# #   # #    .# #     #.#   #     #   # #
# ### # ##### # # ##### # ### ### # ### #
#   # #     #.# # #  . .# #   #   # #   #
### # # ### # # # ### # ### ### ### ### #
#   #   #   #.#   #. .# #   #   #   #   #
# ######### # ##### # # # ####### ### # #
# #       #  . .#. .# # #       #   # # #
# # ##### ##### # ### # # ##### ##### # #
#   #          . .#   # #     #     # # #
##### ########### ##### ### # ##### # ###
#     #   #     # #       # # #   # #   #
# ####### # # # # # ##### ### ### # ### #
#       #   # # # # #   #   #   # #   # #
# # ### ##### # # # # ##### # # # # # # #
# # #   #     #   # #   #   # #   # # # #
# ### ### ######### ### # ##### ### ### #
# #   #   # #         #   #   # #     # #
### ### # # # ##### # ##### # ### # # # #
#   # # # # #   #   #   #   #     # # # #
# ### # # # # # # # ##### # ########### #
#   # # # # # # # #   #   # #           #
# # # # # # ### # ### # ### # # ### # # #
# # #   # # #   #   # # #   # # #   # # #
# ####### # # ####### # ##### # ##### # #
# #       # # #       #     # # #     # #
# # ##### # # # # # # # # ### ### ##### #
# # #     #   # # # # # #   # #   #   # #
### # # ######### # # ##### # # # # ### #
#   # # # #       # # #     # # # # #   #
# ##### # ########### # ##### # ### # ###
#   #   #             #     # #     #   #
#########################################
