########################### #############
#               #     #    . . .    #   #
### ##### ##### # ### # # ##### ### ### #
#   #     #   #   # # # #     #.  #   # #
# ##### ### # ##### # # ##### # # ### # #
# # #   #   # # #   #   #   # #.#   #   #
# # # # ##### # # ######### # # #########
# #   # #     #     #   #   # #. . . . .#
# ##### # ######### # ### ### # ####### #
# #     # #       # # #   #   #     #. .#
# ####### ####### # # # ### ######### # #
# #   # #   #   # # #   #   #    . . .# #
# ### # ### ### # # ### # # # ### ### # #
#   #   # #     #     # # # # #. .#   # #
# # ### # ##### ##### # ### # # ####### #
# # #   #   #   #   # #     # #. . . .# #
# # # ##### # ### ### ##### # ####### # #
# # # #     # #       #   # #     #. .# #
# # # ### # # # ####### ### # ### # ### #
# # #   # # #     #   #     #   # #.#   #
### ### # # ##### # ############# # # ###
#   #     #   #   #     #         #.# # #
# ########### ### ### # ##### ##### # # #
# # #     # #   # #   # #     #  . .# # #
# # # ### # ### # ##### # ##### # # # # #
# #   #   # # # # #       #     #.# #   #
# # ### ### # # # ############### # #####
# #   #   # # #        . . . . . .#     #
# ### ##### # ######### ######### #######
# #       #       #    . . .#     #. . . 
# ####### ####### # ### # # ####### #####
# #     # #     # #   # # #. .#. . .#   #
### ### # ##### # ##### # # # # ##### ###
#   # # #     # # #     # # #. .    #   #
##### # ##### # # ### # # ######### ### #
#         # # #   #   # #   #     #   # #
# ####### # # # ### # # # # # ### ##### #
#   #   #   #   #   # # # #   # #   #   #
# # # # ### ### ### # # ####### # # # ###
# #   #   #         # #         # #     #
#########################################
