##################################### ###
#                     #     #        . .#
# ################### # ### ### ##### # #
# #         # #     # #   #     #     #.#
# # ##### # # # ##### ############# ### #
# #   #   # # #     # #       #     #. .#
# ##### ### # ##### # # # ### ### ### # #
#     # #       # #   # # #       #  .# #
# # # # # ##### # ### ### ########### # #
# # # # # #   #           #   #    . .# #
# ### # # # ############# # # # ### ### #
# #   # # #               # # # #  . .# #
### ### # ########### ##### # # # # # # #
#   # # #   #   #       #   #   # # #.# #
# ### # ##### ### ####### # ##### # # ###
# #   #         # #       # #   # # #. .#
# # ### ######### # # # ##### ### # ### #
# #   #     #     # # # #   #     # #. .#
# ### ####### ##### # # ### ######### # #
#   #         #     # #   #    . . . .# #
# # ################# # # ##### ##### # #
# # #               # # #   #  .#. .# # #
### # ####### ##### # # # # # # # # ### #
# # # #   #   #   # # # # # # #.#.#. .# #
# # # # # ### # ### # ### ### # # ### ###
#   # # #     #   #   #   #   #.#.# #. . 
# ### # ####### # ##### ### ### # # #####
# #   # #       # #   # #   #  .#. . .# #
### ### ####### ### # ### ##### ##### # #
#   # # #     # #   #     #  . .    #.# #
# ### ### ### # # # # ##### # ##### # # #
#     #   # # # # # # # #   #.#     #. .#
####### ### # # ### ### ##### ######### #
# #     #   # #   #   #   #  .#. . . .#.#
# # # ### ### ### ### ### # # # ##### # #
# # # #   #   # #   #     # #. .#   #. .#
# ##### ### ### ### # ##### # ### # ### #
#     #     # #     # #     #   # #   # #
##### # ##### ### ##### # # ### ##### # #
#                       # #   #       # #
#########################################
