####### ####### #########################
#     #.#      . .                      #
# ##### ####### # #######################
#      . . . .# #.        # #. . .#. . .#
############# # # ####### # # ### # ### #
#     #  . . .# #. . . .# #. .# #. .  #.#
# ### ### ##### ####### ### ### # ##### #
# # #   #.#   # #. . .#. . .    # # #. .#
# # ### # # ### # ### # ######### # # ###
# #   #  .# #   #.# #.# #. . . .#   #. .#
# ### ### # # ### # # ### ##### ####### #
# #     #.#   #. .#  . . .#    .#  . . .#
### ### # ##### ############### ### # # #
#   # # #. .#  .#     #   #   #. .#.# # #
# ### # ### ### ##### # ### # ### # # # #
#   # # #  . . .  # # #     #    . .# # #
##### # ##### # # # # ############# # # #
#   #   #     # # # #   #       #   # # #
# ### ### ##### # # ### # ##### # ### # #
# #   #   #     # #       #   # # #   # #
# # ### ####### # ########### # ### ### #
# #     #       #   #         #     #   #
# ####### ### # # # # ############### # #
#       # #   # # # #       #         # #
# ##### # # ### # # ####### ### # #######
# #       #   # # #       # #   #       #
# ############# ####### # # # # # ##### #
#             # #     # # # # # #     # #
# # ########### # ##### # # # ######### #
# #           #   #     # #   #         #
# ################### # ####### ### ### #
#               #     # #     # #     # #
################# ### # # ### # ### # ###
#     #           #   # #   # # #   #   #
# ### ### ####### ##### ### ### # ### ###
# #   #   #   #   #     #       #   #   #
# ##### ### # ##### ############### #####
#   #   #   # #     #             #     #
### # ##### ### ######### ####### ##### #
#     #         #         #             #
#########################################
