############################# ###########
#  . . .#          . . . .#  .          #
# # ### ########### ##### # # ######### #
# #. .#.#. . . . . .# #. .# #. .#   #   #
# # # # # ########### # ####### # ### # #
# # #.#. .#         #. .#  . . .#     # #
# ### # # ######### # ##### ### # ### # #
# #. .# # #       #  . . .#.# # # #   # #
### # ### # ##### ####### # # # ### ### #
 . .# #   # #     #     #.#.# #   # #   #
### ### ### ####### ### # # # ### # # ###
#   #   # #     #   # #  . .#   # # # # #
# ### ### ##### # ### ### # ### # # # # #
# #   #   #   # # #       # #   # # # # #
# # # # ##### # # ### ##### ### # # # # #
# # # #   #   #   #   #     #     # #   #
# # ##### # ####### # # # ### ### # # # #
# #       # # #     # # # #   #   # # # #
# ##### ### # ##### ### # ##### ### # ###
# #   # #   # #     #   #     # #   #   #
# ### ### ### # # ### ####### # # ##### #
#   #   # #   # # #   #   #   # # #   # #
### ### # # ### # # # # # # # # # ### # #
#   #   # # #   # # # # # # # # #   # # #
# # # ### # # ### # ### # # ### ### # # #
# # # #   # # #   #   # # #   # #   #   #
# ### # ### # ##### # # # ### # # # ### #
#     #       #   # #   #   # # # # #   #
# ### ####### # # ########### # # # #####
#   # #       # #           # # # #     #
### ### # ##### ######### # # # # ##### #
# # #   # #     #     #   #   # # #   # #
# # # ##### # # ##### # # # ### # # ### #
#   # #   # # #   #   # # # #   #   #   #
##### # ### # ##### ### # # # # ##### # #
#     # #   #     # #   # # # # #     # #
# ### # ####### # # ######### # # #######
# #   #   #   # #   #         # # #     #
# ####### # # ####### ######### # # ### #
#         # #               #   #   #   #
#########################################
