##### ###################################
#  . .  #. . .                          #
# # ### # ### ####### ######### ### ### #
# #.#   #.  #.#         #   #     #   # #
# # ##### ### # ##### # # ### # # ##### #
# #. . . .#. .#     # #   #   # # #     #
# ######### # # ### ####### ### # # #####
#         #.# #   #   #   # # # # # #   #
########### # ####### # # # # # # # ### #
#. .#  . . .#   #     # #   # # # #   # #
# # ### ####### # ##### ##### # # ### # #
#.#. . .#       #     #     #   #   #   #
# ################# # ##### #############
#.#. . .#. . . .  # #     #       #     #
# # ### # ##### # # # ############# # # #
#. .  #. .#. .#.# # #       #       # # #
# # ####### # # # # ######### ####### # #
# # #. . . .#.#.# #       #     #   # # #
# ### ####### # # ##### ### ##### # # ###
# #. .#      . .#     #         # # #   #
### ########### ### # ##### ### # # # # #
 . .#           #   # #   #   #   # # # #
# ############### # # # # # # ### # #####
# #     #         # #   # # #   # #     #
# ##### # # ### ### # ### # ### ####### #
# #   # # # #   #   #   # #   #       # #
# ### # # # ##### ##### # # # ######### #
#   # # # # #     #   # # # #   #   #   #
# # # # ### # ##### # ### # ### # ### # #
# # # #     # #   # #     #   # # #   # #
### # # ##### # ### ##### # # # # # # # #
#   #   #   # # #   #     # # # # # # # #
# ####### # ### # ### ####### # # ### # #
#         # #   # #   #       # # #   # #
# ### ##### # ### ##### ######### # # # #
#   # #   #     #     # #     #   # # # #
# # ### # ############### ##### ### ### #
# # #   #                     # # # #   #
# # # ######################### # ### # #
# #                             #     # #
#########################################
