######### ###############################
#  . .#. .                        #     #
### # # ##### ####### ### ######### # # #
#. .#.#. . .#     #     #       #   # # #
# ### # ### ### ### # # ##### # # ### ###
#.#. .#   #. .#   # # #     # # #   #   #
# # ##### ### ### # ####### # ##### #####
#.#.#     #. .# # #       # #   #   #   #
# # # ##### # # # ### ### ##### # ### # #
#.#.# #. . .# # #   # # #     #       # #
# # ### ### # # # # # # # # ########### #
#.#. .#. .# # #   # #   # #           # #
# ### # # # # ### # ########### ### ### #
#.# #.# #.# # #   #   #       #   #   # #
# # # ### # # # ##### ####### # ##### # #
#.#  . . .# # #     #   #     # #   # # #
# ### ### ### ####### # # ##### # # # # #
#. .# #   #     # #   # # #     # #   # #
# # # # ### ### # # ##### # # # # #######
# #.# # #     # # #   #   # # # #       #
### # # ##### # # # # # ### ### # ##### #
 . .# # #   # #   # #     #   # #   #   #
##### # # # # ##### ######### # ### # # #
#     #   # #     # #   #     #   # # # #
############# ### # # ### ##### ### # # #
#     #       # # #   #   #     #   # # #
# ##### ### # # # ##### ##### # # ### # #
#       #   #   # #     #     # # #   # #
######### # ##### # ####### # # # # ### #
#     #   # #     # #       # # # # #   #
# ##### # ### # ### ##### ##### # ### ###
#       # #   # #   #   # #   # # #   # #
# ######### ### ##### # # # # # # # ### #
# #         #       # #   # #   # #     #
### ######### ##### # ########### #######
#   # # # #   #   # # #     #     #     #
# # # # # # ### ### # ##### ### # ##### #
# # #     #     #   #   #   #   # #   # #
# ####### ####### ##### # ### # # # # # #
#       #         #     #     # #   #   #
#########################################
