##################################### ###
#   #   # #  . . . .#        . .#    .  #
# # # # # # # ##### ######### # # ### ###
# # # #   # #.#   #. . . .#  .#.# #  . .#
# ### ##### # # # ### ### ### # # ##### #
#           #.# #     #  . . .#.# #. . .#
######### ### # ####### ####### ### # # #
#   #   # #  .# #. . .# #     #. . .# # #
# # # # ### # ### ### # # ### ####### # #
# # # #   # #. . .#. .# # # # #     # # #
# ### ### # # ##### ### # # # ##### # # #
#     # #   #     #.#   # #       #   # #
####### # ######### # ### ####### ##### #
#   #   # #  . . . .# #       #         #
### # ##### # ### ### # ##### ######### #
 . .# #     #.#   #   #     # #     #   #
### # # ##### # ### ######### # ### # # #
# #. .#   #. .#   #         # # # #   # #
# ### ### # ##### ######### # # # ### # #
#   #.#   #. .  #   # #   # # # #   # # #
### # ##### # ##### # # ### # # ### ### #
#   #. . .# #. .  # # #     # #   #     #
# ####### ##### # # # ####### ### #######
#        . . .#.# #   #       # #       #
############# # # # ########### # ##### #
#       #    . .# # #           #     # #
# ##### # ##### # ### ##### ####### # # #
# #   # #     # # #     #     #     # # #
# ### # ####### # # ##### # # ### # ### #
#   #           #   # #   # #   # # #   #
# # ######### # # # # # ### ### # ### ###
# #   # #   # # # # # # #   #   #   #   #
# # # # # # ### # ### # ########### ### #
# # # #   #     #   # #           #   # #
# # # ############# # ### ############# #
# # #             # #   #         #   # #
# ##### # ######### ### ####### # ### # #
#     # #   #     #     #     # #     # #
##### # ##### ### ####### ### ######### #
#     #         #           #         # #
#########################################
