######### ###############################
#        .            #                 #
# ##### # ######### ### # ############# #
# #     #.        # #   #     #       # #
# # ##### ####### # # ##### ### ####### #
# # #   #. .  #   #       #     #       #
# # # # # # ### ##### ### ###############
# #   # # #. .#     #   #             # #
# ##### ##### ##### ### ############# # #
# #   #     #. .  #   #         # #   # #
# # ########### # # # ######### # ##### #
# # #      . . .# # #         # #   #   #
# # # ##### ##### ### ######### ### # ###
#   # #  . .#   #   # #     #   # # #   #
##### ### # # ### # # # # ### ### # ### #
#     #. .# #   # # # # #   #     #   # #
# ##### ### ### ### # # ############# # #
# #. . .# # # # #   #   #           #   #
# # ##### # # # # ### ### ######### ### #
# #.#     # # # #   # #   #       #   # #
# # # ##### # # # # # # ######### # ### #
# #.# #     # # # # # # #     #   #   # #
### # ### ### # ### ### # ### # ##### # #
#. .#     #. .#     #   # #   # #     # #
# ######### # ####### ##### ### # ### # #
#. . .  #. .#. .      #     #   # #   # #
# ### ### ##### ####### ##### ######### #
#   #. . .#   #. .#. .#. .    #       # #
### # # ### # ### # # # # ##### ### ### #
#   # # #   # # #. .#. .#. . . . .#   # #
# # # ### ### # # ### ########### ### # #
# # #       #   #   #         #. .  #   #
# # ####### ####### ########### # #######
# #       # #     #     #  . . .# #. . . 
# ####### # # ##### ### ### ####### #####
#       # # #     #   #   #. . .#. .#   #
##### # # ####### ### # # # ### # ##### #
#   # # #       # # # # # #   #. .  #   #
# ### # ##### ### # # # # ########### ###
#     #     #     #   # #               #
#########################################
