### #####################################
#  . . .#. . . .  #. .          #       #
# # ### # ##### ### # ### ### # ####### #
# #   #. .    #. . .#.  #   # #       # #
# ########### # ##### # ##### ##### ### #
#   #   #   # #   #. .# #     #   # #   #
# # ### # ### ##### # # # ##### # # # ###
# #   # #     #  . .# # #   #   #   #   #
# ##### ######### ##### # # ####### ### #
#   #   #. . . . .#     # #       # #   #
# # # ### ####### # ########### # ### ###
# # # #  . .#     #   #       # #   # # #
# ### ### # # ####### ### ### # ### # # #
#   #   # #.# #. .#   #   # #     #   # #
### ### ### ### # # ####### # # # ##### #
# #   # #. .#. .#.#         # # # #     #
# # ### # # # ### ######### ### # # #####
# #     #.# #.# #.#. . .  # #   #       #
# # ##### ### # # # ### # ### ### ##### #
# #   #  . .#.  #. .# #.#   #   #   # # #
# ##### # # # ####### # ### ### ### # # #
#     # # #.#.        #.  #   # #   # # #
##### ### # # ######### # ### # ##### # #
#   #     #. .#. .#. . .#   # #     # # #
# ######### ### # # # # ##### ##### # ###
#    . . .# #. .#.#.# # #     #     #   #
##### ### # # ### # ### ### # # ####### #
#  . .#  .# #.#  .#. .# #   # #         #
# # ##### # # ### # # ### # # # ####### #
# #.#   #.# #. .#.# #.#   # # # #     # #
# # # # # # ### # ### # ##### # # ### # #
# #.# # #.# #. .#. . .# #   # # # #   # #
# # ### # ### ##### ### # # # # ### ### #
# #. .#  . . .#     #   # # # #     #   #
##### ##### ######### # ### # ####### ###
 . . .#   # #         # #   #       #   #
####### # # # ##### ### # ### ### ##### #
#       # # # #     #   # #   #   #   # #
# ######### ######### ### ##### ### # # #
#           #         #         #   #   #
#########################################
