# #######################################
#. . .                                  #
# ### ######### ####################### #
# # #.#. . . .#         #     #   #   # #
# # # # ##### ### ####### # ### ### # # #
# # #.#.    #. .# #       #     #   #   #
# # # # ##### # # # #####################
#   #. .    # #.#   #                   #
########### ### ##### ############# #####
 . . . . .#   #. . . . . . . . .  #     #
######### ### # ####### ####### # ##### #
#      . .  # #       #   #. . .# #     #
# ##### ##### ####### ### # ### # # ### #
# #   #.#     #. .# #   # #. .# # # #   #
# # # # ####### # # ### # # # # # # #####
# # # #. . . . .#.#     # # #.# # #     #
# # ##### ####### ####### ### # # ##### #
# # #     #     #.#. .# #   #.# #   #   #
# # # ##### ##### # # # ### # ##### # # #
# #   #   #      . .#. .#   #. .  # # # #
# ####### ############# ####### # # ### #
#   #     #            . .#  . .# #   # #
### # ########### ####### ### # # ### # #
#   # #           #     #. . .# #   # # #
##### # ############# # ### ### # # # ###
#   # #       #       #     #   # # #   #
# ### ######### ############# ##### # # #
#   #           #           #   #   # # #
### ##### ####### # ####### ##### ##### #
#         #   # # # #             # # # #
####### # # # # ### ############### # # #
#       # # # #     #           #     # #
# ####### # ### ### # ######### ### ### #
# #       #   # #   # #       #   #     #
# ####### ### ### ### ####### ### ### # #
# #       # #   # # #       #       # # #
# # ####### ### # # ### ########### ### #
# #     #   #     #   #   #     #     # #
# ##### # ####### ### ##### ### ##### # #
#     #   #       #         #           #
#########################################
