########### #############################
#          . . . . . . .        #. .    #
# ##### ### # ######### ######### # ### #
# #   # #   #         #. . .#. . .#.# # #
# # # # # # ######### ##### # ##### # # #
#   # # # #     #   # # #. .#.#   #.# # #
####### ####### ### # # # ### ### # # # #
#       #   #   #   #   #. . .#   #.#   #
# ### ### ### # # ####### # # # ### #####
#   # # # #   # #  . .#   # # # #. .#   #
### # # # # # ##### # ##### ### # # ### #
#   # #     # #  . .#. .# #     #.#     #
# ### ######### # # ### # ####### ### # #
# #     #   #   #.# #  . . . . . .  # # #
# ##### # ### ### # # ########### # # ###
# #   # #     #  .# # #     #   # # #   #
# # # # ######### ### # ### ### # # ### #
#   # #     #  . .#   # # #   #   #   # #
########### # # ### ### # ### ##### # # #
#           # #. .# #   #   # #     # # #
# ### ####### # # # # # ### # # # # ### #
# #   #     # # #.# # #   #   # # # #   #
# # ####### # # # # ##### ### # ### # ###
# # #  . .#   # #.#   # # #     #   # # #
##### # # ##### # ### # ### # ### ### # #
#     #.#. .# # #.# # #   # # #   #   # #
# ##### ### # # # # # ### # # # ### ### #
# #  . .#  . .# #.#     # # # # # # #   #
# ### # ##### # # ##### # # # # # # # ###
# #. .# #   #.# #.    # #   # # # #   # #
# # ##### # # ### ### ######### # ##### #
# #.#     # #. .#.  #       # #   # #   #
# # # ##### ### # # # ##### # ##### # ###
# #.# #. .#    . .# # #     #       # # #
# # ### # ####### # # # ### ### ##### # #
# #. . .#. . .#   # # # #   #   #   #   #
# ########### # ### # # ##### ### # ### #
#   #   #. . .# # # # #     #   # #   # #
# # ### # ### # # # ##### ### ### ### # #
# #     #.#   #   #     #           #   #
######### ###############################
