############################### ##### ###
#  . .#    . .#    . .#. . . . .#   #.# #
# # # ##### # ##### # # ### ### ### # # #
# #.#. . . .#. . . .#.#.# # #   #   #.# #
### # ############### # # # # ### ### # #
#. .# #. .#          . .#   #   # #. .  #
# # ### # ##################### # # #####
#.# #. .#. . . . . .#. . . .  # # #.#   #
# ### ####### ##### # ##### # # # # ### #
#. .#.#     # #   #.#. .  #.# #   #. .# #
# # # # ### ### # # ### ### # ####### # #
# #. .  # #   # # #. . .#. .# #. . . .# #
# # ##### ### # ### # ### ##### ####### #
# #         # #   # #   #. . . .    #   #
# ######### # ### # ##### ########### ###
#         # #     #     #   #         # #
# # ####### ########### ##### ######### #
# #   #   #           #               # #
### ### # ####### ### ####### ######### #
#   #   #   #       # #     #         # #
# # # ##### # ##### # # ### ######### # #
# # # #   # # #   # # #   # #   #   # # #
# # # ### ### # ### # ##### ### # # # # #
# # #     #   #     #           # # #   #
# ### ##### ####################### # ###
#         #             #           #   #
# ####### # ### # ##### # ### ###########
#   #   # #   # #     # #   #       #   #
### # ### ### # ##### ##### ####### # # #
# # # #     # #   #   #     #     # # # #
# # # # # ### ### ##### ##### ### # # ###
# # #   # #     #             #   # # # #
# # ### ### # # ##### ############### # #
#     # #   # #     #                 # #
### # ### ### # ### ################### #
#   #   # #   #   #       #           # #
####### # ######### ### ### ######### # #
#     # #         #   #     #       #   #
# ### ####### ### ### ############# # ###
#   #         #     #               #   #
#########################################
