################### #####################
#       #          . . .#. .  #. .  #. .#
# ##### ### ####### # # # # ### # # # # #
#   #   #   #       # #. .#. . .#.# #.#.#
##### ### ### ##### # ####### # # ### # #
#   # #     # #   # #       # # #. . .#.#
# # # ##### # ### # ####### # ######### #
# # #       #   #   # #   # #     #. . .#
### ########### ##### # ### ##### # ### #
 . . .#  . . .#       #   #     # #.#   #
##### ### ### ####### ### ##### # # #####
#    . . .# #.#. .# #   #     # # #. . .#
# ######### # # # # # ####### # ####### #
#   #     # #.#.#. .#       # #   #   #.#
##### ### # # # ### ##### ### ### # ### #
#     #   #  . .# #. .# #   #   # # #. .#
# ####### ##### # ### # ### ### # # # # #
#   #           #    . .#   #. .#   #.# #
# # ################### # ### # ##### # #
# # #   #     #     #  .# #. .#. . . .# #
# # ### ##### # # # ### ### ### ### ### #
# # #   #     # # #   #. . .#   #   #   #
# # # ### ##### # ### ### ### ### ### # #
# #     #       # #     # #   #   #   # #
# ####### ####### ##### ### ### ### #####
#       # #     #   #       #     #     #
####### ### ##### # ### ####### # # ### #
#     #   #       #   # #       # # #   #
# ####### ######### # ### ####### # # # #
# #   # #   #       #   # #       # # # #
# # # # ### # ########### # ####### # # #
# # #     # # #           #   #     # # #
# ##### # ### # ############# ####### # #
# #     #     # #             #       # #
# # ##### ##### # ####### ##### ### ### #
#   #   # #     # #       # #     # #   #
##### ##### ### ########### # ### # # ###
#     #   #   #             # # # # # # #
# ##### # ################### # # # # # #
#       #                       # # #   #
#########################################
