############################# ###########
#   # #        . . . . .#    . . . .    #
# # # # ####### ####### ##### ### # ### #
# #   #   #. . .#   #  . . .#   # #.  # #
# ######### # ### # ####### ### # # ### #
# #      . .# #   #       #.#   # #. .# #
# # # ### ### # ######### # # ####### # #
#   # #  .#   # #   #   #. .#       #.# #
# ##### # ##### # # ### # ########### # #
# #     #. . .# # # # # #.#  . .#  . .# #
# # ### ##### # ### # # # # # # # # # # #
# # #   #   #.#   #     #.# #.#.# #.# # #
# # ##### # # ### ### ### # # # ### # # #
# # #     # #. .#   # #  .# #.#. . .# # #
# # # ##### ### ### # ### ### ####### # #
# #   #   #   #.  # #   #. . .#     # # #
####### # ### # ### ### ####### ### # # #
#       #. .# #. .#   #         # #   # #
# ####### # ##### ############### ##### #
# #    . .#. . .#. . . .  #     #       #
# ##### ####### # ##### # ##### ####### #
# #. . .# #. . .#     #.#   #       #   #
### ##### # ########### ### # # ### # # #
 . .#   #. .#    . . . .  # # #   #   # #
##### # # ####### ### # ### # ### ### # #
#     # #. .#. . .#   # #   #   # #   # #
# ######### # ##### ### # # ####### ### #
#   #   #  . .#     #   # # #   #   #   #
### # # ### ### ##### ### ### # # ##### #
# #   #     #   #   # #       # # #     #
# ########### ##### # ######### # ### # #
# #   #       #     #   # #   # #   # # #
# # # # ### # # ##### # # # # # ### # ###
#   #   #   # # #     #   # #   #   #   #
######### ### # ########### # ### ##### #
#           # # #           # #   #     #
######### # ### # ############# ### #####
#         #   #   #     #       #     # #
# ########### ##### ##### ########### # #
#           #           #           #   #
#########################################
