################################### #####
#               #                  .    #
# ##### ##### # ####### ####### ### ### #
# # #   # #   #     #   #       # #.  # #
# # # ### # # ##### # # # ### ### # # # #
#   # #   # # #   # # # # #   #   #.# # #
##### # ######### # # # # # # # ### ### #
#     #     #   #   # # # # #   #  . .# #
# ######### ### # ### ### ######### # # #
#   #         #       #   #         #.# #
# # ######### ### ##### ### ######### ###
# #       #     # #     #   #    . .#. .#
# ####### ##### ### ##### ####### # ### #
# #     # #         #     # #. . .#. . .#
### ##### # ######### # ### # # ### ### #
#   #     # #         # #   #.# #   #   #
# ### # ##### ### ##### # ### ### ### # #
# #   # #     #   #     # #  . .#   # # #
# # # ### # ### ### # ### ### # ### # ###
# # # #   # #   #   #     #   #. .# #   #
# ##### ### # ### ######### ### # ##### #
# #     #   # # # #     #   #   #. .#   #
# # ##### # # # # ##### # ####### # #####
# # #     # #   #     # # #     # #. . .#
# # # # ### ######### # # ##### # ##### #
# # # #   # #       # # #     # # #   #.#
# # # # # ### # ##### # ### ### # # # # #
#   # # #     #   #   #   #     # # # #.#
### # # ### ### # # ##### # ##### # # # #
#   # #   # # # # #       #     #   # #.#
# ### ### # # # ############### ##### # #
# #     # # # # #             #   #   #.#
# # # ### # # # # ################# ### #
# # # #   # # #   #   #             #. .#
### # # ### # ####### # # ##### ##### # #
#   # # #   # #       # # #     #  . .# #
# ### # ##### ##### # ### # ### # # ### #
#   # # #   # #     # #   # #   # #. .# #
### # # # # # # ##### # ##### ####### # #
#   # #   # #   #       #     #. . . .# #
############################### #########
