######### ########### ###################
#     #  .#       #  . . .#. . . .      #
# ### ### # ####### # ### # ### # ##### #
#   #   #.#         #   #. .  # #.#   # #
### ### # ################### # # ### # #
#   #  . .# #   #    . . .#   # #. .#   #
####### ### # ### ### ### ##### ### #####
#      . .# #     #  .#  . .# # #. .    #
# ####### # ####### # ##### # # # # #####
# #     #. .#     # #.#   #. .# #.#     #
# ### ##### # ### # # # ##### # # ##### #
# #       #.#   #   #.# #    .# #. .#   #
# # ##### # ### ##### # # ### ##### # ###
# # #   # #.#   #. . .#   #  . . . .#   #
# # # # # # ##### # ####### # ######### #
# # # # #  . .#. .# #       # #       # #
# ### ####### # # # # ######### ##### # #
#   #   #   #.#.# # #   #       #     # #
# # ### # # # # # # ### ####### ### ### #
# #   #   # #. .# #   #       # #       #
# ### ### ####### # # ####### ### # ### #
#   #   #       # # #     #   #   # #   #
### ### ####### # ### ### # ### ### # ###
# # # # #   #   #   #   # # #   #   #   #
# # # # ### # ### # ##### # ########### #
# # # #   #     # # #     #       # #   #
# # # # # ##### ### # # ######### # # # #
# # # # # #   #     # #       # #   # # #
# # # # # # ##### ### # # ### # # ### ###
# #   # #   #     #   # #   #   #   #   #
# ########### ##### # # ####### ##### # #
# # # #       #     # #   #   # #   # # #
# # # # ####### ##### # # # # # # # ### #
# #   # #       #     # #   # # # #     #
# ### # # ####### ######### # ### ##### #
#     # #   #   # #       # #   #   # # #
##### ##### # # # # ##### ### # # # # # #
#   #       # # # # #       # # # # # # #
# ########### # # ######### ### ### # # #
#             #   #             #   #   #
#########################################
