##### ###################################
#    .  #       #. .          #         #
# ### # # ####### # ### ##### # ### #####
# #. .# #. . . . .#.  #     # # # #     #
# # ##### ######### # ### ### # # ##### #
# #. . .#.# #   #. .# # #   # #   #   # #
# # ### # # # # # # # # ### ##### ### # #
# #   #.#.# # # #.# #   # #           # #
# ##### # # # ### ####### # ########### #
# #. . .#.  #   #. .      #   #       # #
### # ### ##### # # ########### ### # # #
#. .# #. .#   # # #. . .        #   # # #
# ##### ### ### # # ### ######### ##### #
#. . .#.# # #   # # #. .#       # #     #
# ### # # # # ### ### # # ##### # # ### #
#   #.#. . .  #   #. .# #     # # # #   #
# # # ##### ####### # # ##### # # # #####
# # #. .  #.#. . . .# #     # # # #     #
### # # ### # ### ### # ##### # # ##### #
#   # #. . .#.# # #   #   #   # #     # #
# ### ##### # # # # ### ### ##### ##### #
#   #     # #.#   # # #     #       #   #
### ##### ### ##### # ####### ### ### # #
# #     #   #. .  # #         #   #   # #
# # ### ### # # # # ############### ### #
# #   # # # # #.# #     #           #   #
# ### # # # # # ####### # ###############
#     #   # # #. .    # # # #     #     #
########### # # # ### # ### # ### # ### #
#   #       # # #. .# #       # #   #   #
# ### ### # # ### # ##### # ### ##### ###
# #   #   # #   # #. .  # #     #   # # #
# # ####### # # # # # # ##### ##### # # #
#   #       # # # # #.#   # #       #   #
# # ######### # # ### ### # # # #########
# # #       # # # #. .  #   # #         #
### # ##### ### # # ############### ### #
#   # #   #     # #. . . . .    # #   # #
# ### ### ##### # ######### ### # ##### #
#   #     #     #         #.  #   #     #
########################### #############
