############# ################### #######
#   #        . . .  #. . . .    #.#   # #
# ### ### ### # # ### ##### ### # # # # #
#     #   #   # #. .#. .# #. .# #.# # # #
##### # ### ### # # ### # ### ### # # # #
#     # #   #   # #. .#.#   #. .#.# #   #
# ##### # # # ##### # # ### # # # ##### #
# #     # # #     # #. .    # #.#. . .# #
### ##### ####### ### ####### # ##### # #
#   #   #       #   #   #     #.  # #.# #
# ### # # # ### ### ### ####### # # # # #
# #   # # # # #   #   #     #  .# #  . .#
# # ### # # # ### ### ##### ### # ##### #
# # #   # #   #   # #     #   #.#     #.#
# # # ### ##### ### # ### ### # ####### #
# # #     #     #   #   # # # #.  #. . .#
# # ####### ### # ### # # # # # ### #####
# #   #     #   #   # # #   # #. . .  # #
# ### ####### ##### # # # ### # ##### # #
#   #     #       #   # # #   #     #   #
### ### # # # # # ##### ### # ##### ### #
#     # # # # # #     #   # #     #   # #
# # # # # # ### ##### ### # ### # # # ###
# # # # # #   #     #   # #   # # # #   #
# # # # ##### ### ##### # ### # ### ### #
# # # #     #   # #   # #   # # #   #   #
# # # ######### # # # # ### # # # # #####
# # #       # # # # #   #   # # # # #   #
# ######### # # # # # ### ### # # ### # #
#   #     #   # # # # #   #   # #     # #
# ### ### ##### # # ### ####### ### ### #
# #   # #   #   # #   # #     #   #   # #
# ##### ### # ### ### ### ##### # ##### #
#         # # #   # #     #     # #     #
# # ### # # # ##### ######### # ### # # #
# #   # #   #     #           # #   # # #
# ### ####### # # ############# # ##### #
# #   #   # # # #         #     # #     #
# ##### # # # ########### ######### ### #
#       #   #           #   #       #   #
#########################################
