### #####################################
#  .  #. .    #   #             #   #   #
# # ### # # # # ### ##### # ### ### # # #
# #. . .#.# #   #   #   # #   #     # # #
# ####### # ##### ##### # ### ######### #
# #. . . .# #           #   #     #     #
# # # # # # # ########### # # # # ##### #
# #.# # # # # # #   #     # # # # #   # #
### # # # # # # # # ####### ### # # # # #
#. .# # # #   #   # #       #   # # # # #
# ##### # # ####### # ####### ### # ### #
#.# #   # # #       #   #     # # # #   #
# # # ### # # ########### ##### # # # ###
#.#   # # # # #   #       #   #   #     #
# ##### # ### # ### ####### # ##### #####
#. . .  #     #     #       #           #
# # # ############### ####### ######### #
# # #. . . .          #     #         # #
# ######### ### ####### ### ##### ### # #
#   #     #. .#           # #   #   # # #
### # ####### ########### # ### ##### # #
# #   #. . . .  #     #   #   #       # #
# ##### ### # # # ### # # ### ####### # #
#. . . .#   # # #   # # # #       #   # #
# ##### ##### # ### # # # # # ### ##### #
#.#   # #     #     # # # # #   #     # #
# # # # # ### ####### # # # ### ##### # #
#.# #   # #   #       # # #   #     # # #
# ####### # ### ####### # ### ##### # # #
#. . .  # # #   #       #   #   #   # # #
# # # ### # # ### # ########### # ##### #
# # #.#   # # #   # #   #       # #   # #
# ### # ### # # # # ### # # ##### # ### #
# #. .# #   # # # # # #   # #     # #   #
### # # ##### # ### # ##### # ##### # # #
 . .# #     # # #   #       # #   # # # #
##### ##### ##### ########### ### # # # #
#     #   #   # #           #     # # # #
# ##### # ### # ######### # ####### ### #
#   #   #     #           #       #     #
#########################################
