##################### ###################
#                    . . . . . .        #
# ######### ######### # ### # # #########
#       #   #         #   # # #.#. . . .#
######### ### ####### # # # ### # ##### #
#   #     # #     #   # # #   #. .    #.#
# # # # ### # # # # ##### ### # ##### # #
# # # #     # # # # #     # # # # # # #.#
# # ######### ### # # # ### # # # # ### #
# #       #   #   # # #   #   #   #   #.#
######### # ### ### # ### ########### # #
#       #   #   #   # # #     #   #   #.#
####### ####### # # # # ### ### # # ### #
#     #         # # # #   #     #   #. .#
# ####### ####### # # ### # ######### # #
# #   #   #   #   # #     #   #      .# #
# # # # ### ### ### # ######### ##### # #
#   #   #     # #   #   #       #  . .# #
##### ####### # # ####### # ##### # ### #
#   # #         #   #     #     # #. .# #
# # ### ############# # # # # # ### # # #
# #   # #     #       # # # # #   # #.# #
##### # ### # # # ####### # # ### ### ###
#   #   #   #   # #       # #   #   #. .#
# # ##### # ####### ####### ### ### # # #
# #       # #   #   #         #   # # #.#
########### # ### ########### ##### ### #
#   #   #   #     #           #     #. .#
# # # # ########### # ######### ##### # #
# #   #   #   #   # #   #       #    .# #
######### # # # # # # # ##### ### ### # #
#       #   # # #   # #     # #   #. .# #
# ####### ### ####### ##### ### ### ### #
#         #         # #   #   # #. .#   #
########### ####### ##### ### # # ### ###
#         # #     #     #     # #. .#   #
##### ### # # ### ##### ####### ### ### #
#     # # # # # # #         #   #. .  # #
# ##### # ### # # # # ##### ### # ##### #
#     #       #     #     #     #.#     #
################################# #######
