####################################### #
#                              . . . . .#
# ######### # ### ####### ##### ##### # #
# #       # # #   #       # #  .#   # # #
# # ####### # # ### ##### # # # # ### # #
#   #       # # #   # #   #   #.# #   # #
####### # ##### # # # # ####### # # ### #
#       # #   # # # # #     #. .# # #   #
# # # # ### # # # # # ##### # ### # # # #
# # # # #   #   # # #     # #. .# # # # #
### # # # ####### # ##### # ### # # # # #
#   # # #   # #   #     # # # #.#   # # #
# ##### # # # # ####### # # # # ####### #
# # #   # # #   # #   #   #   #.#       #
# # # ### # ##### # ########### # #######
# # #   # # #       #      . . .#   #. . 
# # ### ### ##### ### # ### # ####### ###
# #     #   #   # #   #   #.# #. . . .# #
# ####### ### # # ### # # # ### ####### #
# #       #   # #     # # #. .#.#       #
# # ####### ### ######### ### # # #######
# # #       #   #         #. .#.#   #   #
# ##### ### ### # ##### ### ### ### ### #
#   #   #   #     #     #  . .#. .#     #
### # ### ### ######### # ### ### ##### #
#   #   # #   # #       #   #.  #.#   # #
# ##### # # ### # # # # ##### ### ### # #
# #     # #   # # # # # #   #. .#.#. . .#
# ####### ### # # # ### ### # # # # ### #
# #   #   # # # # #   #   # # #.#. .#. .#
# # ### ### # # # ### ##### # # ##### ###
# #     #   #   #   #       # #. .  #.# #
# ####### # ####### # ####### ### # # # #
#       # # # #     # #     #   #.# #.# #
# ####### ### # # # # # ### # # # ### # #
#         #   # # # # # # # # # #. . .  #
########### ### # ### # # # ### # #######
#       #   #   #   # # # #     #   #   #
# ####### ######### # # # ### # ### ### #
#                   # #   #   #   #     #
#########################################
