################################### #####
#      . . . . . . . . . . . . .#. .  # #
# ##### # ##################### # # # # #
# #   #.# #       #   # #. . . .#.# #   #
# # ### ### ##### # # # # ####### # # ###
#   #. .#   #       # #  .#      .# #   #
##### # # ########### ### ####### # ### #
#  . .# # #         #    . . .#  .#   # #
# # ### # ######### ######### # # ### # #
# #.#   #         #         #.# #.# # # #
# # ####### # ########### # # ### # # # #
# #. .    # #       #     # #. .#.#   # #
# ### ### # ######### # ### ### # ### # #
# #. .  # # #   #   # #   # #  . .  # # #
### # # # # ### # # # ### # ### ### # # #
 . .# # # # #   # # # #   #   # #   # # #
##### ### ### ### # ### ##### ### # # # #
#     #   #     # # #   #         # # # #
# ##### # # ##### # # # # ########### # #
# #   # # # # #   # # # # #           # #
# # # # ### # # ### ##### # ########### #
# # # #   #   # #         # #           #
# # # # # ### # # ######### ######### # #
#   # # #     # # #   #     #         # #
##### # ####### ### # # # ### ####### # #
#   # #   #   #   # # # # #   #       # #
# ### ### # # ### # # # # # # ######### #
#       # # #   # # # # # # #       #   #
##### ### ##### # # # ### ####### # # # #
#   #   #       # # #   # #     # # # # #
# ### # ### ##### # ### # # ### ### ### #
#   # #   #   #   # #   #     # #   #   #
### ### # ##### # ##### ######### ### ###
#     # #   #   # #   #           #     #
##### ### # # ##### # ####### # ### ### #
#   #   # # #       # #   #   # #   #   #
# # ### ### ######### # # ##### # ### ###
# # #               # # #     # #   # # #
# # # ############### # ##### ##### # # #
# #   #               #     #       #   #
#########################################
