############################### #########
#       #           #          . . . .  #
# ##### ##### ##### ### ########### # ###
#     #   #       #   #     #. . .# #. .#
# ### ### ########### ####### ### # ### #
# # #   #    . . .# #   #  . .#  .# #. .#
# # ######### ### # ### # # ##### ### # #
#   #  . . . .#  . . .# # #.#. .#. . .# #
##### # ############# # # # # # ####### #
#     #.#. . . .# #. .# # #. .#. .#   # #
### ### # ##### # # ### # # ##### # # # #
#   #  .#. . .#.#. .#   # #     #.# # # #
# # # # ##### # # ### ### ####### ### # #
# # # #.    #.#.#.#   #   #. . .#. .#   #
# ### # ##### # # # ### ### ### ### #####
#   # #. .#. .#.#. .#   #  .# #. .#. .  #
# # ##### # ### ### # ##### # ### # # # #
# # #   #. .  #.# #.# #. . .#. . .# #.# #
# # # # # # ### # # # # ##### ####### # #
# #   # # # #. .#. .# #.#   #.#    . .# #
# ##### # ### ### ##### # ### # ### # # #
#   #   # #. .# #.#  . .#. . .# #. .# # #
### # ### # # # # ### ### ####### ##### #
#   #   # #.# #  . . .#. .#  . .#. .#   #
# ### # # # ########### ### # # ### # ###
# # # # # #. . . .#. . .#   #.#. .#.#   #
# # # # # # ##### # ######### ### # ### #
# #   # # # # #. .#.#  . . . .#  .#.  # #
# ##### # # # # ### ### ######### # # # #
#     # # # # #.#  . . .#       #.#.# # #
##### # # # # # ######### ##### # # ### #
#   # # # #   #. .#. . .# #   #  . .#   #
# # # ### ##### # # ### ##### ####### ###
# # #   #     # #. .  #. .  #       # # #
### ### ##### # ####### # ######### # # #
#     # #     # #     # #. . . .  #   # #
##### ### # # # ##### # # ##### ####### #
#   # #   # # #     # # # #   #. .      #
# # # # ##### # ### # # ### # ### #######
# #     #     #   #   #     #   #.      #
################################# #######
