##################### ##### #############
#                    .#. . .#     #     #
# ### ##### # ####### # ##### ### # ### #
# #   #     # #   #  .#.#. .# #. .# # # #
# # ### # ### # # ### # # # ### # # # # #
# # #   # # # # #   #.#.#.#. . .#.#   # #
# ### ### # # ##### # # # ####### ### # #
#   #   # # #     # #.#.#.#   #. .#   # #
### ### # # # # ### # # # # # # ### ### #
#   #   #   # #     #.#. .# # #.# # # # #
########### # # ##### ####### # # # # # #
#         # # #   #  .  #. .  #. .# #   #
# ####### ### ##### # ### # ##### # #####
# #     #     #     #. . .#. .  #.  #   #
# ##### ####### # # # # ##### ### ### ###
# #   #   #     # # # #     #. . .#     #
# # # ### # # ### # # ##### ####### ### #
# # # # #   # # # # #     #   #     # # #
# ### # ##### # # # # # # ##### ##### # #
#     #       #   # # # #     #   #   # #
# ##### # ### ##### # ####### # ### ### #
# # #   # #   #     #     # # # #   #   #
# # # # # # ### ### ##### # # # # #######
#   # # # # # #   # #   #   #     #     #
##### # ### # # # ### # ##### ##### ### #
#     # #   #   #     #     #       #   #
# ##### # # ####### ####### ######### # #
#   #   # # #     #       #         # # #
### ### # ### ### ####### # # ####### # #
# # #   # #     #     # # # # #     # # #
# ### # # # ####### # # # # ### ### # # #
#     # #   #   #   #   # #   # #     # #
####### # # # ### # ##### ### # # ##### #
#     # # # # #   # #     #   # # #     #
# ##### # # # # ### # ######### # # ### #
#       # # # # #   # #   #     # # # # #
# ##### # # # ####### # ######### # # # #
# #   # # # #     #   # #   #     # # # #
# # ### # ####### # # # # # ####### # # #
# #     #       #   # #   #         #   #
#########################################
