##################################### ###
#           #     #       #       #  . .#
# ######### ### ### # ### ##### # # # # #
# #     # #   #     # #         # # # #.#
# # ### # ### ####### # ######### ### # #
# #   #       #   #   # #       #     #.#
# ### ### ### ### # ### # ############# #
#   #   # # #   #   #   #         #    .#
### ##### # ### ### # ########### # ### #
#   #     # #   #   # #      . . .# #. .#
# # ##### # # ####### ### ### ### ### # #
# # # #   #           #   #. .#  . . .# #
# ### ######### ####### ### ########### #
# #   #     #   #       #  .# #         #
# # ### ### ##### # ####### # # #########
#   #   # #       # #     #.#   #   #   #
##### # # ### # ### # ### # ####### ### #
#     # #     # #     #   #.        #   #
# ##### ####### # # ### ### ######### ###
#   # # #     # # # #   #  .#. . . . .  #
# # # # # ### # # ### # # # # ####### # #
# # #   # #   # #   # # # #. .#     #.# #
# # ##### ### ##### # ### ######### # ###
# #     #   #       # #   #         #. .#
# ##### ### ######### # ### ########### #
# #   #   #     #   # #     #   #    . .#
# # # # # ##### ### # ####### ### ### ###
# # # # # #     # # #     # #     #  . .#
# ### ### # ##### # ##### # ### ##### # #
#     #   # #   #   #   #   #   #     #.#
# ##### ##### ### ### # ######### ##### #
#     # #   #         #     #     #  . .#
####### # # ############### # ####### # #
#       # #                   #    . .# #
### ##### ##################### ### ### #
#   #       #   #   #           #. .#   #
# ######### ### # # ####### ##### #######
# #   #     # #   # #   #   #    . . .  #
# ### # ##### # ##### # # ####### # # # #
#     #       #       #   #       # #.# #
##################################### ###
