######### ###############################
#        .          # #       #     #   #
# # ##### # ######### ####### # ### ### #
# # #  . .#   # #   #   #   # # #     # #
### ### ### # # # # ### ### # # ##### # #
#   #. .#   # # # # # #   # # #     # # #
# ### ### ### # # # # ### # # ##### # # #
# #  . .#   #   # #   # #   #     # # # #
# # # # ### ######### # ### ##### # # # #
# # # #.  #       #   # #       # # #   #
# ### # # # # ##### ### ####### # ##### #
#   # #.# # #           #   #     #     #
### ### # ### ########### ### ##### #####
#   #. .#   # #           #     #       #
##### # # # # # ### ####### ##### ##### #
#. . .# # # # # # #   #     #     #   # #
# ##### # # ### # ##### ##### ##### # # #
#. .#   # #   #   #   # #     #. .# #   #
# # # ##### # ### ### # # ##### # # #####
# #.# #   # #   #     # #. . . .#.# #. . 
# # # ### # ### ##### # # ####### ### ###
# #.#     #   #     # # #.# #   #. . .  #
# # ######### # ### # # # # # ### ### # #
# #. .  #     #   # # # #.# #   #   # # #
##### # ######### ### # # # ### ### # # #
#. .#.# #         #   #. .#   # #   # # #
# # # # # ####### # ### ##### # ##### # #
#.#. .# # #       #   #. . . .# #   # # #
# ### # # ########### ####### # # # ### #
#.#   # #   #       #   # #. .# # #   # #
# # ### # # # ##### ### # # ### # ### # #
#.# #   # # # # #   #   # #. .  # #   # #
# ### ####### # # ### ### ### ### ##### #
#. .#     #   # #   #. . . .#.#   # #   #
# # ##### # ### ##### ##### # # ### #####
# #. .# # # #. .#. . .#   #. .  #       #
# ### # # # # # # ##### ############### #
# # #.#   #. .#. .      #             # #
# # # ##### ############# ### ######### #
#   #. . . .                #           #
#########################################
