################################### #####
#         #   #             #  . .#. . .#
# ### ### ### # ########### # # # # ### #
#   # # #   # #     #. . .#   #.#.# #. .#
# # # # ### # ####### ### ##### # # # ###
# # # #      . .#  . .#  . . . .#.# #. .#
# # # ####### # ### ############# ### # #
# # #     #  .#. .#.#           #. .# #.#
# # # ### # # ### # # ######### ### # # #
# # #   # # #.#. .#.#     #   # #. .# #.#
# # ##### # # # ### ##### ### # # ##### #
# # #     # #.#. . .#     #   #  . .#. .#
# # # # ### # ### ### ##### # ##### # # #
# # # # #   #.#   #   #     #     #. .# #
# # ### ##### ##### ##### ####### ### # #
# # # #   # #. . .# #     # #   #   # # #
### # ### # # ### # ####### # # ### # # #
#   #   # #   #. .#       #   #   # # # #
# ##### # ##### ################# # ### #
#   #   #   #  . . . .          # # #   #
# # # ### # # # # ### ####### # # # # ###
# #   #   # # # #   #. . .# # # #     # #
# ##### ##### # ##### ### # # # ####### #
#     # #     # #. .# #. .# # #   #     #
####### # ### # # # ### ### # ### # #####
#       #   # # #.#. .#.#   # #   #     #
# # ### # # ### # ### # # ### ######### #
# # #   # #   # #.#  . .#     #         #
# # # ### # # ### ##### ####### #########
# # # #   # #   #.#. .# #         #     #
### ### ### # # # # # # # ######### #####
#   #   #   # # #. .#.#   #. .    # #. . 
# ### ### ##### # ### ##### # ### # # ###
#   #   #   #   #   #.#. . .#.#   #. .# #
### ### ### # ##### # # ### # ##### ### #
# #   #   # #     # #. .  # #. .#. .  # #
# ### # # # ##### ### ### ### # # ##### #
#     # # # #   # # #   #   # #. .#     #
####### # # # # # # ### ### ####### #####
#       # #   # #   #     #             #
#########################################
