################################### #####
#                       #          . .  #
### # ####### ### # ### ##### ##### # # #
#   #   #   #   # # # #   #   #     #.# #
# ### # ### # # ### # ### # ##### ### # #
#   # # #   # #   # # # #   #     #  .# #
# # ### # ### ### ### # ##### # ##### # #
# #   #   # #   # #   #       # #  . .# #
##### # ### # # # # ### ######### # ### #
#   # #     # # # # #     #     # #. .# #
# # # ######### ### ### # # ### ### # ###
# # #     #     #   #   #   # #   # #. .#
# ####### # # ### ### ### ### # # # ### #
#         # #   # #   # #     # # #   #.#
########### ### # ##### ####### # ##### #
#           #   #           #   #   #. .#
# ########### ############# ######### # #
# #   #       #    . . . .#   #      .# #
# # # ##### ### ### ##### ### # ##### ###
#   # #     #   #  . .#  . .#   #    . .#
##### # ##### # # # # ##### ######### # #
#     # #     # # # #. . .#. . .#. .# #.#
# ##### ### # ### # ##### ##### # # ### #
# #     #   # #   # #   #. . .#. .#. . .#
# ### ### ### # # # # # ##### ### ##### #
# #   #   #   # # # # #     #.# # #   # #
# # ### # ##### # # # ##### # # # # ### #
# # #   #     # # # # #. .# #.# # #     #
# # # ####### # ### # # # ### # # ##### #
# # # #       #   #   #.#. . .#   #     #
### # # ##### ### ##### #################
#   # #     #   # #   #. .#. . . .      #
# ### # ### ##### # # # # # ##### ### ###
# #   #   #   #   # #   #. .    #.  #   #
# # ####### ### ### ##### ##### # # ### #
# #       # #   #   # #   #. .# #.# #   #
######### # # ####### # ### # ### # # ###
#       # # #       # # #. .#. . .# # # #
# ####### # ####### # # # ######### # # #
#         # #       #   #.#         #   #
######################### ###############
