############################# ###########
#       #   #            . . .    #     #
# # ### ### # # ##### ### ####### # ### #
# # # #     # # #     #  .#       # #   #
# # # ##### ### # ### # # # ######### ###
# # # #     #   #   # # #.# #. . .  #. . 
# ### ### ### ####### # # ### ### # # ###
#   #     #   #     # # #. . .#. .# #.# #
######### ### # ### # ######### # ### # #
#     #       #   #   #   #. . .# #. .  #
# # ### ##### # # ####### # ### ### #####
# #   # # #   # #   #     #.#   #. .#   #
# ### # # # ### ### # ##### ##### ### # #
#   # #   # #   # #     #  .#. . .#   # #
### # ##### # # # ####### # # ######### #
# # # #     # # #   #     #.#. .#. . .# #
# # ### ##### # ### # # ### ### # ### # #
# # #   # #   #   # # # #  .  #. .# #.# #
# # # ### # ##### # # ### # # ##### # # #
#     # # #     #   # #   #.#     #. .  #
### ### # ########### # ### ####### #####
#   #                 #   #.  #. . .#   #
##### # ######### ######### # # ##### # #
#     # #           #   #. .# #.    # # #
# ##### ######### # ### # ### # ##### # #
#   #   #     #   #     #.#   #.#   # # #
##### # # ### # ### ##### ##### # # # # #
#     # # #     #   #  . .#. . .# #   # #
# # ### # ####### ### # ### ### # #######
# # #   # #     #   # #. . .  # # # #   #
# # # ### # ### ### # ##### # ### # # ###
# # # # # #   #   # #     # #   # # # # #
# ### # # ### ##### # # # ##### # # # # #
#   # # #   #       # # #     #   # # # #
# # # # ### ######### # ### ####### # # #
# # # #   #   #   # # #   #     #     # #
### # ### ### ### # # ####### ### ##### #
#   #   #   #   # # #   #   #   #     # #
# ##### ### # # # # # ### # ### # ##### #
#     #     # #     #     #   #         #
#########################################
