######### ###############################
#. . . . .                          #   #
# ##### # ######### ### ####### ##### ###
#.#. .# #   #     #   #     #   # #   # #
# # # ##### # ####### # ##### # # # ### #
#.#.#. . .# #. . .  # #     # #   # #   #
# # ##### ### ### ### ##### # ##### # ###
#. .    #. . .  #. .#     # #       # # #
# # ### ########### ### # # ######### # #
# # # # #   #. . . .  # # #         #   #
# # # # ### # ##### # # ####### ####### #
# #   #     #.#   # # #       #         #
# ########### # ### # # # ###############
#   #  . .#  .# #   # # #           #   #
### ### # ### # # ### # # # # ##### # # #
#   #. .#. . .#   #   # # # #     #   # #
# ### ############# # # # # # # # # ### #
#   #.# #     #     # # # # # # # #   # #
##### # # ### # ### ### # # # # # ##### #
#  . .#   # #   # # #   # # # # # #     #
### # ### # ### # # # ### # # # # # #####
 . .# #   # #   #   # #   # # # # # #   #
### # ##### # ####### # # # ##### # ### #
#   #       # #       # # #   #   #     #
# # # ####### # ##### # ##### ###########
# # # #       # #   # #     #       #   #
# ### # ####### # # ##### ##### ### # ###
# #   # #     #   #     #     #   # #   #
# # ### ##### ####### # ##### ### ### # #
# #   #       # #     #   #     #     # #
# ############# # ### ##### # # # ### # #
#             # # # # #     # # # # # # #
# ####### ### # # # # # ##### # ### ### #
# #         # # # #   # #   # #   #     #
# # ##### # # # ####### ### # ### #######
# # #   # # #   #       #   #   #   #   #
### ### ### ########### # ### # ### # ###
# #   #     #         # #   # #   # #   #
# ### ############### # ### ### # # ### #
#                     #   #     # #     #
#########################################
