################# #######################
#       #        .    #. .#. . .    #   #
# ##### ####### # ##### # # ### ### ### #
# #   # #       #. . . .#. .  #. .#     #
# # # # # ####### ############# # #######
# # # # # # #   # #. . . . . .# #. .    #
# # # # # # # # # # ######### ### # ### #
# # # #   # # # # #.# #. . .#. .# #.  # #
# ### ##### # ### # # # ### ### # # ### #
# # #  . .# # #   #.# #.  #. . .# #. .# #
# # ### # # # # ### # # ######### ### ###
#   #  .#. .# # #. .# #.#     #   # #. .#
####### ### # # # ### # # ##### ### ### #
 . . . .#  . .# #.#   #. .  #   #   #. .#
# ########### ### # ##### ### # # ### # #
# #   # #    . .#.# #   #.#   # #   #.# #
### # # # ##### # # # ### # ### ### # # #
#   # #   #    . .#  . . .#   # #   #.# #
# ### ##### ### ##### ####### ### ### # #
# # #       #   #    . . .# #     #  .# #
# # ############# ####### # ######### # #
# #             # #     #. .#. . . . .# #
# ##### ####### ### ### ### # ######### #
#   #   #   #   #   #   #. .#.#       # #
# # ####### # ### ##### # ### # ####### #
# #     # # # #   #   #  .#  .# #       #
####### # # # # ##### ### ### # # # ### #
#     #   #     #       #. .#.# # # #   #
# ############# ####### ### # # # # # ###
# #     #       #     # #  . .#   # #   #
# # ### ######### ##### ### # ##### #####
#   # #     #   # # #   #   # #   # #   #
### # ##### ### # # # ### ### ### # ### #
#   #           # #   #   #     # # # # #
# ############# # # ### ####### # # # # #
#   #       #   #     # #     # #   # # #
### # ##### ### ##### # # # # # ##### # #
# # #   # #   #   #   # # # #         # #
# # # # # ### ### # ### # # ########### #
#   # #   #             # #             #
#########################################
