############################# ###########
#         #   #              . .        #
# # ##### # ### # # ########### ### ### #
# #   # #       # # #   #  . . .  # #   #
# # # # ######### ### ### # # ##### # ###
# # # #           # # #   #.# #     # # #
# ### ### ##### # # # # ### ### # ### # #
# #   #   #     # # # # #  .#   # #   # #
# # ### ##### # ### # # # # # # # # # # #
# # #   #     # #   #   # #.# # # # # # #
# # # # ### ##### ####### # # ### # ### #
# # # #   #       #       #.#   # #     #
# # ##### # ### ### ####### ### # #######
# #     # #   #   # #    . .# # #       #
######### ### ##### ##### # # # #########
#         #   #     #. . .# #   #       #
# # ##### # ### ##### ##### ### # ##### #
# # #     # #   #    .#     #   # #   # #
### # ##### # # # ### # ########### # # #
#   # #     # # # # #.#             # # #
# # ### ##### # # # # ##### ####### ### #
# # #   #     # # # #. .  #       #     #
# ### ### ### ### # ### # ########### ###
# # #   #   # #   #   #.#           #   #
# # ### # # ### ##### # ########### #####
#   # # # #   #     # #. .  # #   #     #
##### # ##### ### ### # # # # # ### ### #
#   # #     #   #     # #.# # #   # #   #
### # ##### ##### ##### # # # ### ### # #
#   #     #   # #     # #.# #. .#     # #
# ####### ### # ####### # ### # #########
# #     # # #   #     # #. . .#. . . .  #
# # ### # # ##### ### # # ### ####### # #
#   # #   #       #     #   #       #.# #
##### ### ### ######### # # ######### # #
#             #         # # #  . . . .# #
# ### ################### # # # ####### #
# #   #     #     #     # # # #. .#   # #
# # ### ### # ### # ### ### # ### # ### #
# #   # #     #     #       #   #.#     #
################################# #######
