############### #########################
#  . . . . . . .            #           #
### ### ####### ### ################### #
#. .#   #       # #           #         #
# ####### ####### # ##### # ### ####### #
#.#   #   #       #   # # #     # #   # #
# # # ### # ######### # # # ### # # # # #
#.# #     #. . .    # # # #   # #   # # #
# ######### ### ### # # # ### # ##### # #
#. .    #. .  #.  # # # # #   # #     # #
# # ##### ##### ### ### # ####### ### # #
# #. . . .  #. .#   #   #           # # #
# ######### # # # # # ############# ### #
#     #. .# #.# # # #   #   #     # #   #
####### # ### # # ##### # # # ### # # # #
#    . .#. . .# #     # # # # #   # # # #
##### ### ##### ##### # # ### # ##### # #
#. . .#   #     #   # #   #   #       # #
# ######### ##### # # # ### ######### # #
#. .#       #     # #   #   #     #   # #
# # ######### ##### ### ##### ### ##### #
# #. . . .        #   # #       #     # #
######### ######### # ### ### # ##### # #
 . . .#. .        # #       # #     # # #
##### # # ####### ### ##### # ##### # ###
#    . .#   #   #   #     # #     # #   #
# ### # ### # # ### ##### ### ##### # # #
# #   #   # # # #       #   # #     # # #
# # ####### # # # ######### # # ##### # #
# # # #   # # # # # #       # # #     # #
# # # # # # # ### # # ####### # # ##### #
# #   # #   #     # # #       # # # #   #
# ##### ### ##### # # ######### # # # # #
#   #   #   #   # # #       #   #   # # #
# # # ### ##### ### # ### ### ####### # #
# # # #   #     #   # #   # #   #     # #
### # ####### ### ### # ### ### # # #####
#   # #       #   # # # #   #   # #   # #
# ### # ####### ### # # # ### # # ### # #
#   #             #   #   #   # #   #   #
#########################################
