################### ############# #######
#   #   #     #   #.# #          .      #
# ### # ##### # # # # # ######### ### # #
#     #   #   # # #. .#   #    . .  # # #
######### # ### ##### ### ##### ### ### #
#         #   #   # #.  #     #.#   #   #
####### ##### ### # # ####### # # ### ###
#     #   #     # # #.#   #   #.#   #   #
# ### ### # ### # # # # ### ### ####### #
#   # # #   # # # # #.  #   #  .#     # #
### # # ##### # # # # ### ##### # ##### #
#   # #     #  . . . .#   #. .#.#     # #
##### # ### ### ####### ### # # ##### # #
#     #   #   #.#   #   #  .#.#. . .#   #
# ### ####### # ### # ##### # ### # #####
# #       # # #.#   # #  . .#. .# #. . .#
# # ##### # # # # ### ### ##### # ##### #
# # #   # # #  . .#   #. .#   #.# #   #.#
# ### # # # ##### ##### ### ### # ### # #
#   # # #     #  . .# #. .# #. .#     #.#
### # ####### ##### # # # # # ######### #
#   #       #   #  .#   #.# #.#      . .#
# ### ######### ### ##### # # ####### # #
# #   #   #   #    . . . .#. .#. . . .# #
##### ### # ############### ### ##### # #
#         #               #.#  .#     # #
######### ####### ####### # ### # ##### #
#                 #     # #. . .#   #   #
# ########### ##### ### # ### # ### # # #
# #       #   #     #   #     #   # # # #
# # ##### # ### ### # ############# # # #
# # #   # # #   #   #               # # #
# # ### # ### ################# ##### ###
# #   #       #         #       #       #
# ### ########### ##### # ####### ##### #
# # #   #         #   # #       # #   # #
# # # # ### ##### # ### ####### # # # # #
# # # #   # #   # #   #       # # # # # #
# # # ### ### ### ### ####### ### # ### #
#   #   #   #     #               #     #
#########################################
