####################### #################
#      . . .#        . .    #       #   #
# ##### ### # ####### # # ### ##### ### #
#     #. .#.# #  . . .# #   #     #     #
##### # # # # ### ### # # # # ###########
#. .# # #.#.#   #.#   # # #       #     #
# # # ### # ### # ##### ### ##### # #####
#.#.# #. .#. .# #. .  #   #   #   #     #
# # # # ##### ##### ##### ### # ####### #
#.#.# #.#    . . . .#       # #       # #
# # ### # ######### # ### ### ### ##### #
#.#. .#.# #       # # #   #     #       #
# ### # ### ##### ### # ### # ### #######
#. .#. .#   #         # #   #   #       #
# # # ### # ####### ### # ##### ####### #
# #.# #   # #       #   #     # #     # #
### # # ##### ####### ### # ### # ### ###
 . .# # #   #   #   # #   #   #     #   #
##### # # # ##### # # # ##### ### # ### #
#   # # # #       #   # #       # #   # #
# ### # # ### ########### ### # # ##### #
#     # # #   #           #   # # #     #
### ### # # ### ####### ####### # ### # #
#   #   # # #   #       #       # #   # #
##### ### # # ######### ########### # # #
#     #   # #   #     #     #       # # #
# ####### # # # # ### # # # # ### ##### #
# #     # # # #   # # # # # #   #     # #
# # ### # # ####### # ### # ##### ### # #
# #   #   #         #   # #     # # # # #
# ### ####### ####### # # ##### # # ### #
#   # #     #   #     # #     # #   #   #
### # ##### ##### ##### ####### ##### # #
# # #     #       #     #         #   # #
# # ### ########### # ### ######### # # #
# #   # #     # #   # # # #   #   # # # #
# ### # ##### # # ### # # # ### # # # # #
#   # #     # # # #   # # # #   #   # # #
### # # ##### # # # ### # # # ######### #
#     #       #   #   #   #   #         #
#########################################
