########################### #############
#             #    . . . .#.      #     #
# ####### ### ### # ##### # ### ### # ###
# #   #   # #     #.#    . .  #     #   #
# # ### ### ####### ######### ######### #
# # #   #  . .#   #. . . . .#       #   #
# # # ##### # # ### # ##### ####### # ###
# # # # #. .#.#     #     #. . .  # #   #
# # # # # ### ############# ### ### ### #
# # #   #.# #. . . . . . .#   #.#   # # #
# # ##### # ### ######### ### # # ### # #
#   #  . .# #   #. . . .#. .# #.#     # #
##### # # # # ### ##### ### ### ####### #
#     #.# #   # #. . .#.#  . . .    #   #
# ##### ####### ##### # # ### # ##### # #
#     #. . .    # #. .#.#   # # #     # #
##### ### # ##### # ### ##### # # ### # #
#   #   # #. . . . .#. .#     # # #   # #
# ### # # # ##### ### # # ##### # # ### #
# #   # # # #. .#   #.# # #   # # # # # #
# ##### # # # # ##### # # ### # # # # # #
# #     # # #.#.#. . .# #   # # # #   # #
# # ### # # # # # ### ##### # # # ##### #
# # #   # # #.#. .#   #   # # # #   #   #
# # ##### # # ######### ### # # ##### # #
#   #     # #. . . . .#   # # #   #   # #
##### ### # ######### ### # # ### # #####
#   # #   # #     #. .  #   #   # #     #
# # # ##### # ##### # # ####### # ##### #
# # #     #   #  . .# #         #   # # #
# # ### # ##### # # # ########### # # # #
# #     # #     #.# #     #     # # #   #
# # ### ### ##### # ### ### ### # # #####
# # #   #   # #. .#   #       # # # #   #
# # # ### # # # ##### ######### # # ### #
# # # #   # # #. . .#       #   # #   # #
# # # ### # # # ### ####### # ### # ### #
# # # #   # # #   #.#     # # #   #   # #
##### # ##### ### # # ##### # ####### # #
#     #       #   #.#       #       #   #
################### #####################
