############# ###########################
#            . .        #           #   #
############# # # ##### # ##### ### # # #
#   #         #.#     #       # #   # # #
# # ### ####### ##### ######### ##### # #
# #     #      . .  #         #       # #
# ### ########### ### ####### # ####### #
# #   #  . . . .#. .#   # #   #     #   #
# ##### # ##### ### ### # # ####### #####
# #     #. . .#. .#. .# # # # #   #     #
# # ######### ### # # # # # # # # #######
# #     #   #. .#.# #.# #   # # # #     #
# ######### ### # ### # ##### # ### ### #
#           #. .#. . .#   #   # #     # #
# ########### ### ### # # # ### # ##### #
# #  . .#  . .#   #   # # #     # # #   #
### # # ### ### ### ### # # ##### # # # #
#   #.#. . .#   #   #   # # #     # # # #
# ### ##### # ### ### # ### # ##### # ###
# # #.#     #   # #   #       #   # #   #
# # # # ####### # # ########### # # # # #
#   #.# #       # #             #   # # #
##### # # ### ### ############# ####### #
#  . .# # #   #         # #   #     #   #
### ##### # ### # ### # # # ##### # # # #
 . .#     # #   # #   # # # #     # # # #
# # # ##### # ### # ### # # # ### # # # #
# # #   #   #   # # #   # # # #   # # # #
### # # # ##### # # ##### # # ##### ### #
#   # # # # #   # #     #   #     # # # #
# ### # ### # ##### # # # ##### ### # # #
#   # #     # #   # # #   #     #   #   #
# # # ########### # # # ######### #######
# # # #   #       # # # #   #     #     #
# # # # ### ####### # ### # ####### ### #
# # #   #   #   #   #     #           # #
# # ##### ### # # ##################### #
# #   #   #   # #       #           #   #
# ### # ### ### ##### ### ### ####### # #
#   #         #     #     #     #     # #
#########################################
