##################################### ###
#   #     #     #            . . .#  .  #
# ### ### ### # ####### ##### ### ### # #
#     # #     #   #     #  . .#. .#. .# #
####### ######### ##### # # ### ### ### #
#    . .# #    . .#   # # #. .#.#  . .# #
# ### # # # ### # # # # # # # # ### # ###
# #. .#. .# #. .#.# #   # # #.#. .# #. .#
# # ##### # # ### ####### ### ### ##### #
# #. .# #.# #.# #. .#     #. .# #. . .#.#
# ### # # ### # ### ####### ### ##### # #
# #. .#  . . .#    . . .#. .# #   #. .#.#
# # # ####### ######### # # # ### # ### #
# #.# #     # #        . .# #    . .#  .#
### # # ##### # ######### ####### ##### #
 . .# # #     # #   #     #      . . . .#
### # # ####### # ### ##### # ######### #
#   # #   #   #   #   #     # #         #
# ### ### # # ##### ### ##### # # ##### #
# # # # #   # #     #   #     # # #   # #
# # # # ##### ### ### # ####### # ### # #
#   # #   # #     #   # #   #   #   # # #
##### ### # ########### # # # # # # # # #
#       #   #           # # # # # # #   #
# ### ##### # ### ### ##### # ### # #####
# #   #   # # #   #   #     # #   #     #
# # ### ### # ##### ### ##### # ### # # #
# # #   # # # #   # #         # #   # # #
### # ### # # # # # # ### ##### ##### # #
#   # #   #   # #   #   # #     #   # # #
# ### # ### ### # ####### # ##### # # # #
#   # # #   #   # #       # #     #   # #
# # # # ##### ##### ####### ##### ##### #
# #   # #     #     #   #     #   #     #
# # ### # ### ####### # # ### # # #######
# #   #   #   #     # # # #   # #     # #
# ### ######### ### # # ### # # ##### # #
#   #     #       # # #     # # #   # # #
# # ####### ####### # ####### # # # ### #
# #         #       # #       #   #     #
#########################################
