### ############# #######################
# #. .#. . . .  #.#   #   #   #   #     #
# # # # ##### # # ### # # ### # # ##### #
# # #. .    #.# #. .#   # #   # #   # # #
# # ####### # ##### ##### # ### ### # # #
# # #. . .# #. .  #.#   # # #   # # #   #
# # # ### ##### # # # ### # # ### # # ###
#   #.#  . . . .# #. .#   # #     # # # #
##### # ####### # ### # ### ####### # # #
#    .# #. .#   #   #. .#         #     #
##### ### # ########### # ####### # #####
#. . .#. .#. . . . .  #.# #   #   # #   #
# ##### ######### # ### # # # ##### ### #
#. . . .        # #. .#. .# #   #       #
# # # ######### ##### ### # ### # #######
# # #   #     #   # #.  #.# # #   #     #
# # ##### ### ### # # ### # # ##### ### #
# # # #     #   #   #. . .    #       # #
# # # # ##### # ##### ######### ####### #
# # #   # #   #     #           # #     #
# ### ### # ######### # # ####### # # # #
#         # #   #   # # #     #   # # # #
# # ####### # ### ### ### ### # ### # # #
# #       #     # # # #   #   # #   # # #
# ####### ### ### # # # ####### # # ### #
#       #   # #   #   # #       # # #   #
# # ### ### # # ####### # ####### # # ###
# #   # #   # # #       #   #   # # # # #
# ### # ##### # # # ### ### # # # # # # #
# #   #     # # # # #   # # # # # # # # #
# ######### ### # # ##### # ### # ### # #
#     #   # #   # #             #   #   #
##### ### # # ### # #####################
#   # #   #     # # #         #       # #
### # # ### # # # ### ####### # ##### # #
#   # # #   # # #     # #   #       #   #
# ### # # # # # ####### # # # ###########
# #     # # # #       #   # #   #     # #
# ####### # # ############# ### # ### # #
#         # #                 #     #   #
#########################################
