############### #########################
#   #          .  #     #     #. . . .  #
# # # ##### ### # ##### ##### # ##### # #
# # # #     #. .#     #     # #. .# #.# #
# ### # # ### # ### ####### # ### # # # #
#     # # # #.#   #       # #   #. .#.# #
### ### # # # ### ####### # ### ### # ###
#   #   # # #. .#       # # #   #. .#. .#
# ### ### # # # ######### # # ### ##### #
# #   #     # #. . . . .#   # #. .#   #.#
# # # ####### # ##### # ##### # ### ### #
# # # #   # # #     # #. . .  #.    #. .#
### ### # # # ##### ##### # ### ##### # #
#   #   #   #   #   #   # #.  #.#. . .# #
# ### ####### # ##### # ### ### # ##### #
#       #   # #     # #   #. . .#.#   # #
# ##### # ### ##### # ### # # ### ### # #
# #   #   #   #   # #   # # #   #. .#   #
# # # ##### # # # # ##### # ### ### #####
# # # #     # # # #       #   #   #. . . 
# # # # ##### # # ### # ### ##### ### ###
# # # #     # # #   # #   #     #   #   #
# # ####### # # ##### ##### # # ### ### #
# #       # # # #   #     # # #   #   # #
# ####### # ### ### # ### # # ####### ###
#       # #     #   # #   # # #     #   #
# ### # # # ##### ##### # # # # ### ### #
#   # #   #     # #     # # #     #   # #
### # # ####### # ### ##### # # ##### ###
# # # #       # #     #     # #     #   #
# # # ######### ### # # ### # ######### #
#   # #   #   # #   # #   # # #         #
####### # # ### ##### ### # # # ####### #
# #     #   #       # #   # # # #     # #
# # ############### # # # ### ### ### ###
#       #   #   #   # # # # #       #   #
####### ### # ### ##### # # ########### #
#     #   #       #     # #           # #
# ####### ######### # ############### # #
#                   #               #   #
#########################################
