##################################### ###
#       #   #        . . . .#  . . .#. .#
# # ### # # ##### ### ##### # # ### # # #
# # #     #       #. .#   #.# #.# #.# #.#
# # ### ########### ### # # ### # # ### #
# #   # #     #    .#   #  . . .#  . .#.#
# ### ### ### # ### ####### ### ##### # #
# #   #   # # # #  . . .#   #   #    . .#
# # ### ### # # ### ### ##### ### ##### #
# # # # #   # #   # # #. .  #   # # #   #
### # # # ### # # # # ### # ### # # # ###
#   #   #   # # # # #   #.# # # # # # # #
########### # ### # ### # # # # # # # # #
#  . .#  . . .#   #     #.# # # #   # # #
# # # ### ### # ######### # # # ##### # #
# #.#. . .# #.#   #. . . .#   # #   #   #
### ##### # # ##### ### # ##### # #######
 . .#     #  . .#. .#   # # #   #       #
##### ######### # ####### # # # ####### #
#     #     #  . .#       #   #       # #
# ##### ### # ### # ##### ##### # ### # #
# #   # # # #   # # #     #   # #   #   #
### # # # # ##### # # ##### ### #########
#   #   #         # #     # # #       # #
# ##### # # ### ### ##### # # # ##### # #
# #     # # #   #       # #   # #   # # #
# ######### # ### # ### # # ##### # # # #
#       #   # #   #   # # #       # #   #
# ####### ### # # ### # # # #############
#       #   # # # # # # # # #       #   #
##### # ##### # # # # # ### # ##### ### #
#   # # #     # # #   #       #     #   #
# # ### ### ### # ##### ### ### ##### ###
# # #   #   # # #     #   #   #       # #
# ### ### ### # ##### ### ############# #
#     #   #   #     #   #           #   #
####### ### ####### ### ######### # # ###
#   #     #       #   #     #   # # #   #
# # ### # ####### ##### ### ### # ### # #
# #     #       #         #     #     # #
#########################################
