########################### #############
#                          .  #   # #. .#
# # ####### ######### ##### # ### # # # #
# # #     # #           #  .#     # #.#.#
# # # ### # # ####### # ### ####### # # #
# # #   # # # #       #   #.  # #. . .#.#
# # ### # # # ######### # # # # # ##### #
# #   # # # #   #     # # #.# #. .#. . .#
# # # # ### ### # ### ### # ### ### # # #
# # # #     #   # # #     #.#. .#. .# # #
# # # ####### ### # ####### # ### ##### #
# # #   #     #   #        . .# #.#     #
# # ### # # ### # ######### # # # # #####
# #   # # #   # #     #     #   #.# #. .#
### # # # ### ### ### ### # ##### ### # #
#   # # #   # #     #   # # #   #. . .#.#
# ##### ##### # # ##### # ### # ####### #
# # #   #     # # #     # #   # #     #.#
# # # ### ##### # # # ### # ### # ##### #
# #   #   #     # # # #       #   #  . .#
# ####### # ##### # # # # ######### # # #
#   #   # # #     # # # #   #   # # #.# #
# ### # # # # ##### # # ##### # # # # ###
# #   # # # #     # # #     # #   # #.#. 
# # ### # ######### # ##### # ##### # # #
# # #   # #         # #   # #       #. .#
# ### ### # ######### # # # ####### # ###
#       # #   #   #   # # #   #   # # # #
# ####### # # # ### ##### # # ### # # # #
#   # #   # #   # #       # #     # #   #
### # # # # ##### # ####### # ##### #####
# #   # # #   #   #       # #     #   # #
# ##### # ### # ######### # ##### # # # #
#       #   # # #   #   # #     # # #   #
### ####### # # # ### # ### ##### ### ###
#   #     # #     #   # #   #   #   #   #
# ### ### # ####### ### # ### # # # #####
# #   # # #     #   #     #   # # #     #
# # ### # ##### # ############# ####### #
#       #     # #             #         #
#########################################
