######################### ###############
#   #    . . . .#    . . .              #
# # # ### ##### ##### ### # # ####### # #
# # # #  .#   #.#. . .#   # #   #   # # #
# ### # # ### # # ######### ### # # # # #
#     # #. .#  . .# #   #   #   # # # # #
####### # # ##### # # # ### # ### # ### #
 . .#   # #.#     #   #     # #   #     #
### ####### # ##### ##### # # ###########
# #. .#  . .# #     #     # #           #
# ### # # ### ####### ##### ######### # #
# #. .# #. .#       # #   #     #     # #
# # ### ### ####### ##### ####### ##### #
#. .# #   #. . .  #     #         #   # #
# ### ### ### # # ### # # ### ##### ### #
#. .#   #   # #.# #   # # #   #     #   #
### ### ### # # ### # # ### ### ##### # #
# #. .#     # #.#   # # #   #         # #
# ### ####### # # # ### # ##### ####### #
#    . . . .# #.# # # # #     # #     # #
########### ### # ### # ##### ### ### # #
#         #. . .# #   #     #   #   # # #
# ### ### ### # # # ####### ### ### # # #
#   # # #     # #   #     #   #     # # #
##### # ####### # # # ### # ######### ###
#     #         # # # # # #         #   #
# ##### ##### # # ### # # # ### #########
#     #   #   # #       # #   #         #
######### # ### # ### ### ### ##### ### #
#         # #   #   # #   #   #   #   # #
# ##### # # # # ### ### ### ### ### # # #
# #   # # # # # #   #   #   #       # # #
# ### ### # # # # ### ### ####### ##### #
#     #   # # # #   # #   #       #     #
####### ### # ####### # ########### #####
# #     #   # #   #   #         # # # # #
# # ##### ### # # # # ##### ### # # # # #
#   #       #   # # #   # #   #   #   # #
######### # ####### ### # # # ######### #
#         #   #       #   # #           #
#########################################
