######################### ###############
#                        . .    #       #
### ####### ### ########### ### # #######
#   #       # # #. . . . . .  #   #. . .#
# # # ### ### # # ######### # ##### ### #
# # #   #     # #.#         #   #. .  #.#
# ##### ####### # # ############# ##### #
#   #   #       #.# # #. . . . . .  #. .#
# # ##### ### ### # # # ############# # #
# #     # #   #  .# #. .#   #     #. .# #
# ##### # # # # # ### ### # ##### # ### #
#   #   # # # # #. . .#   #       #.#   #
##### ### # # # # # ### ########### # # #
#     #   # # # # #     # #        .# # #
# ##### ##### # # ####### ######### # ###
# #     #     # #       #   # #    .#   #
# # ##### # # # ##### ##### # # ### ### #
# #   #   # # #     #     #   #   #. .# #
##### ##### ####### ### ##### ### # # # #
#   #   #       # #   #     #   # # #.# #
# ##### # # # ### ### ### ##### # ### # #
# #     # # #       #   #     # # #. .# #
# # # # ### # ####### # ### ### # # #####
#   # # #   #     #   # # #     # #. . . 
# ##### # ####### # ##### ####### #######
# #     #   #   # # #   # #     #       #
### ##### # # # # # # # # # ####### ### #
#   #   # # # #   #   #     #     #   # #
# ### # # # # ##### ### ##### ### ### # #
#   # # # # # #   #   #       #   #   # #
# # ### # # ### # ### ######### ####### #
# #     # #     #   #       #   #     # #
######### # ##### # ####### # ### ### # #
#         # #   # #   #   # # #   #     #
# ##### # # ### ##### # # # # # # ##### #
#   #   # #   # #     # #   # # # #   # #
### ##### ### # # ### # ##### ##### ### #
# #   #   # # # # #   # #     #   # #   #
# ### # ### # # # # ### ####### # # # # #
#     #     #   # #   #         # #   # #
#########################################
