####################### ############# ###
#   #          . . . . .  #. . .  #. .# #
# ### ####### # ######### # ### ### ### #
#   # #       #.#. . . .# #.# #. .#.  # #
### # # # # ### # ##### ### # ### # ### #
#     # # # #  .#. . .#. .#. .# #.#.#   #
####### # ### # ##### ### ### # # # # ###
#       # #   #. . .#.# #. . .  #. .  # #
# ####### # # # # # # # # ####### ##### #
# #   #   # # # # #. .# #   #   # #     #
# # # # # # ### # ##### ### ### # # ### #
# # # # # #   # #         #     # # #   #
# ### # ##### # ####### # ####### ### ###
#     # #     #       # # #     #     # #
####### # ### ##### # # # ##### # # ### #
#       # #   #     # # #     # # #     #
# ##### # ##### ### # ##### ### # #######
# #     #     #   # #     # #   #   #   #
# # ######### ### # ##### # # ##### ### #
# # #   #       # #     # #   #   #   # #
# ### ### # ##### ####### ####### ##### #
#       # # #   #     #     #     #     #
# # ##### # # # # ### # ##### # ### #####
# # #     # # #   #   # #     #     #   #
# # # # ### # ######### # ############# #
# # # # #   # #         #     #     #   #
# ####### ### ############# ### ### # ###
#   #     # #               #     #     #
# # # ##### # # ############# ###########
# # # #   #   #               #     #   #
# # ### # ######### ##### ##### ### # # #
# #     #     #   # #   #         # # # #
# ####### ### # # ### # ####### ### ### #
# #     #   #   #     #   #   #   # #   #
# # ### ### ####### ##### ### ### # # ###
# #   #   #       # #   #   # # # # #   #
# ### ### ### ### # # # ### # # # ### # #
#     # # #   # # # # #   #   # # #   # #
####### ### # # # ### ### ##### # # #####
#           #   #       #       #       #
#########################################
