######### ########################### ###
#       #.#   #                  . . .  #
# ####### # # # ### ############# ### # #
# #  . . .# # # #   #      . . . .#   # #
# ### ##### # # # ######### ####### ### #
#   #.#   # # # # # #. . .#. .#   # #   #
### # ### # # # # # # ### # # ### # # # #
# # #. .#   # # #   #.#. .# #.#   # # # #
# # ### ##### ####### # ##### # ### ### #
#   #  . .# # #    . .#. . .#.#   #   # #
# ####### # # # ### ####### # ### ### # #
# #      .# # #   #.#      . .  #     # #
# ####### # # ### # ######### # ####### #
#        . . . .# #. . . .#   #   #     #
# ############# # ####### # ##### # #####
# #     #     #.# #     #.# #     #   # #
### ### ##### # # # ##### # ### ##### # #
#   # # #   # #.#   #. .#.# #   #   # # #
# ### # # # # # ##### # # # # ### ### # #
#     # # #   #. . . .#.#.# # #. . .#   #
####### # ############# # ### # ### #####
#   #   #   #     #    .#. .# #.# #. .  #
# # # ##### # ### ##### # # ### # ### # #
# # # #     # # #      .# #. . .#   #.# #
# # # ##### # # ####### ### ####### # # #
# # #   #     #        . .#         #.# #
# # ### # # ####### ##### ########### # #
# #   #   # #       #    . . . . . . .# #
# ### ####### ### ### # ############### #
# #           #   #   #   #             #
# ### ########### # ####### ######### # #
#   # #           # #       #       # # #
# # # # ##### ##### # ### ### ##### ### #
# # # #   #   #   # # # #   # # #   #   #
# # ##### # ### # ### # # # ### # ### # #
# # #   # #   # # #   #   #   #   #   # #
##### ### # # # # # ####### # # ##### ###
#     #   # # # # #   #     # #     #   #
# ##### ### # # ####### ### # ##### ### #
#       #   #   #       #   #     #     #
#########################################
