####### #################################
#. . . .#. . .    #. .    #. . . .    # #
# ####### ### ##### # ### # ##### ### # #
#. . . . .  #. . . .#. .# #.    #.#   # #
# # ################# # ### ##### ##### #
# #     #           # #. . .#   #. . .  #
# ##### # ######### # # ### # # ### # ###
#     #   #       # # #   # # #   # #. .#
# # # ##### ### ### # ### # # ### ### # #
# # #     #   # #   #   # # #   #   # #.#
# # ##### ##### # # ### # ##### ### # # #
# #     #       # # #   #     # # # # #.#
# ##### # ####### # # # ### ### # ### # #
#   #   # #   #   # # # # #   # #. .# #.#
# # ##### # # # ### # # # ### # # # ### #
# #     # # # # # # # # #   #   #.#. . .#
# ##### # ### # # # # ### # ##### ### # #
#     # #     # #   #   # # #  . .#   # #
####### ### ### ##### # # # # # ####### #
#         # #       # #   # # #.#       #
# ##### # ### # ### ##### # ### #########
# #   # #   # #   # #   # #   #. . .    #
# # # # ### # # # ### # # ### # # # ### #
# # # # #   # # #     # # # # # # #.#   #
# ### ### ### ##### # # # # # # # # #####
#   #   # #       # # # # # # # # #. . . 
# # ### # ##### # # ### # # # # # # #####
# #   #   #   # # #   # #   # # # #     #
# # ####### # ### ### # ### # # # #######
# #     #   #   #   # #   # # # #       #
# # # ### ######### ### # # # # ####### #
# # #   # #         #   # # # #   # # # #
# ####### # ######### ### ### # # # # # #
#   #     # #   # # # #   #   # # # #   #
### # ##### ### # # # # ### ##### # #####
# # #   #   # # #   # # # # # #   #     #
# # ### # # # # ### # # # # # # ####### #
# #     # # # #   # # #   # # #       # #
# ####### # # ### # # ##### # # # ##### #
#         #     #         #   # #       #
#########################################
