####################### #################
#       #              .        #   #   #
# # ##### # ##### ##### ####### # # # # #
# # #     #   #   #  . .      # # # # # #
### # ######### # # # ####### # ### ### #
#   #   #       # # #.#       #         #
# ####### ### ##### # ###################
# #     # #       # #. . . . .          #
# # ### # # ##### ####### ### ### # #####
# # # # # #     #   #   #   #.  # #     #
# # # # # ####### # ### ##### # ####### #
#   # # # #     # #     #  . .# #     # #
##### # # # ### ######### # # # # ##### #
# #     #   # #       #   #.# # # #     #
# ### # ##### ######### ### # # # ### # #
# #   #       #         #. .# # # #   # #
# # ######### # ######### ### # # # ### #
# #   #     # #     # #. .#   # # # # # #
# # # ##### # ##### # # # # ### # # # # #
# # #   #    . . .#   #.# # #   #   #   #
# ##### # ### ### ##### # # # # # #######
#       # #  .#  . . . .# # # # # #     #
######### # # ######### ### ### ### #####
#     #   # #.#. . . .# #   #   #   #   #
# ### ### # # # ##### ### ### ### ##### #
# #       # #.#.#   #. .# #   #         #
# # ### ### # # # # ### # # ### #########
# # #   #   #.#.  #   #.# #         #   #
# ### ### ### # ####### # # ####### ### #
#   #   # #  . .#. . . .# # #   #   # # #
# # ### # ####### ### ### # # # # ### # #
# # #   #       #.#   #   # # # # # # # #
# # # ####### # # ##### ##### ### # # # #
# # #       # # #. . .#         # # # # #
# # ####### # # # ### ### ##### # # # # #
# #       # # # #   #.  # #   # #   # # #
# # ##### # ### ##### # # # # # ##### # #
# # #   # #   # #   #.# # # # #     #   #
# ### # ##### # # # # # ### # ######### #
# #   #       #   # #.#     #           #
##################### ###################
