####################### #################
#        . . . .#  . . .        #       #
### ##### ##### # # # # # ##### # ##### #
#   # #. .#   #.# #.# # # #   # # #   # #
# ### # # # ### ### ### # ### # # ### # #
# #   #.# #   #.#. .#   #   #   # #   # #
# # ### # ### # # ### ### # ##### # ### #
#   #. .#   #  . .#   #   #   #     #   #
##### # ######### # ### ##### # #########
#. . .# #     #   # # # # # # # #       #
# ### # # ### # ### # # # # # # # ##### #
#.#   # # # #   #   # # # # #   #. . .# #
# ##### # # ##### ### # # # ##### ### # #
#. . .# # #   # #   #   # #. . . .  #.# #
# # # ### ### # # # ##### # ######### # #
# # #. .#     #   #   #   #.#   #. . .# #
# ##### ############# # ### # # # ##### #
#     #.            # # # #.  # #. .#   #
# ### # ############# # # # ####### # ###
# # # #. . .    #. .#   #. .#     #.#   #
# # # ### # ##### # ##### ### ### # ### #
# # #   # #. .#. .#. . .#.# # # # #. .# #
# # # # # # # # ####### # # # # # ### ###
# # # # # # #. .    #. .#. . .  #   #. . 
# # # # # ######### # ####### ###########
#   # # #         # #. . .  #.#     #   #
##### # ######### ### # # ### # ### ### #
# #   #         #   # # #. . .    #     #
# # # # ##### # ### # ###################
#   # #     # #   # #   #     #         #
### ######### ##### ### # ### # ####### #
#   #         #     #   # #     #     # #
##### # ### # # ##### ##### ##### ### # #
#   # # # # # #     #         #   # # # #
# # # # # # # # ### ########### ### # # #
# # # # #   # #   #             # # # # #
### # # ##### ### ### ### ####### # # ###
#   # # #   # # #   #   # #       # #   #
# ####### # # # ### ### ### ##### # ### #
#         #   #       #     #     #     #
#########################################
