############################# ### #######
#   # #                . . .#. .#.#     #
# ### # ########### ### ### ### # ##### #
#     # #       #   #. .#  . .#.#. . .# #
# ##### ### ### # ### # ##### # ##### # #
#   #   #   #     #. .# #    . .#. . .# #
### ##### ### ##### ##### ####### ##### #
# #       #   #    . . .# #. . . .#     #
# # ### ### ### ### # # # # ####### #####
# # #   #   #   #   # #.# #. . . .# #   #
# ### ### ### ##### # # ######### # # # #
#     #   #   #     # #. . .  #. .  # # #
######### ### # # ### ##### ### ##### # #
#         #   # #   #   #. .#. .#     # #
# ##### ### # ##### ##### ### ### ##### #
# #     #   # #   #     #. . .    #     #
### ##### # # # # ##### # # #############
#   #   # # # # #   #   # # # #     #   #
# ##### # # ### ##### # # # # # ### ### #
#     #   #     #     # # #   # # #     #
# # # ##### ##### ##### # ####### ##### #
# # # #   #   #   #   # #         #     #
# ### # # ##### # ### # ### ####### ### #
# #   # #       #   #   # #     #     # #
### # # ####### # # ##### ### ### ### ###
#   # #   #     # #         #       #   #
# # ##### # ##### # # ############# ### #
# # #     # #     # # #     #   #     # #
### # # ##### # ### # # ### # # ####### #
#   # # #     # #   # # # # # #     #   #
# ### ### # ##### # # # # # # ##### # ###
#   #   # # #   # # #     #   #   # #   #
# # ### # ### # # # ########### # # #####
# # # # #   # #   #             # #     #
# # # # ### # ################### #######
# #   # #   #   #               #       #
####### # ##### # # ########### ####### #
#       #     #   #         # #       # #
# ########### ########### # # ######### #
# #                   #   #   #         #
#########################################
