########### ################# ###########
#       #  . .      #. . .  #.#       # #
# ####### # # ##### # ### # # # ##### # #
#         # #. . .# #. .#.# #.# #   #   #
####### # # ##### ##### # ### # # #######
#     # # # #   #. .  #.#. . .  #       #
##### ### # ### # # # # ######### ##### #
#   # #   #     # #.# #. .#   #   #   # #
# # # # ### ####### # ### # # # ### ### #
# # #   #   #  . . .#   #.# # # # #   # #
# # ##### ### # # ####### ### # # # # ###
# #     # #   #.# #. . .#. . .  #   #   #
# ##### ### ### ### ### ##### ### ##### #
# #         #  . . .  #. . . .      #   #
# ############# # ######### ######### # #
#     #   #     # #       #   # #     # #
# # ### ### ### # # ##### ### # # ##### #
# # #   #   #   #       # # # #   #     #
### # ### ####### ####### # # ###########
#   # #   #   #   #       # #           #
# # # # ### ### ### ##### # # ######### #
# # #   #   # # #       # # #         # #
### # ### ### # ### # # ### # ####### # #
#   # #       # #   # #   # #     #   # #
# ### # ####### # # # # # # # ### # ### #
#   # # # #     # # # # # # # #   # #   #
# # # # # # # # # # # ### # ### # ### # #
# # # # # # # # # # # #   #     # #   # #
### # # # # ### # # # # ########### # # #
#   # #   # #   # # # # #         # # # #
# ##### ### # ### # # ########### # # # #
#       #   # #   # #             # # # #
# ####### ### # # # ####### ####### ### #
#     #   #   # # #       # #   #   #   #
####### ####### ######### ##### # # # ###
# #     #       #   #   # #   # # # # # #
# # ### # ### ### ### ### # # # # ### # #
# # #   # #   #     #   # # # #   # #   #
# # # ### ##### ####### # # # ##### #####
#   #   #               #   #           #
#########################################
