########################### #############
#       #       # #     #  . . . .      #
##### # ### ### # # ### ### # ### ##### #
#     #     # # # # # #   # #   #.  #   #
# ########### # # # # ### # ### # ### ###
# #   #     # # #     #   # #   #. .#   #
# # ####### # # ##### ##### # ### # ### #
#   #   #     #             # #   #.  # #
##### # # ### ############### ##### # # #
#     # # #       #     #     #. . .# # #
# ##### # ####### ### ### ##### ##### # #
# #   # #   #   #   #     #. . .#   # # #
# # ### # # ### ### ####### ##### # ### #
# #     # #     #. . . . .#.#. .# #     #
##### ### ####### ####### # # # #########
#   # # # #   #  .#     #. .#.#. . . . . 
# # # # # # ### # # ### ### # ##### #####
# #     #   #   #.#   #     #.#   # #   #
####### ##### ### ########### # # ### # #
#   #         #. .  #. . . . .  # #   # #
# # ########### # ### ############# ### #
# # #     #    .#   #.# #     #       # #
# # ##### # ### ### # # # ##### ####### #
# #       # #  . .# #.  # # #     #   # #
# ######### # ### # # ### # # ##### # # #
#           #   #.# #.    #   #     # # #
# ##### ####### # ### ##### ### ####### #
# #     #   # # #. . .        #   #     #
### ##### # # # # ### ########### # # ###
#   #     #   # #   #       #     # # # #
# ####### ##### ### ### ### # ####### # #
# #     #         #   #   #   #     # # #
# # ### ### ### ### # ######### ### # # #
# #   #   # #   #   #     #     # # # # #
# ### ##### # ### ####### # # ### # ### #
#   #     # # #       #   # #     # #   #
# # # ##### # ### # ### ### ######### ###
# # # #   # #   # #   # #         #   # #
# ### # # # # # ##### ### ######### ### #
#     # #   # #     #                   #
#########################################
