##################### ###################
#      . . .#  . . . .                  #
# ##### ### ### ##### # ##### ######### #
# #. . .# #.#. .#     #     #   #     # #
### ##### # # ################# # ### # #
#. .#    . .#.# #               #   #   #
# ####### ### # # #######################
#. . . .#. . .#   # #. . .              #
# ##### # ######### # ### ############# #
# #   #.# #. . . . .#.#. .    #   #   # #
# ### # ### ####### # # ##### ### # # # #
#     #. . .      #. .#. . .#     # # # #
# # ### ######### # ####### ####### ### #
# #   #       # # # #     #. .    # #   #
# ### ### ### # # # # ##### # ### # # ###
#   #   #   # #   #   #   # #. .# #   # #
# # ### ### # ######### # # ### ####### #
# #   #   # #     #     # #   #. .      #
# # # ### # # ##### ##### ##### # #######
# # #   # # #           #     # #.  #. . 
# # ### # ##### ### ##### ### # # ### ###
# # #   #     #   # #   #   # # #. .#.# #
# # # ####### ### # # ##### # # # # # # #
# # # #     # # # # #   #   # # # #. .  #
# # ### # # # # # ### ### ##### # ### ###
# #     # # # #   #   #   #   # #   #   #
# ##### # # # ##### ### ### ### ### ### #
#     # # # #       # # #       #     # #
##### # # # ### ##### # ### ##### ##### #
#   # # # #   #       # #   #     # #   #
# # # ### ### ######### # ### ### # # # #
# # # #     # #     #   # #     # #   # #
# ### # ### # # # # ### # ##### #########
#     # #   # # # #     #     #         #
####### # ### ### ######### # ### ##### #
#   #   # #   #   # #     # # # #     # #
### # ##### ### ### # ### ### # # ##### #
#   # #     #   # # # # #   #   # #   # #
# ##### ##### # # # # # ### ##### # # # #
#       #     #   #   #           # #   #
#########################################
