################# ##### #################
#           #    .    #.#  . . . .#     #
# ##### ### # ### ### # ### ##### ##### #
# #   #   #   #  .  # #.#. .#. . .#     #
# # ### # # ##### ### # # ### ##### #####
# # #   # # #   #. .# #. .# #.# #   #   #
# # # ### ### ### # ####### # # # ##### #
# # # #     #   # #. .  #   #.  #   #   #
# # # # # # ### ##### # # ### ### ### ###
# #   # # #   # #. . .# #. . .        # #
# ##### # # # # # ####### ############# #
#     # # # #   #.#. . . .#             #
# ### # # # ##### # ####### ### ##### ###
# #   # # #   #  .#. . .# # # # #   #   #
### ### # ### # # ##### # # # # # ##### #
#   #   #   # # #. . . .  #   #   #   # #
# # ####### # # ##### ##### ####### # # #
# # #       # #     # #         #   # # #
# ### ##### # # # # ### ############# # #
#   # #   # # # # #         #         # #
# # # ### ### # ############# ######### #
# # #   #     #   #           # #     # #
# # ### ####### # # ##### ### # # ### # #
# #   #       # #   #   #   # #   #   # #
### # # ##### ####### # ### ######### # #
#   # #     #   #     #   #     #   # # #
##### # ### ### # ####### ##### # # # # #
#     #   # #   # #   # #     # # # #   #
# ##### # # ##### # # # # # # # # # #####
# #   # # #       # # # # # # #   # #   #
# ### ### # # ####### # ### # ##### # # #
#   # #   # #       #   #   # #   #   # #
# # # # ### ####### # ### # # # # ##### #
# # #   #   #     #   #   # #   # #   # #
# # ######### # ####### # ####### # ### #
# #   #       #   #   # # #     #   #   #
# # ### ####### ### # # ### #############
# #     #     # #   # #             #   #
# ####### ### ### ### ### ########### # #
#           #       #   #             # #
#########################################
