##### ###################################
#  . .  #   #. .      #           #     #
### # ### ### # ### ### ### ### ### #####
#. .#     #. .#.  #   # # #   #     #   #
# ######### ### # ### # # # # ######### #
#.#. . .#. .# #.#   #   # # #   #     # #
# # ### # ### # ### ##### # # ### # # # #
#. .# #. .    #.  # #   # # #     # # # #
# # # ######### # # ### # ####### # ### #
# # # #. . . . .# #     #   #   # # #   #
# ### # ######### ######### # # ### # ###
#     #.#     #   #   #     # #   # #   #
####### # ##### # # # # ##### ### # ### #
#  . . .#     # # # #   #    . .# #   # #
### ######### # ### ######### # # ##### #
#. .#. . .  #   #   #       #.#.#   #   #
# # # ### ####### ### ##### # # ### # ###
#.# #.# #. . . . .    #   # #.#. .#   # #
# # # # ######### ##### # # # ### ##### #
#.# #. . .      #.#. .  # # #. .#. .    #
# ####### ####### # # ### # ### ### #####
#. .  #. .#     #. .#.#   # # #.# #. . . 
### # # ### ### # ### ##### # # # ### ###
#. .# #.# #   # #   #.#. .#   #.#   #   #
# ##### # ##### ### # # # ##### ### ### #
#. . .#. . .    # # #.#.#. . . .  # #   #
# ### ##### ##### # # # ########### # # #
# # #. . . .#   #   #. .            # # #
# # # # # ### # ##### # ############# ###
#   # # #     #   #   # #           #   #
# ### # ####### # ####### ##### ### ### #
#   # #   #   # #             #   #   # #
##### ### ### ############### ### ### # #
#     # # #   #             #   #   # # #
# ### # # # ### ########### ### ### # # #
# #   #   #     #   #   #   # #   # # # #
# # ####### ### # ### # ##### ####### # #
# #   #       #   #   #   # #       # # #
# ##### ########### ##### # ##### # ### #
#                   #     #       #     #
#########################################
