########### ############# ###############
#   #      .#. . . .    #.# #   #       #
# # # ##### # ##### ##### # ### # ##### #
# #   #  . .#. . .#. . .#.#   #   #   # #
# ##### # # ##### ##### # ### ##### # # #
#   # # #.# #. . .    #.#. . .#     # # #
# # # # # ### ######### ##### # ####### #
# # # # #. . .#   #. . .    #. .#       #
### # # # # ##### # ########### # #######
#   #   # #     # #.#. . . . . .#   #   #
# ####### ##### # # # ########### ### # #
#       #     #   #. .            #   # #
# # ### ##### ##### # ############# #####
# #   #     #     # #               #   #
# ### # ##### ### # ##### ####### ### # #
# #   # #   # #   #     #     # #   # # #
# ##### # # # # ##### # ##### # # ### # #
#   #   # #   #     # #     #   #     # #
### ### # ### ####### ##### ##### ##### #
# #   # # #   #         # #     # # #   #
# ### ### # ### # ##### # # ### ### # # #
#   # #   # #   # #   #   #   #   #   # #
# # ### # # # # ### # ######### # ##### #
# #     # # # # #   #         # # #     #
# # ##### # # ### ##### ##### # # #######
# # #     # #         # #     # #       #
##### ##### # ####### ############# ### #
#     #     #       #     # #       #   #
# ####### # # ### # ##### # # # ### # # #
#   #   # # #   # # #   # #   # #   # # #
### ### # # ##### # ### # ##### ##### ###
# #     # # #     #     #     #     #   #
# ####### # # # ############# # # ##### #
# #   #   # # # #     #       # #     # #
# ### ### ### # # ### # ####### ####### #
#       #   # # # #     #     #   #     #
####### ### # ### ####### # ####### ### #
#     # #   #   #   #   # # #     # # # #
# ### # # # ### ##### ### ### ### # # # #
#   #     #   #           #   #     #   #
#########################################
