######################### ###############
#         #   #        . .              #
######### # # ### ##### # ##### ####### #
 . .#   # # # #   #  . .#     #   #     #
### ### # # # # ### # ##### ##### #######
# #. . .# # # # # # #.#     #   #       #
# ##### # # # # # # # # ##### ######### #
#      . . .# # #   #.#     #. . .#     #
########### ### ##### ####### ### #######
# #     #. .#   #    . . . . .# #. . . .#
# # ### # ### ### ##### ####### # # ### #
#     # #.# # #   #   #         # # #. .#
##### ### # # ####### ########### # # # #
#   #   #.# #       # #           # #.# #
# ##### # # ### ##### ############### # #
#     #  . . .#   #   #. . .#      . .# #
##### ####### # ### ### ### ####### # # #
#   #       #.#     #. .#  . . . . .# # #
# # # ##### # ####### # ########### ### #
# #   #   #  .#. .#  .# #     #     #   #
# # ##### ### # # ### # # ##### ##### # #
# # #        . .#. . .# #       #     # #
# ### # ##### # ################# ##### #
#   # # #     # #             #   #   # #
### ### ####### # # ######### # # # ### #
# #   #       # # # #     # #   # #   # #
# ### ### # # # # # # ### # # # # ### # #
#   #   # # # # # # # # # # # # # # #   #
### ### # ### # ### # # # # # # # # ### #
# # # # # #   # #   # # # #   # #   #   #
# # # # ### ### ##### # # ##### # ### # #
# # #   #   #   #       #     # #   # # #
# # ##### # # # # ####### ##### ##### # #
#       # # # #       #   #       #   # #
####### # # # ### ##### ### # ##### ### #
#     #   # #   # #   # #   # #     #   #
# ### ### # # # # # # ### ##### #########
# # #   # # # # # # # #   #   # #       #
# # ### ### # # ### # # ### # ### # ### #
#   #       # #     # #     #     # #   #
#########################################
