############### #########################
#   #          .                        #
# # # # ####### ### # # ### ### # ### # #
# #   # #      .  # # # #   #   #   # # #
# ##### # ##### # # # ### # # # # # # # #
# #   # # #. . .# # # #   # # # # # # # #
# # # # # # ##### # ### ### # ### # # ###
# # # # # #.#     # #   #   #   # # #   #
# # ### # # ####### # ### ### # # ##### #
# #     # #.#   #   # #   #   # #   # # #
# ######### ### ##### # ####### ### # # #
# #    . . .  #   #   # # #   # #   # # #
### ### ### # ### ### # # ### # ##### # #
#   #  .# # #   #     # # #   #     #   #
# ##### # # ### ##### # # # ##### # #####
#     #.#   # # #   # # #       # #     #
##### # ##### # ### # # ####### # ##### #
 . .# #. .  # #     # #   #   #     #   #
### ##### # # ####### # # # # ### ### # #
# #. . .#.# #         # #   # # #   # # #
# ##### # # ############# ### # ### # # #
# #. .#.#.#             #   # #     # # #
# # # # # ########### # ### # ####### # #
# #.#.#.#. .  #   #   #   # #   # #   # #
# # # # # # # ### # # ### # ### # ### # #
# #.#. .# #.#     # # #   # #   #   # # #
# # ####### ####### ### # # # # ### # ###
# #.#  . . .      # #   # # # #   # #   #
# # ### # # ####### # ##### ##### # # # #
#. .#. .# #       # #     #     # # # # #
# ### ########### # ##### ##### ### ### #
#.#  . . .# #     #     #     #   #     #
# ####### # # ##### ### # # # ### #######
#. . . . .# # # #     # # # #   #     # #
### # ### # # # # # ### # # ########### #
#   # #   #   #   # #   # #             #
# ### # ########### # ######### #########
# #   # #     #   # #   #     #   #     #
# # ### # ### ### # ### # ### ######### #
# #   #   #   #       #     #           #
#########################################
