####################### #################
#   #       #       #  . . .      # #. .#
# # # ### # # ### # ### # # ##### # # # #
# # # #   #   #   #     # #. .#   #. .#.#
# # ### ######### # ######### ##### ### #
# #     #       # # #    . .#. . . .  #.#
# ####### # ### # ### ### # ### ##### # #
# #     # # # #   #   #  .#. .#     # #.#
# # ##### # # ##### ##### ### ##### ### #
# #       # #       #  . .# #.#     #. .#
# ######### ######### # # # # ####### # #
#   #       #. . . .# #.# #  . . . . .# #
# ### # ##### ##### # # ##### ####### # #
#   # # #  . .#   #.# #. .#   #     # # #
##### # # # ### ### ### # # ### ##### # #
# #   # # #. .#   #. .# #.#   #       # #
# # ### ### # ### ### ### ############# #
# #   #   # #. .#   #. .#. . .  #   #   #
# ### ######### ### ### ##### # # ### # #
#     #    . . .  #    . . .#.#   #   # #
# ##### ### ### # ######### # ##### ### #
# #     #. .#   # #. . . .#.#.#     #   #
# # ### # # ##### # ##### # # # ##### ###
# # #   #.# #   # #.#   #.#. .# #   #   #
### # ### ### # # # # ### ### # ### ### #
#   # #  . .# #   #.#   #.# # #     #   #
# ### ##### ####### ### # # # # ##### ###
#   #   # #. .    #.    #.#   #     #   #
##### # # # # ##### ##### ###############
#   # #   # #. . . .    #. . .          #
# # ##### # ########### ##### ######### #
# # #   # # #   #. . .# #. . .      #   #
# # # # ### ### # ### ### ### ##### # # #
# # # #   #     #.# #. . .#   #   # # # #
### # ### ####### # ##### ##### # ### # #
#   # #  . . . . .# #   # #   # #     # #
# ### # # ####### # # # # # # # ### ### #
# #   # #.#   #   # # #   # #   #   #   #
# ##### # # ### ### # ##### ######### # #
#       #.#     #     #       #       # #
######### ###############################
