####################### # ###############
#           #     #. . .#.              #
# ######### # ##### ##### ### ### ##### #
#   #     # #. . .#.#. .#.  #   #   #   #
##### ### # # ### # # # # ##### # ### ###
#   #   # #. .#. .#.#.#. .#   # #   #   #
# # ### # # ### ### # # # # # # ### #####
# # #   #. .# #. . .#.# # # #     #     #
# # ##### ### ####### ### # ####### ### #
# #      . .#  . .#  . .# #   #   #   # #
# ######### ### # ### # # ### # # ##### #
#     #   #. . .#. .# #.# #   # #       #
####### # ######### ### # # # # #########
#   #   #     #   #. . .# # # #   #     #
# ### ######### # ### # # # ##### # #####
#   #           #     # # #     # #     #
### ##### ############# # ### ### ##### #
# #   #   #       #     #   #   #     # #
# ### ##### ### # ### # # # # # ####### #
# # # #     #   #     # # # # #         #
# # # # ##### # ######### # # # #########
# # # # #     # #     #   # # #         #
# # # # # ##### ##### # ### ### ####### #
# # #   # #   # #     #   #   # #     # #
# # ##### # # # ##### ####### ### ##### #
#       # # #   #           # #   #     #
# ######### ##### ######### # # ### # # #
# #         #     #           # #   # # #
# ######### # ##### ### ##### # ##### # #
# #         # #     #   #     # #     # #
# ########### ### # # ### # ### # ### # #
#   #         #   # #   # # # #   #   # #
### # ######### # ####### # # ######### #
# #   #   #     # #       # # # #       #
# ##### ### ### # # ####### # # # ##### #
#   # #   # # # # # #       # # # #   # #
### # ### # # # # # # ##### # # # # # # #
#   # #   #   # # # #     #   # # # # # #
# ### # # ##### # # ########### # # ### #
#       #       # #           #   #     #
#########################################
