########################### #############
#       #           #      .    #       #
####### ### ####### # # ### ### # ##### #
 . . .#   # #   # # # #   #. .# #     # #
##### ### # # ### # ##### # # # ####### #
#    . . .#   #. .#     # # #.# #       #
# ####### ##### # ##### # ### # # #######
#   #   #. .#. .#. . .#   #. .# #. . . .#
##### # ### # ####### ##### ### # ##### #
#     #    . .#      . .#. .#   #.# #. .#
# ########### ######### # ####### # # # #
#   #   #   # #        .#. . . . .  #.# #
# # # # ### # # ####### ##### ####### # #
# # # #     # # #      . . .#     #. .# #
### # ######### ### ####### ####### # # #
#   #     #     #   #     #. .#. . .# # #
# # ##### ### ### # ### ##### # ####### #
# # #   #     #   # #        . .#     # #
# ### ########### # # # ######### ### # #
#   #       #     # # # #         #   # #
### ### ### ### ##### # # # ####### ### #
#   #   #       #     # # #   #         #
# ##### # ### ### ####### # # ######### #
# #   # #   # #   # #     # #   #   # # #
# ### # ##### # ### # # ### # ### # # # #
# # # #   #   # #   # # #   # #   #   # #
# # # # # # ### # ### # # # # # ####### #
# #     # # #     #   # # # # #         #
# ##### # # ####### ##### # # ###########
# #     # #   #   # #     # #   #       #
### ##### # # ### # ########### ####### #
#   #     # #   # #           #       # #
# ##### # ##### # # ### ##### ##### ### #
# #     # #   #   #   #     # #   #     #
### ##### # ########### ### # # # #######
#   #   # #     #         # # # #       #
# ### # ####### # # ####### # # ####### #
#   # #   #     # #   # #   # #       # #
# # ##### # ##### # # # # ### ##### #####
# #       #       # #   #   #           #
#########################################
