##################################### ###
#   #     #          . . .#       #  .  #
# # ### # ### ### ### ### # ####### # ###
# #     #     #   #  .# #.# #       #. .#
# ############### # # # # # # ####### # #
#   #     #       # #.# #.#   #  . .# #.#
### # ### # ### ### # # # ####### # ### #
# #   # # #   # #   #.#  . .#  . .#. . .#
# ##### ####### # ### ##### ### ##### # #
# #   #         # #  .#. .#. . .#     # #
# # ####### # # # # # # # ####### ##### #
# #         # # # # #.#.#. .#     # #   #
# ######### ### # # # # ### # ##### # # #
#           #   # # #. .  #.#       # # #
##### ####### ### # ##### # ######### # #
#     #   #   #   #     # #.#         # #
##### # ### ### ####### ### # ###########
#   # #   # #     #   #   #.#       #   #
# # # ### # # # # # # # # # ####### # # #
# #     # # # # # # # # # #. . .  #   # #
# ### # # # # ### # # ### # # # ####### #
# #   # #   # #   # #     # # #. .    # #
# # ########### ### ####### ### # ##### #
# #     #       # # #     #   # #. . .# #
# ##### # ### # # # ##### # # # ##### # #
# #   # # #   # #   #     # # # #   #.# #
# # # # # # ### ##### ####### # # # # ###
#   # # # # #   #     #       # # # #.  #
##### # # # # ### ######### ### ### # # #
#     # # # # #   #         #   #   #.# #
# ##### # # # # ### # ##### # # # ### # #
# #   # # # #   # # #     # # # # #  .# #
# ### # # ####### # # # # ### ### # # ###
#     # # #     #   # # #   #     # #. . 
####### ### ### ##### ### # ####### #####
#   #       # #   # #   # #       # #   #
# # ### # # # ### # ### ####### # # ### #
# #   # # # #   #   # # #     # # #     #
# ### # # ##### # ### # # ### # #########
#   #   #       #     #   #   #         #
#########################################
