####### ##### ###########################
#      .  # #. .#       #   #           #
####### # # ### # ##### # ### ### #######
#. . . .#   #. .# #     #       # #     #
# ########### ##### ##### ####### # #####
#.#. . .  #. .      #     #     #     # #
# # ### # # ######### ######### ### # # #
#. .  #.# #.  #       # #     #   # #   #
# # ### # # ### ####### # ### ### # # ###
# # #. .# #.    #   # # # # #   # # #   #
# ### # ### ##### # # # # # # ### # ### #
# #. .# #. .#     # #   #   #   # #   # #
# # # # # ### # ####### # ##### # ### ###
# #.# # #.#   #       #       #     #   #
# # ### # # ####### ##### ############# #
# #.#   #.# #     #     # #     # #     #
### # ### # # # # # # # # # ### # # #####
#. .# # #.# # # # # # #     # # #   #   #
# ### # # # # # # # ######### # ##### ###
#. .# #. .  # # # # #     # # #         #
# # ### ##### # # ### ### # # ##### ### #
# #. . .      # #   #   #     #   #   # #
# ############# ### ######### # # ##### #
#     #     # #   #   #       # # #     #
# ### ##### # # ##### # ####### ### ### #
#   #     #   #     #   #   #   #   #   #
### # ### # ### ### ####### # ### #######
# # #   #     # # #   # #   # #   #     #
# # ### # ### # # # ### # ### # ####### #
#   #   # #   #   #   # # #   #     #   #
##### # # ########### # # # ##### # # ###
#   # # #           #     # #   # # #   #
# # # # # # ####### # # ### # # ####### #
# #   # # #   #   # # # #     # #     # #
# ### # # ##### # # # ### ####### # ### #
#   # # #       # # # #           #   # #
### # # ######### # ### ############# # #
# # # #     #     #       #         # # #
# # # ##### ############### ### ##### # #
#   #     #                   #     #   #
#########################################
