################### ############# #######
#             #   #.#  . . . . .#.      #
##### ####### # ### # # # ##### # ##### #
#     #     # # #. .# #.# #   #.#.#   # #
# ##### ##### # # ### # ### ### # # ### #
# # #         #. .#   #. .#. . .#.#     #
# # # ######### ### # # # # ##### #######
# #     # #. . .#   # # #.#. . .#. .    #
# ##### # # ##### ##### # ##### ### ### #
#   # # #. .#     # #   #.#   #. .#. .# #
##### # # ### ##### # ### ### ### # # ###
# #   #. .# # #  . .#   #.#   #. .# #. .#
# # # # ### # ### # ### # # ### ####### #
# # # #.# #   #. .#. .# #.# #. .#. . .#.#
# # ### # ##### ##### ### # # ### ### # #
# #   #. .#. . .#   #. . .#  . . .#  . .#
# ### ### # ##### # ##### ####### ### # #
# #   #. .#.#     #   #   #     # #   # #
# # ### ### # ######### ### # # ### ### #
# #    . . .#   #       #   # #   # #   #
# ######### ### # ##### # ### ### # # ###
#   #     # # # # #     # #   #     #   #
### # ### # # # # # ##### # ######### # #
# # # #   # # # # # # #   # #     #   # #
# # # ### # # # ### # # ### ##### # ### #
# # # #     #       #   #     #   #   # #
# # # # # # ################# # ####### #
# #   # # #   #             # #         #
# ##### # ##### ########### # ### ##### #
# #     # #     #         #   #   #   # #
# # ####### ##### ####### # ##### # ### #
# #   #     #   #     # # # #     #     #
# ##### ### # ### # # # # ### # #########
# #     #   #     # # #       #         #
# # ##### ######### # ######### ####### #
#   #   # # #   #   #     #     #   #   #
### # # # # # ### ### ### # ### # ##### #
# # # #   # #   # #   #   # #   #   #   #
# # # ##### ### # # ### # # ####### # ###
#   #       #     # #   # #         #   #
#########################################
