################################### #####
#         #     #          . . .#  . . .#
# ####### ### # # ######### ### # # ### #
# # #   # #   #   #. . . . .#  .# #   #.#
# # # # ### ####### ##### ##### ####### #
# #   #   # #      . .#   #   #. .#. . .#
# ### ##### ####### # # ### # ### # ### #
#   #       #       #.# #   # # #.#.#   #
### ######### ####### # # ### # # # # ###
 . . .#       #      .# # #   #  .#.#   #
##### # ############# # # ####### # ### #
#   #.#           #  .# #     #  . .# # #
# # # ########### # # # ##### # ### # # #
# #  . . . . .#   # #.# #   # #   # #   #
# ########### ####### # # ### ##### ### #
# #         #. .#. . .# #   #       #   #
# ### ######### # ##### ### ##### # # # #
#   #         #. .#   #   #     # # # # #
# # ######### ### # # # # ##### ### # ###
# # #   #   # #   # # # # #     #   #   #
# # ### # # # # ### # ### # ##### ##### #
# #   #   #     #   # #   # #     #     #
# # # ######### ##### # # # # ####### # #
# # #     #     #   #   # # # #       # #
# ### # # # # ### ### ##### # # ####### #
#   # # # # #   #     #   #   # #     # #
### ### # ##### ####### # ##### # ### # #
# # #   #     #   #     #       #   # # #
# # # # ##### ### # # ##### # # ### # # #
# # # #     #   # # # #     # # # # # # #
# # # ##### ##### # ######### # # # ### #
#   #   #   #     #   #   #   # # #     #
##### # ##### # # ##### # # ### # ##### #
#     #     # # # #     # #   # #     # #
####### ##### ### ####### ### # ##### # #
#     #   #   #   #   # #   # #     # # #
# ### ##### # # ### # # ### ##### # # # #
# # #       # # #   #   #       # # # # #
# # ########### # ############# ### # # #
# #             #                   #   #
#########################################
