################# #######################
#         #      .      #       #   #   #
# ##### # ##### # ### ### ##### ### # # #
# #   # # #     #.  #   #   # # #   # # #
# ### ### # # ### # # # ### # # # ##### #
#     #   # # #  .# # #   #   # #       #
# ### ##### # # # # ### # ##### ####### #
# #         # # #.# #   #     #     #   #
# # ##### ##### # ### # ########### # ###
# # #   # #     #.#   # #         # # # #
### # ##### ##### # ### # # ##### # # # #
#   #     # #   #.# # # # # #   # #. . . 
# ####### # ### # # # # # ### # # # #####
# #   #   #     #.# #   #     # # #.#   #
# ### # ######### # ############# # ### #
#     # #      . .#         #   # #.#   #
####### ### ### ######### ##### # # # ###
# #     #   #  . .#. .  #       # #.#   #
# # ##### # ### # # # # ####### # # ### #
# # #     # #   #. .#.#       # #  . .# #
# # # # ##### # # ### ####### ####### # #
# #   # #     # #   #. . .#   #     #.# #
# # ### # ######### # # # ##### ##### # #
# # #   # #         # # #. .  #. .#. .  #
# # # ### ########### # ### # # # # #####
# # # #             # #   #.# #.#. .    #
# # # # ####### # # # ### # ### ####### #
#   # # #     # # # #   # #. .#.#   # # #
# ### # # ### ### # # # ### # # # # # # #
# #   # #   #     # # #   # #. .# # # # #
### # ### # ### # # ##### # ####### # # #
#   #   # # #   # #     # #         # # #
# ### # ### ##### ##### # ########### # #
#   # #   # #   #   #   #   #       # # #
### ##### # # # ##### ##### # ##### # # #
#   #     # # # #   # #   #   #   # # # #
# ### ##### # ### # # # # # ##### # # # #
# #   #   # #     #   # # #       # #   #
# # ##### # ############# ######### #####
# #       #               #             #
#########################################
