############################### #########
#   #   #              . . .#  . .      #
# # # ### ######### ### ### ##### # #####
# # #   # #       #   #.#  . . . .# #   #
# # ### # # ##### ##### # ####### # # # #
# #     # # # #. . . . .#   #     # # # #
# ##### ### # # ########### # ##### # ###
# #   # #   # #. .#. . .#   # #     #   #
# ### # # ### ### # ### ##### # # ##### #
# #. . .#     #. .#.# #. . .# # #       #
# # ### ####### # # # ##### # ### #######
# #.# #. . .#. .# #. . .# #.#   #       #
# # # ##### # # # ##### # # ### ####### #
# #.#      . .# # #   #.# #.  #     #   #
# # ############# ### # # # ####### # # #
# #.  #. .#       #   #.# #. .    # # # #
# # # # # ######### ### # # # ### # # ###
# #.# #.#. .    #. .  #.  # #.  # # #   #
# # # # ### ##### # # # ##### # # # ### #
# #.# #. .#. . . .#.# #.#. . .# # #   # #
# # ##### ####### # # # # ##### # # # ###
# #. . . .  #   # #.# #.#. .#   # # #   #
# # # ### ### # # # ### ### ##### ### # #
# # #   # #   # # #. . .  #. .  #   # # #
# # ### ### ### # ##### ##### ##### # # #
# #   #       # #     # #   #. .#   # # #
# # ######### # ##### ### # ### # ##### #
# #   #     # # #   #     #   #.# #     #
# ### ##### ### # ############# # ##### #
#   #     #     #  . . . . .#. .#     # #
### # # # ######### ####### # # ##### # #
# # # # # # #  . . .#     #.#.#   # # # #
# # # ### # ### ##### ##### # ### # # ###
# # # #   #   #.#   #. . . .#. .# # #   #
# # # # # ### # # # # ######### # # ### #
#   # # # # # #.# # #.#  . . . .# #     #
# ### # # # # # # # # ### ### ### # #####
# #   # #   # #.# # #. . .#   #   # #   #
# # ### ##### # # # ####### ### ##### # #
# #   #       #.# #         #         # #
############### #########################
