##################### ################# #
#             #   #. .#            . . .#
# ########### # # # ### # ######### #####
# #     #     # # #.# # # #       #. . .#
# # ### # ##### ### # # ### ##### # # # #
# #   # #   # # #. .  #         # # # #.#
# ### ##### # # # ############### # ### #
# # #     #   # #.#   #     #     # #. .#
# # ##### ### # # ### # ##### ##### # ###
# # #     # # #  . . . .#     #   # #. .#
# # ##### # # ######### ####### ### # # #
# #       # #       #. .#. . .#     # #.#
# ####### # ####### # ### ### ######### #
#   #   #         #  .#  .#  . .#  . . .#
### # # ### ##### ### ### ##### ### ### #
#   # #   #   #      . . .#    . . .#   #
# ### ### # # ########### # ####### # # #
# #   #   # #         #   # # #     # # #
# # ####### ######### # ### # # ##### # #
# #         #       # # #   # # #   # # #
# ########### ### # ### # # # # ### # # #
#   #     #   # # #     # # # #     # # #
### # ##### ### # ######### # ####### ###
# # #   #   #   # # #       #   #       #
# # ### # # # ### # # ######### ##### # #
# #     # # #   # # # #       #       # #
# ####### ##### # # # # ############### #
#   #           # # # #   # #   #       #
### # ########### # # ### # # # ####### #
#   # #     #     # #   # #   #   #     #
# ### # ##### ### # # # # ####### # # # #
# #     #     #     # # #           # # #
# ######### ### # ### # ######### ##### #
# #         #   #   # #       #   #     #
# # # ### ######### # # ##### ##### ### #
#   # #   #       # # # #   # #     #   #
####### # ### ### # # ### # # # ##### ###
# #   # # #   # # # #     # # #   #   # #
# # # # # ##### # ######### # ### # ### #
#   #   #       #           # #   #     #
#########################################
