################# #######################
#           #    .      #           #   #
# ######### # ### ### ### ### ##### # ###
#   #. .# #   #. .  #   # # # #     #   #
##### # # ##### # # ### # # # ######### #
#. . .#. . . .#.# # # #     #           #
# ####### ### # # # # # ####### #########
#.#       #  . .# #   # #     #         #
# ######### # ### # # # # ### # ####### #
#. . .#. .# # #   # # #     # # # #     #
# ### # # ### # # # ######### # # #######
# # #. .#. .# # # #   # #     # #       #
# # # ##### # # ##### # # # ### ####### #
# # # #. . .# #     # # # # #   #   #   #
# # # # ### ##### # # # # ### ### # # ###
#   # #. .# #     # #   #   #     #   # #
##### ### ### ### # ####### ##### ##### #
 . .# # #. .#   # # # #         #     # #
### # # ### ### # # # # # # ### ####### #
# #.# #   #.  # # # # # # #   #       # #
# # # ### # # # ### # ### ### ####### # #
# #.#     #.# #   # #       #       # # #
# # ####### # # # ########### ##### # # #
# #. .#  . .# # #           #     # #   #
# ### # # # # ### # ####### ##### # # ###
#   #.# #.# #   # #       #   #   # #   #
### # ### ##### # # ######### # # # #####
#   #. .#. . .# # #     #   # # # #     #
# ##### ##### # # ####### # # # ####### #
# #    . . . .# #     #   # # #       # #
# ####### ##### ##### # ### # ####### # #
#         #       #   # #       #     # #
########### ####### # # ##### ### #######
# #         #       # #   # # #   #     #
# # ####### # ##### ##### # # # ### ### #
# # #       #   #   #     #   # #   #   #
# ### ### # ### ############### # ### ###
#   # # # #   #       #     #   # #   # #
### # # # ######### # # ### ####### ### #
#     #   #         #     #             #
#########################################
