####################################### #
#       #          . .#    . .#  . .#  .#
##### # ####### ### # # ### # # # # ### #
# #   #       # #. .#.# #. .#.# #.#. . .#
# # # ####### # # ### ### ### ### ### # #
# # #     #     #.#  . . .#  . . .#   # #
# # ##### ####### ####### ############# #
# #   # # #   #  . . .#   #     # #     #
# ### # # # ### # # # ##### ### # # # # #
# # #   # #     # # #. . .#   #   # # # #
# # ##### ####### ####### ### ##### ### #
#   #           #   #   #. .#   #   #   #
### ####### # ##### ### # # ### # ### ###
#   #     # # #   #     # #.  #   # #   #
# ### ### # ### ##### ##### # # ### # # #
# #   #   #   #     # #  . .# # #   # # #
# # ##### ### ##### ### # ### # # ### # #
#   #   #   # #   #     #.# # # #   # # #
####### ### ### ######### # # ##### ### #
#    . .# #   #  . . . . .# #     #     #
##### # # ### ### ####### # ### # # ### #
 . . .#. .#. . .#.#   #   #     # # #   #
######### # ### # # # # # ####### # # ###
#   #    . .#  . .# # # # #     # # # # #
# # ####### ##### # # # # # ##### # # # #
# #   #     #     # #   # #       # # # #
# ### # ##### ##### # # # ##### # # # # #
#   # # #     #     # # # #   # # # #   #
##### # # # ##### ##### # ### # # # #####
#   #   # # #     #     #     # # #     #
# # ##### # ### ### ### # ##### # ##### #
# #   #   # #   # # #   #   #   #     # #
# ### ##### # # # # # ##### # ####### # #
# # # #     # # #   # #   # # #     # # #
# # # # ##### # # ### # # # # ##### # # #
# #     #     # # #   # # # # #   # # # #
# ######### ### ### ### # ### # # # # # #
# #       #   #   # #   # #   # #   # # #
### ##### ####### # # ##### ##### ##### #
#   #             # #       #           #
#########################################
