################# #######################
#. . .# #      . .            #   #     #
# ### # # ##### # # ########### # ##### #
#.#  . .#     #.# #             #   #   #
# ##### ####### # ############# ### # ###
#.#. .#. .#. . .#     #       #   #     #
# # # ### # # # ##### # ##### ### # #####
#. .#.# #. .# #     #       #   # # #   #
# ### # ##### ##### ######### # # ### # #
#   #.#       #. .#         # # #     # #
### # ######### # ######### # # ##### # #
#   #.#. . . .#.#. . .#   # # #     # # #
##### # ##### # ##### # ### # ##### # # #
 . .#. .    #. .    #.#     # #     # # #
### ####### ### ##### ####### # ##### # #
# #. . . .#   # #. . .#. .  # # #     # #
# # ##### ### # # ##### # # # # ####### #
# # #   #.# # # #. . . .#.# # #   #     #
# ### # # # # ### ### ### ### ### # # # #
#     #  . .#   #   #   #.#   # # # # # #
########### ### ### ##### # # # # ### ###
#          .# #   # #. . .# # #   # #   #
### ####### # ### # # # # # # ##### ### #
#   #     #. .#   # #.# # # # #         #
# ### ### ### ####### ### # # ####### # #
#   # # #    . . . .#.#   # #     #   # #
##### # ####### ### # # ######### # ### #
#     # #       #  . .#   #     # # #   #
# ##### ### ##### # ##### # ### # # # ###
# #   #   # #     # #     # #     # #   #
# ### ### # # ####### ### # ####### ### #
#     #   # #     #   #   #     #   #   #
####### # ######### # # ### ### # ### # #
#       #           # # # #   # #   # # #
# # ######### ######### # ### # ##### ###
# # #     #   #       # # #   #     #   #
### ##### ##### ##### # # # ####### ### #
#   #   #     # #   # # # # #   #   #   #
# ### # ##### # # ### # # # # ####### # #
#     #     #   #       #   #         # #
#########################################
