######### ######################### #####
#     #  . .      #       #       #.#   #
# ### # # # ##### # ##### ####### # # ###
#   #   # #. .#   #. .  #   #   #  .#   #
######### ### # ### # ##### # # ### ### #
#. .#   # #. .# # #.#. .  #   #   #.  # #
# # # ### # ### # # ### ######### # ### #
#.#.#   # #. .#   #. .#. .#     # #.    #
# # ### # ### ####### ### ##### # # #####
#.#. .# # # #. . .  #. .#. . .#   #.#   #
# ### # # # # ### # ### ##### ##### # # #
#. .#. .#   # #. .#   #.#   #. . . .# # #
# # ### ####### # ##### # ### ####### # #
# #.#  . . . . .# #. . .#   #         # #
### # ############# ####### ########### #
#. .# #. . .#. . . .    #   #     #     #
# ##### ### # ########### ### # ### #####
#. . . .  #.#. . .  #     # # #   # #   #
# # ####### ##### ### ##### # ### ### # #
# # #     #. .  #.    #         #     # #
# ### ### # # ### ##### ######### ##### #
#     # # # #. . .        #     #     # #
# ##### # # ############### ### ##### # #
# #   # # # #               # #     # # #
# # ### # # # ##### ### ##### ### # # # #
#   #   # #       #   #       #   # # # #
##### ### ### # # ### ### ##### ### # ###
#           # # #   #   #     #   # # # #
######### # # ##### ### # # ##### ### # #
#     #   # # #   #   # # #     #   #   #
# ### # ### # # ### ### ##### # ### #####
# # # # #   #   #   #   #     #   #     #
# # # ### ####### ### ### # ####### ### #
# #   #   #     #   # #   # #     # # # #
# ##### ### ### ### # ####### ### # # # #
#       #   #       #   #   # #     #   #
### ### # ####### # # # ### #############
# # #   # #     # # # #     #         # #
# # # ### ##### ### # ############### # #
#   #   #     #     #                   #
#########################################
