######### ###############################
#  . .#. .                              #
### # # # ############### ### # ####### #
#. .#. .#               #   # # #       #
# # ##################### # ### #########
#.# #. . .    #   #       #   #     #   #
# # # ### ### # ### ### ##### # # ### # #
#.# #. .#. .#   #   #   #   # # #     # #
# ##### ### ##### ####### ### # ####### #
#. .  #.# #.    #       #     #   #     #
# # ### # # ########### ######### # #####
# #. . .  #. . .    #           # #     #
# # ########### ############### ####### #
# #   #       #. . .          #   # #   #
# ### # ##### ### # ####### # ### # # # #
#   #       #   # #. .  #   #   #   # # #
# ############# # ### ### # ### ####### #
#           # # #   #. .# #   # #     # #
# ##### ### # # ### # # # ### # ##### # #
# #   #   # # # #   # #.#   # #     # # #
# ### # # # # # # ##### ### # # # # # # #
#   # # # #   # # #. . .  # # # # #   # #
### # # ####### ### ### ### # # ####### #
# #   #   #     #. .#   #   # #       # #
# ####### # ##### ####### # # ######### #
#         # # #. .#       # #       #   #
##### ### # # # # # # ############# # ###
# #   #   #   #.# # # #         #   # # #
# # # ######### # # ### ### ##### ### # #
#   # #      . .# #   # # # #   # #   # #
##### # ##### # # ### # # # # # # ##### #
#     # #    .# #   # # # # # # #       #
# ##### ##### ##### # # # # # # ##### ###
#   # #     #. .  # # # # # # # #   #   #
# ### # ### # # # # # # # ### # ### # ###
# #   # #   # #.# # # # # #   #     #   #
# # ##### ### # ### # # # # ########### #
# # #     # # #. .# # #   # #     #     #
# # ### # # # # # # ### ### # ##### # # #
# #     # #   # #.#         #       # # #
################# #######################
