####### #################################
# #    . .            #     #           #
# # ### # # ####### ### ### ########### #
#   # # #.# #     # #   # #   #       # #
##### # # # ##### # # ### ### # ####### #
#. . .# #.#     #   # #   #   # #       #
# ### # # ##### ##### # # # ### # #######
#.# #.# #.    #       # # # #   # #     #
# # # ### ### # # ##### # ### ### # #####
#.# #.#. .  # # #     # #         # #   #
# # # # # ### ##### # # ########### # # #
#.#  . .# #   #   # #         #   # # # #
# ##### # # # # # # ### ####### # # # # #
#. . .# # # # # # #   # #       # #   # #
# # # ### # # # ##### ### ####### # #####
# # #. .# # # # #   #     # #   # #     #
# # ### # # ### # # ####### # # # ##### #
# # # #.# #   #   # #     #   #   #     #
# # # # # ### ##### ### # ######### #####
# # # #.#   #     #     #       #       #
# # # # ### ### # ########### ### #######
# #   #. .#   # #   #     #   #   #     #
# ##### # ##### ##### # # # ### ####### #
#     # #. . .#       # # # #   #     # #
# ### # ##### ####### # ### # ### ### # #
#   # # # #. .      # #   #. . . . .#   #
# # # # # # ####### ####### ####### #####
# # # # # #. . . .# #     #.#. . .#.    #
# # ### # # # ### # # ##### # ### # ### #
# #   #   # # # #.# #. .#. .#.#. .#.  # #
# ### ##### # # # ### # # ### # ### # # #
#   #     # #   #. . .#.#. .#.#. .#.# # #
# # ##### # ####### ### ### # ### # ### #
# #     # #       #   #.  #.#.# #. .#   #
######### ### ### ### # ### # # ##### ###
#           #   #   # #. . .#.#     # # #
# ##### # # ##### # ##### ### ##### # # #
# # #   # # #   # #     #   #. . .#   # #
# # ### # # # # ####### ######### ##### #
# #     # #   #       #         #.      #
################################# #######
