################################# #######
#     #             #   #        . .    #
# ### ### # ### ### ### # ### # # # ### #
# # #     # #   #     #   #   # # #.# # #
# # ######### # ##### ##### # ### # # # #
#   #     #   #   #         # #   #.# # #
##### ### # ##### ### ######### ### # # #
#   # #     #     #   #         #  .# # #
### # ####### ##### ### ##### ### # # # #
#   #   #     #     #   #     #   #.#   #
# ##### ### ### ##### # ####### ### #####
#   # #   # #   #     #     #   #. .#   #
### # ### ### ########### ### ### # # # #
#   #   # #   #         # #   #. .# # # #
# ##### # # ########### # # ### # # ### #
#     # # # #         # # # #. .# #     #
##### # ### # ####### # # # # # #########
#   # #   # #       # #   # #.# #. . . .#
# ### ### # ####### # ### # # ### ##### #
#   # #   # #     # # #   # #. . .#   #.#
### # # ### # ### # ### ### # ##### # # #
#   # #     # # # #     #   #     # # #.#
# # # ####### # # ####### # ##### # # # #
# # # #       # # #   #   #     # # # #.#
### # # ##### # # # ######### ### # ### #
#   # #     # # # #           #   # #. .#
# ### ####### # # ############# # # # ###
# # # #       # #         #   # # # #. .#
# # # # # ##### ######### # # # ### # # #
# #   # #   #  . . . .# # # # #     # #.#
# ### ### ##### ##### # # # ##### ### # #
#   #   # #  . .#   #. .# #     # #   #.#
### ### # # # ### ##### # ##### ### ### #
#   #   # # #. .#   # #. .#   #     #. .#
# ### ##### # # ### # ### ### ####### # #
#     #     # #. .# #    . . . .#  . .# #
# ####### # # ### # ########### ### ### #
# #       # #   #.# #     #    . .#.# # #
# # ########### # # # ### ####### # # # #
#   #           #.#   #          . .#   #
################# #######################
