################# #######################
#     #   # #    .#. . .      #. . .    #
# ##### ### ### # # ### ##### # ### ### #
# #     #   #   #. .  #. . .# #.#. .  # #
# # ##### ### # # ######### ### # ### # #
# # #     #   # #   #     #. . .#.#   # #
# # ### ### ####### # ### ##### # # ### #
#       #         # #   # #. .# #.# #   #
####### ### ### # # ### # # # ### # # ###
#     #   # #   # #   # # #.#. .#.# # # #
# # # ### ### ### # # # # # ### # # # # #
# # #         #   # #   # #.# #. .# #   #
# # ######### # ########### # ### # #####
# #       #   # #    . . . .#     # #   #
# ######### ### # # # ############# ### #
# #         #   # # #.#     #       #   #
# # ### ##### ### # # ##### ### ##### ###
# #   #     # #   # #. . .#     # #. . . 
############# ##### # # # ####### # #####
#   #       #   #   # # #.  #. . . .    #
# # # ### # ### # ### ### ### ######### #
# #   #   #     #   #   #.#. .    #   # #
# ##### # ######### ### # # ##### # # ###
# #     # #   #       # #. .    # # #   #
# ####### # ### # # ### ####### # # ### #
#   #   #   #   # #   #       # # # # # #
### # # ######### ### ##### # # ### # # #
#   # #             # #   # # # #   #   #
# ### # ######### # # # # # # # ##### ###
# #   # # #       # #   # # # #   #     #
# # ### # # ####### ####### # # ### #####
# #   # # # # #   # #       # #     #   #
# ### # # # # # ### ### ### # ### ##### #
# #   # #   # #   # #   #   #   #       #
# # ### ##### ### ### # ##### # #########
# # #         #       # #   # #   #     #
### # ######### ####### # # ### # ##### #
#   # #       # # #   # # #   # #   #   #
# ##### ##### # # # ##### ### # ### # ###
#           # #   #       #       #     #
#########################################
