########### #############################
#      . . .  #     #           #       #
### ### # # # ### # # ########### ##### #
#   #. .# # #   # #           #     #   #
# ### # # # ### # ############# ##### # #
# #. .# # #   # #   #           # #   # #
# # ### # ### ##### # ######### # # #####
# #.#   #   #   #     #       #   #     #
### # ### # # # # ##### ##### ### # # # #
#. .#   # # # #   # #       #   # # # # #
# ##### ### ### ### # ### # # # ### # ###
#. . .#   #   #   # #   # # # # #   #   #
# ### ### # # ### # # ##### # # # ##### #
#   #.  # # #   #   # #   # # # #   #   #
##### ### # # ####### # # # # ##### # ###
#  . .#   # # #         # # #   # # # # #
### # # ### # # ######### ##### # # # # #
#. .# # #   #   #     # #     # #   #   #
# ##### ######### ##### # ### # #########
#.#   #     #   # #     #   # #         #
# # ####### # # # # ######### ######### #
#.#         # #     #                 # #
# ######### # ####### ##### # ######### #
#. . .  #   #     #   #     #   #       #
# ### # ######### # ########### # ##### #
# #. .#         # #           # # #   # #
# # ####### # ### ############### # ### #
# #. . .  # #       #           # #     #
# # ### # ### ####### # ####### # #######
# # # #.#   # #       #       # # # #   #
# # # # ### ### ########### # # # # # ###
# # # #. .#     #       # # # # # # #   #
# # # # # ####### ##### # ### # ### ### #
# #   # #. . . . .    # #     #   # # # #
# ########### ### ### ### ### # # # # # #
#     #     # # #.# #   # #   # # #     #
# # ### ### # # # # ### ### ##### ##### #
# # #   # # # # #.#   #   # #   #     # #
# # # ### # ### # ### ### # ### # # ### #
# #       #     #. .#     #     # #     #
################### #####################
