##################### ###################
#    . . . . . . .#. .        #         #
# ### # ######### # # ####### # ####### #
#   #.# #        . .# #. .  # # #. . .# #
##### # # ####### ##### # ### # # ### # #
#. . .# # #   #   #. . .#. .#   #.# #.# #
# ####### # # # ### ####### ##### # # ###
#.# #     # # # # #.#     #.  #. .  #. . 
# # # ##### ### # # ##### # ### #########
#.#   #   #   # # #. . .# #. . .#       #
# ### # # ### # # ##### # ####### ##### #
#.  # # #     # #     #.# #       #     #
# # ### ####### ##### # # ######### #####
#.#   # #     #   #   #.# # #       #   #
# ### # # ####### # ### # # # ######### #
#.#   #. . . . .#   #. .# #   # #       #
# ##### ####### ##### ### # ### # ### ###
#. .  #.#     #. . .#.    #   #   # #   #
# # ### ##### # ### # ##### ##### # # ###
# #. . .      #   #. .      #   # # #   #
# ### ############### ####### # # # ### #
#   #   #           #         # # #   # #
# # ##### ######### ####### ##### ### # #
# # #         #     #     #           # #
# # # ######### # # # ##### ########### #
# #       #     # # #     #       #     #
# # ############# # ##### ####### #######
# #       #   #   #     #       #       #
# ####### # ### # # # ### ######### ### #
#     #   # #   # # #     #       #   # #
##### # # # # ##### # ##### ##### ##### #
#   # # # #   #     #           #   #   #
### # # ####### ################### # # #
#   # #       # #     #     #       # # #
# ### ### ### ### ### # ### # # ##### ###
# #     # # #       # # #   # #     #   #
# # # ### # # ####### # ### ######### # #
#   # #   # #   #     #   #   #     # # #
####### # # ##### ####### ### # # # ### #
#       # #       #       #     # #     #
#########################################
