########### ######################### ###
# #   #    .#. . . .#. . . . . .#. . .# #
# # ### ### # ##### # ######### # ##### #
#       #  . .  #. .#. .# #   #. .  #   #
######### # ##### # ### # # # ####### ###
#       # #   #. .# #  . .# # #     #   #
# ##### # ### # # # ##### ### # ### ### #
# #     #   # #.# #     #. .  # # #   # #
# ####### ### # # ##### ### ### # # ### #
#         #   #.# #     # #.    # # #   #
######### # ### ### ##### # ##### # # ###
#   #   # # #  . .#   #. . .#     #   # #
# # # # # # ### # ##### ##### # ####### #
# #   # # #   # #. . . .  #   #     #   #
# ####### # # # ### # ##### ### ##### ###
#         # # #   # #       # #     # # #
########### # ### # ######### ##### # # #
#   #   #   #   # #     #   #       #   #
# # # ####### # # ### # # ############# #
# #   #     # # #   # # #     #     #   #
##### ### # # ### # # # ##### # ##### ###
#   #     #   #   # # #   # #         # #
# # ####### ### ### # ### # ### ####### #
# #         #   #   #   # #     #       #
# ########### # ##### ### # ##### # #####
# #   #       # #   #   # # # #   #     #
# ### # ### ##### ### # ### # # ##### ###
#   #   #   #       # # #     # #   #   #
# # ##### ### ### # ### # ##### # # ### #
# #     #       # #   #         # #     #
# ### # ####### # ### # ######### #######
#   # #     #   # #   #     #     #     #
# # # ##### ####### # ### ######### #####
# # # #   #       # #   #     #         #
# # # # ##### ##### ######### # ####### #
# # # # #   #   #   #       #     #   # #
### # # # # ##### ### ### ####### # # # #
#   #   # # #   # #     #     #   # #   #
# ####### # # # # # ####### # ##### ### #
#         #   # #     #     # #     #   #
#########################################
