################### #####################
#  . . . . . . . . .                #   #
# # ### ##### ### # ### ######### ### # #
# #.#   #     #   # # #         #     # #
# # ##### ##### ### # # ##### ######### #
# #.#     #     # #   #     #         # #
### # ##### ##### ############### ##### #
#. .#   #   #   #                   #   #
# ####### ##### ##### ### # ####### # # #
#. . .#   #   #       #   # #     # # # #
# ### # ### # ##### # ##### # ### # # # #
# #. .# #   #   #   # #     # #   # # # #
# # # # ####### ##### # ##### # ### # # #
# #.# #     # #   #   # # #   #     # # #
# # ##### # # ### # ### # # ### # ### ###
# #. . .# # #   #   #   # #   # # #     #
# ##### # ##### ##### ### ### # # # ### #
# #   #.#     #     #   # # # # # # #   #
# # # # ### ### ####### # # # # # # #####
#   # #.  #     #     # # # # # # # #   #
##### # # ### ### # # # # # # ### # # # #
#     #.#   #   # # # #   # #   # # # # #
####### ### ##### # ##### # ### ### ### #
#. . . .# #       #     # #   # #   #   #
# ### # # # ######### # ##### # # # # ###
#.# # #   #       #   # #     # # # #   #
# # # ############# # # # ##### # ##### #
#.# #       #       # #   #   # #     # #
# # ### ### # ##### # # ### # # ##### # #
#.#   #   # #   #   # # #   # # #   #   #
# ### ##### # ####### # # ##### # #######
#. .#   #   #   #     #   # #   #     # #
# # ### # ##### # ######### # # ##### # #
# #.  # # #     #           # # #     # #
### # # # # ############# ### ### ##### #
#. .# #   # #     #     #   #     #     #
# ### # ##### # # ##### ### ####### #####
#. .# # #     # #     #   #         #   #
# # # ### ##### ####### ############### #
# #.#         #                         #
### #####################################
