####### #################################
#      . . .                # #     #   #
# # # # ### ##### ######### # # # ### # #
# # # #   #. .  #         #   # #     # #
# # # # # ### ##### ##### ##### ####### #
# # # # #   #. .  # #   #     # # #   # #
### # ##### # # # ### # # ##### # # # # #
#   #     # # #.#   # # # #     #   # # #
# # ##### # ### ### # # # # ######### # #
# # #   # #   #. .# # # # # #   #   # # #
# ##### ##### ### # # ### # # ### # # # #
#     #   #   #. .# #     #   #   #   # #
# # # ### # ### # ######### ### ####### #
# # #   # # #  .# #. .          #       #
# ### ### # ### ### # ########### #######
#   # #   #   #. . .#. .      #   #     #
# # # # ##### ### ##### ### # ##### ### #
# # #       #   #     #.  # #     # # # #
### # ##### ### ####### # ####### # # # #
#   #     # #   #. . . .#       # #   # #
# ####### ### ### ### # ####### # ### # #
# # #   #   #   #.#   #       # #     # #
# # # # ### # # # ########### # ####### #
# #   #   # # # #. .#. . . .# #   # #   #
# ##### ### ### # # # ##### ##### # #####
#         #   # # #. .#   #. .  #   #   #
# ### ### ### # # # ### # ### # ### ### #
#   # #   #   # # #     #   #.#   # #   #
# # # ##### # # # ######### # ### ### ###
# # # #   # # # #   #   #   #.  #     # #
# # ### # # ### ### # # ##### ####### # #
# # #   # #   # # #   #     #. .    # # #
# # ##### # # # # # ####### ### ### # # #
# #     # # # #   #       #   #.  # #   #
# # ### # ### ############### # ### #####
# #   # #   # #           #   #. .#     #
# ##### ### # # ######### # ### # ##### #
#     #   # # # #   #   #   # # #.#   # #
##### # # # # ### ### ##### # # # # # # #
#     # #   #       #       #   #.# #   #
################################# #######
