################################# #######
#     #              . . .#    . .  #   #
# ### # ### ######### ### ##### # # # # #
# #   #   # #      . .#  . . . .# # # # #
# # ####### # ##### ######### ##### # # #
# # #       # #    . .#       #     # # #
# ####### # # # ### # # ####### ### # # #
#         # # # #   #.#   # #   #   # # #
####### # ### # # ### ### # ### ####### #
#   #   # #   # #   #.  # #   #       # #
### # ### # ### ### # ### ### ### # # # #
#   # #   #   # #   #.#     #   # # #   #
# ### # # ### ### ### # ### ### # #######
# #   # #   #   # #  .#   # #   #       #
# ### ##### # # # ### ### ### ######### #
#     #   # # # #   #.  #     #         #
####### # # # # ### # # # ###############
#     # # # # #   # #.# #     #         #
# ### # ### # # # # # # ####### ####### #
# #   #     # # # # #.#         #   #   #
# # ######### ### ### ### ######### # # #
# #         # #   #. .  #         # # # #
# ##### ### # # ### # # ######### # # # #
# #     #   # # #  .# #   #     #   # # #
### ####### # # # # # # ### # ####### # #
#   #       # # # #.# #   # # #       # #
# # ####### ### ### # # # ### # # #######
# # #     # #   #. .# # #     # # #     #
# # # ### # ##### # # ######### # # ### #
# # # #   #      .# #         # # # # # #
# ### ##### ##### # ######### ##### # # #
#   #     # #  . .#   #. .  #       #   #
# # ##### ### # # ##### # ###############
# #     #     #.#   #. .#. .    #       #
############### ##### ##### ### ####### #
#     #   #    . .#. .#   #.#     #   # #
# ##### # # ### # # ### ### # ##### # # #
# #     # # #   #. .  # #. .#   #   # # #
# # ##### # # # ####### # # ### # ### # #
#   #       # #         #.#   #     #   #
######################### ###############
