# #######################################
#. . . .    #. . .                  #   #
# # ### ##### ### ##### ####### ### # # #
# #   #. .#. .  #. . .#       #   # # # #
# ### ### # ### ##### ### # # # # # ### #
#   #   #. .  #     #.  # # # # # #     #
# # ### # ### ##### # # # # ### #########
# #   # #   # #. .# #.# # #   #         #
# ##### ### ### # ### # ##### ######### #
#   #   #   #. .#. . .# #     #       # #
# # # ####### ##### ### # # # # ####### #
# # #       #. . .# #   # # #   #     # #
# ######### # ### ### ### ####### ### # #
#   #  . .# #   #.#   # #       # #   # #
### # # # # ##### # ### ### ### # #######
#   # #.#.# #. . .# #. .  # #   #       #
# ##### # ### ##### # # # ### ######### #
# #   #.#. . .#     #.#.#   # #         #
# # # # # ########### # ### # # #########
# # # #.# #. . . .  #.#.#   # #. .      #
# ### # # # ##### ### # ####### # #######
#     #.# #. .  #. . .#.#. . . .#.  #. . 
####### # ### ##### ### # ####### ### ###
#  . . .# #. .#. .# #. .#.#     #. . .# #
# # ##### # ### # ### # # ##### # ##### #
# #.#     #.  #.#.#. .# #. . .# #     # #
# # # ##### ### # # ### ##### # ##### # #
# #.#   #. .# #.#. .#   #   #.  #   #   #
# # ##### ### # ##### ### ### ### # #####
# #. . . .# # #. .#   #. . . .    #   # #
# # ####### # # # ##### ########### # # #
# #         # # #. . . .  #     #   # # #
# ########### # ### ####### ##### ### # #
#   #         #   #     #   #     #   # #
# # # ####### ### ##### # ### ##### ### #
# # # # #   #   #     # #   #     # #   #
# # # # # # ### ##### # ### ##### ### ###
# # # #   #   #     # #   #     #     # #
# ### ####### ##### # ####### ######### #
#             #     #                   #
#########################################
