############# ################### #######
#     #      .#   # #      . .#  . . .  #
# ### ####### # # # # ### # # ##### # # #
#   #   #   #.# #   # #   #.#. . .# #.# #
### ### # # # ##### # ### # ##### ### # #
# # # #   #  . . .# # #   #.#    . . .# #
# # # ########### # ### ### # ####### # #
# #   #     #   #.#   #   #.# # #   # # #
# ##### ### # # # ### ### # # # # # ### #
#   # # # # # # #. .#     #.#   # #     #
### # # # # # ##### ####### ##### ##### #
#   #   # # # #   #. .#    . .  #   # # #
# ### ### ### # # ### ####### # ### # # #
#   #   #   #   #   #. . . .#.#   # #   #
### ### ### ####### ####### # ### # #####
# #             # #     #  .#. .# #     #
# ############# # ##### ### # # ####### #
#       #             #    .# #. .  #   #
### ### # ########### ##### ##### # # # #
#   # #   #         #      . . .#.# # # #
### # ##### # ##### ########### # # # # #
#   # #     #   #             #.#.# # # #
# ### ########### ### ####### # # # # # #
# #   #           #   #       #. .# # # #
# # ### ######### # ### ##### ##### # # #
#   #   #   #     #   # #   #   #   # # #
##### # # # # ######### # # ### # ### # #
#     # # # # #   #     # #       #   # #
# ####### ### ### # ##### ############# #
#   #   #   # #   # #     # #       #   #
### ### ### # # ### # # ### ####### # # #
# # #       # # #   # #     #   #   # # #
# # # ##### # # # # ######### ### ### # #
# # # #     #   # # #       #   # #   # #
# # ####### ##### # # ##### ### # ##### #
#   #             # # #       # #   #   #
### ############# ### ####### # ### # # #
#   #             #   # #   # #       # #
# ### ############# ### # ### ######### #
#   #             #     #               #
#########################################
