################### ########### #########
#   #      . . . .#. . .      #.#       #
# # ### ### ##### ##### ### # # # #######
# #     #  .#   #. . . .  # # #.#       #
# ######### # ########### ### # ####### #
#     #. . .#       #     #   #. . . .# #
####### # ######### ####### ######### # #
#. . . .# #. .#. .#   #     #     #. .# #
# ### ##### # # # ### # ##### ##### ### #
#. .# #. . .#. .#.  #   #. . . . . .  # #
### ### ####### # ####### ######### ### #
#. .#. .      # #. . . .#.#   #   #     #
# ### ####### ### ##### # # # # # #######
#. .#.#   # #   # #. . .#. .# # # #     #
# # # # # # ### ### # # ### ### ### ### #
# #. .# # # #   #. .# #   #.#   #   #   #
# # ##### # # ### ### ##### # ### ### # #
# #         # #. .#   # #. .  #   #   # #
# ########### # ####### # ####### #######
#       #   # #. . . .  #.  #   # #     #
# # ### # # # # ##### ### ### # # # ### #
# #   # # #   # #   #.  #.#   # # # #   #
# ##### # ####### ### ### # ##### # # ###
# #     #         #  . . .  # #   # #   #
# # ### ############# # ##### # ### ### #
# #   # #     #   #   #       # #   # # #
# ### ### ### ### # # ####### # ##### # #
#   # #     # #   # # #     #           #
### # # ####### ### # # ### #############
#   #         # #   # # # #             #
# # # ####### # # # ### # ### ####### # #
# # #       #   # #   #   # #     #   # #
# ######### ##### ### ### # # ### # #####
#       # #     #   #       # #   # #   #
##### # # ### # ##### ### ### # ### # # #
# #   #   #   # #   #   # #   # #   # # #
# # # ##### ##### # ### ######### # ### #
#   # #   #     # #   #     #   # # #   #
### # # # ##### ### ####### ### # ### ###
#   #   #     #           #     #       #
#########################################
