####### ######### #######################
#      .    #   #.#         #   #   #   #
####### ### # # # ######### # # ### # # #
#. . . .# # # #  . . . . .# # #       # #
# ####### # ############# # # ###########
#. . . .# # #       #   #.# #     #     #
# ##### # # # ##### # # # # ##### # ### #
#     #.#   # #   # # # #.# # #   #   # #
##### # ##### # ### ### # # # # ##### # #
# #   #. .#. . . .#     #.  # # #     # #
# # ##### # ##### ####### ### # # ##### #
#   #. . .#.# #. .    #. .      # #   # #
##### ### # # # ####### ######### ### # #
#. . .#   #. .#. . . . .            #   #
# ########### ##### ############### #####
#. . . . . . .#   #         #     #     #
# # ##### # ##### ####### # # ##### # # #
# #     # #       #       #   #   # # # #
# ##### # ##################### # # # ###
#     # #     # #         #     # # #   #
### ### ##### # # ##### ### ##### # ### #
# #   #     # #   #         #     # #   #
# ### ### # # ##### ################# # #
#       # # #     # #         #       # #
# ### ### # # ##### # ####### # ### # # #
# #   #   # #       #     # # #   # # # #
### ### # # ####### ##### # # ##### # # #
#   #   # # #     #       # #     # # # #
# ### # # # # ### ######### # ### # ### #
# #   # # #     #     # #   #   # # #   #
# # # ### # ### # ### # # ####### # # # #
# # # #   # # # #   #   #   #     # # # #
# # # # ### # # ### ####### ### ### # ###
# # # #   # # #   #       # #   #   #   #
# # ##### ### ####### ### # ##### # ### #
# #     #   #         #   #       # #   #
# ### ##### ########### ########### # ###
#   #     #   #   #   # #         # #   #
# # ##### ### ### # # # ######### ##### #
# #     #   #     # #   #               #
#########################################
