####################### #################
#   #      . . .# #  . .  #. . .        #
# # # ##### ### # # # ### # ### ##### # #
# #   #  . .# #.#   #.#   #.# #.  # # # #
######### ### # ##### ##### # # # # # # #
 . . . . .#   #. . .#. . .#.  #.#   # # #
# ####### # ####### ##### # ### ##### # #
# #     # #     #  . . .#. .  #.  #   # #
# # ### # ##### ####### # ### # # # # # #
# # # # #     #   #  . .# #   #.# # # # #
# # # # ##### ### ### ### ##### ### # # #
# # # #     #   #    .#   #. . .#   # # #
# # # ##### ######### ##### ##### # # # #
# #   #              . . . .#   # # # # #
# # # ################### ### # # ### # #
# # # #     # #           #   # # #   # #
# # # # ##### # ### ####### ### # # ### #
# # # # # #   # #   #     # #     #   # #
# # ### # # ##### # # ### # ### ####### #
# #   # #   #     # # #   # #   #     # #
# ### # # ### ##### # # ##### ### ### # #
#   # # # #   #     # #       #     #   #
# # # # # ### # ##### ####### ### # # # #
# # # #     # # #     #       #   # # # #
# # ####### # ### ### # ####### ### # # #
# #   #       #   #   # #   #   #   # # #
# ### # ##### # ####### # # # ##### # # #
# #   # #     # #       # # # #     # # #
### # ### ##### ######### ### ### ##### #
#   # #   #           #   #   #   #     #
# # ### # # ### ##### # ### # # ### #####
# # #   # # #   #     #     # # #   #   #
# ### ##### ############# ##### # # # # #
#   #   # #           #   #     # # # # #
### ### # ##### ##### ##### ### # # # # #
# # #   #     # #     #   # #   # # # # #
# # # # ##### ### ##### # # ##### # # # #
# # # # #       # # #   # #     # # # # #
# ### # ####### # # # ######### # # ### #
#     #       #   #             # #     #
#########################################
