# #######################################
#.  #. .      #. . .      #             #
# ### # ####### ### ### ### # ### ##### #
#. .#.#. .#. . .#. .  #     # # #     # #
# # # ### # ##### # ### ##### # ##### ###
# #.#.# #. .#   #.#   # # #   #     #   #
### # # ##### ### ### # # # # ##### ### #
#. .#. .    # #. .  # # # # #   #       #
# # ### ##### # # # # # # # ### ####### #
#.# # #.      #.# # # #   #   #     #   #
# # # # ####### # # # ##### ####### #####
#.# #. .#. . .#.# # #     #       # #   #
# ### ### ### # # ####### # # # ### # # #
#. . .# #.#  . .#     # # # # # #   # # #
# # ### # # ### ##### # # # # # # ##### #
# # #   #.#   #   # #   # # # # #       #
# ### ### ####### # ##### # # # #########
#     #  . . .#   #       # # # # #     #
# ##### # # # ##### ####### # # # # #####
#     # # # #. .  # #   #   # #   #     #
####### # # ### ### # ### ##### ####### #
#       # #   #.#   # #   #   #     #   #
# ####### ### # # ### # ### # ##### # ###
#   #   #   # #.#   #   #   #     # # # #
### # # ### # # ### ##### ##### # # # # #
# #   #   # # #. .#     # #   # # # #   #
# # ####### # ### ### # # # ### # # ### #
# # #       # # #. .# # #   #   # #     #
# ### # ### # # # # ####### # ###########
#     #   # #   # #.        #   # # #   #
### ### # ####### # ### ##### # # # ### #
#   #   # #     # #.  #     # #     # # #
##### ### # ##### # # ##### ### ##### # #
#     #   # #     #.#     #   # #       #
# ##### ### # ##### ##### ### # # #######
# #     # #   #. . .  #     # # # #     #
# ### # # ##### ####### # ### ### # ### #
#   # # #      .#     # # #   #   #   # #
### # ######### # ### # # # ### ####### #
#   #         #.#   #   # #             #
############### #########################
