##### ###################################
#  . .        #   #. .  #. . . .      # #
# # # ####### # # # # ### ##### ##### # #
# #.# #. . .# # # #.#. . .#   #. . .#   #
# # ### ### # # # # ####### # ##### #####
# #. . .# #.#   # #. .#   # #   # #.    #
# # ##### # ##### ### # # # ### # # #####
# #       #.    #   #. .# # # # # #. . . 
# ######### ########### ### # # # # # ###
#   #      . . . . .#. .#   # #   # #   #
# # ####### ### ### # ### ### ##### ### #
# #       #   #   #. .    #       #   # #
# ####### ### ### # ####### # ##### # # #
#     # #   # #   # #       #   #   # # #
# ### # # # # ####### ### ##### # ### # #
#   #   # # # #       # #   #   # #   # #
######### # # # ####### ### # # # ##### #
#         # #   # #   # #   # # # #     #
# ### ##### # # # # # # # ####### # #####
#   # #     # #   # # # #   #     # #   #
### # ####### ##### # # ##### ### ##### #
# # #       #   #   # #     # #   #     #
# # ### ### # ### ######### # ##### #####
# #   #   # #     #         #     #     #
# # # # ### ####### ####### # # # # #####
# # # #   #   #       #   # # # #   #   #
# ### # ### ### ##### # # ### # ##### # #
#     #   #     #   #   # #   # #   # # #
### ##### # ####### ##### # # # # # ### #
#   #     #     # #   #   # # # # #     #
# ### ### ####### ### ##### # # # #######
# #   #   #         #       # #         #
# ### ##### ############### # ######### #
#   #     #               # #         # #
### # ### # ############# # ######### ###
# # #   # # #   # #     # # #       #   #
# # ### # # # # # # ##### ### ### ##### #
# #   # # # # #   #   #   #   # #     # #
# ### # # # ##### ### # ### ### ####### #
#     # #             #       #         #
#########################################
