##### ###################################
#    .    #             #         #     #
# ### # # # ### ####### # ####### # ### #
#   #.# # # #         #   #     #     # #
##### # ### # # ########### # ######### #
#. . .#     # #   #     #   #       #   #
# ########### ### # # # # ####### # # ###
#. . . . .  #   # # # # # #       # #   #
# ### ### # ### ### ##### ####### # #####
#   #   #.#   #     #   #. . .  # #     #
# # ### # ############# # ### # ####### #
# #   # #.#. . .    #   #.#. .# #   # # #
# # # ### # ### ### # ### # # # # # # # #
# # #   #. .  #. .#   # #.#.# # # # #   #
# ### # ### # ### ##### # # # # ### #####
#   # #   # #   #. . . . .#.# # #       #
# # # ### ##### # ######### # # # #######
# # #   #     # #       #. .# # # # #   #
# # ### ##### # ####### # # # # # # # # #
# #   #     # #       # #.# # # #   # # #
# # # ##### # ####### # # ### # ### ### #
# # #   # # #       # # #. .# #     #   #
# ### # # # # # ### # ##### ######### ###
#   # # #   # #   # # #   #. . . . . . . 
# # # # ##### # # # # # # ##### # # #####
# # # #   #   # # # #   # #   # # #     #
### ##### ##### # # ### # # ### # #######
#   #   #   #   # #   # # # # # #       #
# ### # # # ##### ### # # # # # ####### #
#   # # # # #       # # #   # #       # #
### # # # # ##### ### # ### # ##### # # #
# # # # # # #   # #   #   # #       # # #
# # ### # # # # # # ##### ######### ### #
# #     # #   # # # # #   #     #   #   #
# ##### # # ####### # ##### ### ##### # #
# #   # # # #   #   #       #         # #
# # # # # ### # # ####### ##### ##### # #
# # # # # #   # # #     # #   # #   # # #
# # # ### # ### # # ### ### # ### # ### #
#   #     # #     #   #     #     #     #
#########################################
