############# ###########################
#   #        .#. . . . . . .  # #. . .  #
# # ##### ### # ########### # # # ### ###
# # #     #  .#. .#     # #.#   #.  #. .#
# # # ##### # ### # ### # # ##### ##### #
# # # #   # #. . .  # #   #.    #.#   #.#
# ### # # ########### ##### ##### # ### #
#   #   # #. . . .# #      . .#. .# #. .#
### ####### ##### # ######### # ### # # #
#        . .#   #. .#  . . .#.#.  # #.# #
######### ### ##### ### ### # # ### # # #
#    . . .#   #. . .#. .# #.#. .    #.# #
# ### ##### ### ##### ### # # ####### ###
# #. .#   # #. .#    .#. . .# #. .#  . .#
### ### # # # ####### # ####### # # ### #
 . .#   # #. .#  . . .#.#  . . .#.# #. .#
# ####### # ##### ##### # # ##### ### # #
# #     #  . . . .#   #.# #.#    . . .# #
### ### ########### # # # # # ######### #
#   # #             # #.# #.#   #     # #
# ### ############### # ### ##### ##### #
# #   #     #       #  . .#. . .#       #
# # ### ### # ### ####### # ### #########
# # #   #     # # #     #.# #. .      # #
# # ##### ##### # # # # # ### # ##### # #
# # #     #   # # # # #  . . .#     #   #
# # # ##### # # # ### ##### ##### ##### #
# #   #     # #     # #     #   #     # #
# ##### ##### ##### # # ##### ##### # ###
# #     #   #   #     # #   # #     #   #
# # ##### ##### ####### # ### # ####### #
# #   # #   #           # #     #       #
# ### # ### ######### # # # # ### # #####
# # # #   #       #   # #   # #   # #   #
# # # ### ##### # ### # ##### # ### # # #
#   # # #     # #     #   #   # #   # # #
##### # ##### # ##### ##### ### # ##### #
#   #   #       #     #   # #   # #     #
### ################### # # # # ### #####
#                       #   # #         #
#########################################
