##################### ###################
#              . .#. .            #     #
# # ######### # # # # # ######### # # # #
# # #   #     #.#. .# #         #   # # #
# ### # ### ### # # # ######### # ### # #
# #   # #   #  .# # # #       # #   # # #
# # ### # ##### ### # # ##### # ##### # #
#   #   #     #. .# #   #   # # #     # #
# ### ##### # ### ####### ### ### ##### #
#   # #   # #   #. .    #     #   #     #
##### # ##### # # # ### ####### # # ### #
#     #     # # # #.  #   # #   # # # # #
########### # # ### # # # # # # # # # # #
#         # # # #. .# # # # # # # # #   #
# # ##### # ### # # # # # # # # # # #####
# # #     #     #.# # # # #   # # #     #
### # ########### # # # # ##### # ##### #
#   # #      . . .# # # # #   # #     # #
# ### # ##### # ##### ### # # # ##### # #
#   # # #    .# #     #   # # # #   # # #
# # # # # ### # # ##### ##### # # # ### #
# # #   # # #.# # #   #   #   # # #     #
######### # # ### ### # # # ### # ##### #
#     #   # #. .#   # # # # #   # #     #
# ### # ### ### ### # # # # # ###########
#   # #   # #. .  # #   #   #           #
##### ### # # # # # ##### # ####### ### #
 . . . .#   #.# # # #     # # #   #   # #
####### ##### ### # ######### # # ### # #
#     #. .# #. .# #   #       # # #   # #
# ### ### # # # # ### # ####### # ##### #
#   #   #.#   #.#   #         # #       #
### ### # ##### ### ### ##### ###########
# #   #  . .#  . .#   #     #     #     #
# ######### # ### ### ##### ##### ##### #
# #     #  .#   #.  # #   #     #     # #
# ##### ### ##### # # # # ##### ##### # #
# #       #. . . .# # # #     #     # # #
# ####### ########### # ##### # ### # # #
#                     #     #   #   #   #
#########################################
