##### ######################### #########
#   #.#     #         #      . .  #     #
# ### # ### # ####### # ##### # ### ### #
# #. .#   #   #   #   # #. . .#   # # # #
# # ############# # ### # ### ### # # # #
# #.#  . .#       #     #.#   # #   # # #
# # ### # # ############# ##### ##### # #
#  . . .#. .    #       #. . . . . . .# #
########### ##### ##### # ########### # #
#     #   #.#     #. .#   #. . . . .#.# #
### # ### # # ##### # ##### # ##### # # #
#   #   # #.# #. . .#. . .#.# #   #.#.# #
####### # # ### ######### # # # # # # # #
#     # #  .#. .#        . .# # # #. .# #
# ### # ### # ### ########### # # ### # #
# #   #   #. .#   #     #     # #     # #
# # ##### ### # ##### # ####### ####### #
# #       #   # #     #         #       #
######### ##### # # ### ####### # # ### #
#       #       # # #   #     # # # #   #
# ##### # # ##### # # ### ### ### ### # #
# #   # # # # #   # # #   #     #   # # #
# # ### ### # ####### # ####### ### ### #
# # # # #   #     #   # #     #   # #   #
# # # # # ####### # ### # ### ### # # # #
#   #   # #   #   # #   # #   #     # # #
### ##### # ### ### # # # # ######### # #
# #       #     #   # # # #       #   # #
# ### ####### ##### # ### ####### # ### #
#   # #           # # # # #     #   #   #
### # # ######### # # # # # ######### # #
#   # # #           #   # # #         # #
# ##### ### ############# # # ######### #
# #     #   #   #     #   # #         # #
# ### ### ### ### ### # ### ########### #
#     #     # #   #   #   #             #
########### # # ### ######### ### #######
#         #   # #       #       # #     #
# ############# ####### # ### # ### ### #
#                     #   #   #     #   #
#########################################
