####################### #################
#      . . . .#  . . .#. . . . . . . .  #
####### ##### ### ### # # ####### ### # #
 . .#  .# #  . . .#  .# #   #   #   #.# #
### ### # # ######### # ##### # ### # # #
# #. . .#   #       #.#     # #   # #.# #
# # ######### ##### # ##### ##### ### ###
# # #       #   # #  . .# #     #   #. .#
# ### ##### ### # ##### # ##### ### # # #
#     #       # #   #  . .#   #     # #.#
# ########### ### # ##### ### ######### #
# #             # #      . . . . .#  . .#
### ########### # ############### ### # #
#   #   #     #   #             #. . .# #
# ### # ##### ######### ############# # #
#   # #   # # #             #         # #
# # # ### # # ############# ### # ##### #
# # #   # # # #         #       # #     #
# # ### ### # # # ##### ########### # # #
# #       #   # # #   #   #   #     # # #
# ########### # # # # ### # ######### ###
# #   #     #   # # #   # # #     #     #
# # # # ### ##### # ##### # # # # ##### #
# # # # # #   #   #   #   # # # #       #
# # # # # ### # ##### # ### ### ##### # #
# # # # #   #   #   # #         #     # #
# # # # ### ##### ### ##### ########### #
# # # #   #     # #   # # # #     #     #
# # # # # ##### # # ### # ### ### ##### #
#   # # #     # # #   #   #   # #   #   #
# ### # ##### # # ### ### # ### ### # # #
#   # #     # # # # #       #   #   # # #
##### # # ### # # # ####### # ### ### # #
#     # #   # #     #       #         # #
########### ####### # ### ########### # #
#         #   #   # # #   #           # #
# ####### ##### ### ### ### # ######### #
#   #     #   #     #   #   # #     #   #
### ####### # # ##### ### ### # ### # ###
#           #         #   #     #   #   #
#########################################
