##### ###################################
#    .  # #. . . . .    #. . .  #. . . .#
# ### # # # ####### ##### ### ### ##### #
# #  .#   #. .# #. .#. . .  #. .#.#. . .#
# ### ####### # # ### ####### # # # ### #
#   #.#. .  #.  #. . .      # #. .#.# # #
# # # # # ### ##### ####### ### ### # # #
# # #. .#. . .    #       #   #   #.#   #
# # ############# ### ####### ##### #####
# #   #       #     #   #     #   #. . . 
# # # ####### # # ### ### ##### # ### ###
# # #         # #   #   # #     #   #   #
# ####### ##### ### ### # ######### ### #
#       #     #   #   # #       #   # # #
# # ### ##### # # ### # ######### ### # #
# # #   #     # # # # #             # # #
# ### ######### # # # # ##### ####### # #
# #   #         #   # # #   #       #   #
# # ### ##### # # ### ### # ####### #####
# # # # #   # # # #       #       # #   #
### # # # # # # ### ####### ##### # ### #
#   # # # #   #   # #     #     # #     #
# ### # ######### ### ########### #######
#     # #       #   #       #           #
# # ### # ##### ### ####### # # # ##### #
# # #   # #   #   #       # # # #     # #
# # # # # ### ### ##### ### # # ####### #
# # # #       # # #   # #   # #   #     #
# # # ######### # ### # # ### # ### #####
# # #   #       #     #   #   # #   #   #
# ### # # ##### ####### ####### # # # # #
#   # #   #   #       # # #   # # # # # #
# # # ##### # ### ### # # # # ### # # ###
# # # # #   #   #   # #   # #     # #   #
# # # # # ##### # # # ##### # ##### ### #
# # #   # #   # # # #   #   # #     #   #
# # ##### ### ##### ##### ##### ##### ###
# # #     #         #     #     #     # #
# # # ########### # ############# ##### #
# #   #           #                     #
#########################################
