##### ###################################
#    . .  #. . .  #. . . .    #. . . .  #
# ### # ### ### ### ##### ### # ##### ###
# #   #.#. .  #. .#. .# #.#   #.#   #. .#
### ### # ### ### ### # # # ### ### # # #
#   # #. .  #   #. . .  #.# #. .#   # #.#
# ### # # # ### ######### ### ### ##### #
#     # # #   #       #  . . .    #  . .#
# ##### # ### ####### ### ######### # # #
# #     #   #       # #   #. . .# # #.# #
### ############# # # # ### ### # # # # #
#   #     #       # # #   #.#  . .# #.# #
# ####### # ####### # ### # ##### ### # #
#     #   # #       #   # #. .#  . .#.# #
# # # # ### ########### # ### ##### # # #
# # # # #   #       # # #   #. .#  . .# #
# ### # # # # ##### # # ### ### ##### # #
# #   #   # # #   #   #   # # #. .#   # #
# # ######### # # ####### # # ### # ### #
# #           # # #   #   #   #. .#   # #
# ####### ##### # # # # ####### ####### #
#   #   # #   # # # # #       #. . . .# #
# # ### # # ### # # # ### ### # ### # # #
# #   # #   #   #   #   #   # #   # #.# #
##### # # ### ################### # # ###
#   #   #   # #     #             # #. . 
# # ####### # # # # # ##### ##### # # ###
# # #     #   # # #   #     #     # #   #
# # # ########### ##### ##### ##### ### #
# # #           # #   # #     #       # #
### ########### # ### # ### ##### ##### #
#   #       #   # #   # #   #     #     #
# ### ##### ### # # ### # # # # # # #####
# #   #   #       #     # # # # # #   # #
# ### # ####### # ####### ### # ##### # #
#   # #   #   # #   #     #   #     #   #
### # ### # ### ##### ##### ### # #######
# #   #   #     #     #   # # # #       #
# ####### ####### ### # ### # ######### #
#                 #   #     #           #
#########################################
