######### ### ###########################
#        .  #.#          . . .#. . . . .#
### ##### # # ########### ### # ####### #
#   #  . .# #. . . . .#  .# #. .#. .  #.#
# ### # ############# ### # ##### # ### #
#   # #. . . .      #. . .#. . . .#. . .#
# # ##### # # ############# ####### #####
# #     # # #. . . . . . . .      # #   #
# # ### # # ##### # ############# # ### #
# #   # # #     # #           # # #   # #
# ### # # ##### # ########### # # ### # #
#   # # #     # #         #   #     # # #
### # # ### # # ######### ########### # #
#   # #   # # #     #   #         #   # #
####### # # # ### # # ### ####### # # # #
#     # # # #   # #   # #     #   # # # #
##### ### # ### # ##### ####### # # ### #
#         #   # #     # #       # #   # #
# ########### # # # # # ### ##### # # # #
# #   #     # # # # # #     #     # #   #
# ### # ### # # # # ####### ####### ### #
#     # # #   # # #       # #     #   # #
# # ### # ### # # ### ### ### ### ### ###
# # #   #     # #   #   #       #   #   #
# # # # ####### ### ### ######### # ### #
# # # #     #     #   #         # #   # #
# ### ### # ##### ### ### ##### ##### # #
# #   # # #     #   #   #     # #     # #
### ### # ### # # # ##### # # # # # ### #
#   #   #   # # # #     # # # # # # #   #
# ### ### # ### # # ### # # # # # ### # #
#   #   # # #   # # #   # # # # #   # # #
# # ### # ### ### ### ######### # # # ###
# #     # #   #   #   #     #   # # #   #
# ######### ### ### ### ##### ### # ### #
# #     #   #   #   #   #     #   #   # #
# ##### # ######### # ### ### # ####### #
# #     #       #   # #   #   # #     # #
# # ########### # ### ####### ### ### # #
#   #           #   #         #   #     #
#########################################
