######################### ###############
#   #       #     #  . . .    #     #   #
# # ### ### # ### # # # # ### # # ### # #
# #   # #   # #     #.# #   # # #     # #
# ### # ##### # ##### ##### ### ##### # #
#   # #   #   # #   #. . .#       # # # #
##### ### ### ### ####### ######### ### #
 . . . .# #   #   #. . .#. . .    # #   #
####### # # ### ### ### ##### ### # # # #
#      . .#     #. .# #. . .#. .# #   # #
######### ####### ### ##### # # # #######
#       #. . .#  .# #. . . .# #.#       #
# ########### ### # # ####### # ####### #
#            . . .#  . . . .# #. .#   # #
############# # ########### # ### # ### #
#           # # #   #      .#   #.#     #
# ### ##### ### # # ####### ##### #######
# # # #   #     # #        .#  . .#     #
# # # # # ####### ######### ### # # ### #
# # #   # #       #       #. . .# # #   #
# # ##### # ####### ### # ##### # ### ###
# # #     # #       #   #   #   #     # #
# # # ##### # ####### # ### # # # # ### #
#   # #     # #     # # #     # # #     #
##### ### ### # ### ### # ### ### #######
#     #   #   # #   #   # #   #   #     #
####### ### ####### # ##### ### # ##### #
# # #   #   #     # # #   # #   #       #
# # # # # # ##### # # # # # # # #########
#     # # # #   #     # #   # #         #
### ##### ### # ### ### ##### ##### ### #
#   #   #   # #     #   #   #     #   # #
# ##### # # # ####### # ### ##### ### ###
# #   # # # #   #     # #   # # #   #   #
# ### # ### ##### ### # # ### # ### ### #
#   # #     #     # # # #   # # #   #   #
### # ####### ##### # # ### # # # ### # #
# # #   #   # #   #   # # # #   # #   # #
# # ### ### # # # ##### # # ### ### ### #
#     #       # #       #           #   #
#########################################
