# #######################################
#.    #                 #         #     #
# # ### ### ##### ##### # ####### # ### #
#.#       #     #     # #       #   #   #
# ############# ##### ### ##### ##### ###
#.#. . .  #   #     #         # #     # #
# # ### # # # ##### ######### # # ##### #
#. .  #.#   # #   #         # # # #     #
##### # ##### # ####### ### # # # # #####
#. .# #. .  # # #       #   # # # # #   #
# # ##### # # # # ##### # ### # ### # # #
#.#. . .#.# # # # #     #   # #     # # #
# ##### # # # # # ####### # # # ####### #
#.#    . .# #   # # #   # # # #     # # #
# ######### ####### # # ### # ##### # # #
#. .#. .#   #       # # #   #     # #   #
# # # # # # # ####### ### # # ### # # ###
# #. .#.# # #   #   #   # # #   # # # # #
### # # # ##### # ##### # # ##### ### # #
 .# # #.#     #   #     # #     #       #
# # ### ### ### ### ##### ##### ##### ###
#.# #. .  # #       #         #     #   #
# # # # # # # ####### # # ######### ### #
#.# #.# # #   #   #   # #         # # # #
# ### # ##### # ### # # # ######### # # #
#.#. .#     # #     # # #   #       #   #
# # # ##### # ### ### # ##### # # # #####
#. .# #     #   # #   # #   # # # # #   #
##### # # # # # ### ### # ### # # # # ###
#     # # # # # #   #   # # # # # #   # #
# ##### # # ### # ### # # # # # ####### #
# #   # # #   # # #   # #   # # #       #
# ### # # # # # # # ####### ### # #######
# # # # # # # # # #       #   #     #   #
# # # # # ### # ######### ### # ##### # #
# #   # # #   #       # #     #     # # #
# # ### # # ##### ### # ########### # # #
# #   # # # #   # #   #           # # # #
# ### # # # ### # ##### ### ### # # ### #
#   #   # #     #       #   #   # #     #
#########################################
