################# #######################
#    . . .#    . .    # #               #
# ### ### # ### ##### # # # ########### #
#   #.# #.#   #. .# # # # #           # #
# # # # # ####### # # # # ####### ### ###
# # #.#  . . . . .#   #  . . .  #   #   #
### # ########### ####### ### # ### # # #
#   #.  #         #     #.#. .# # # # # #
# ### ### ############# # # # ### # ### #
# #  . .#     #       #. .#.# #   # #   #
# ### # ##### ####### # ### # # ##### ###
# #   #. .  #       #  .  #.# #       # #
# # ##### ##### ####### ### # ######### #
# #     #. .#     #   #.#. .#           #
# ##### # # # ##### # # # ###############
# #   # # #.# #     # #.#. . . .  #. . . 
# # # # # # # # ##### # ####### ### #####
# # # # # #.# #. .  # #. . .# #. . .    #
# # # # # # ### # # # ##### # # ####### #
# # #   # #. . .#.# #     #.# # #   #   #
# ####### # # ### # ####### # ### # #####
#     #   # #   #.#     #. .# #   #     #
# # ### ### ### # ##### # ### # ####### #
# #   #   #   # #.#. .# #. .#   #       #
# # # ### ### # # # # ##### ##### ### # #
# # #   #   # # #. .#. . . .        # # #
# ### # # # # ### ############### # # ###
#   # # # # #   #               # # #   #
# # ### # # # # ############# # ### ### #
# #   # # # # # #         #   # #   #   #
# ### ### # ### # ### ### # ### # #######
# #   #   #   #     # # # # #   # #     #
### ### # ### ####### # # # # ### # ### #
#   #   #   #   # #   #   # #   # # # # #
# ### ##### ### # # ####### ### ### # # #
# # #     #   # # # #         #     # # #
# # ##### ### # # # ################# # #
# # #       # #   #             #     # #
# # # ### # # ####### ####### ### ### # #
#   # #   # #       #       #     #   # #
#########################################
