##################### ############# #####
#   #   #     #     #.#    . . .#  . .  #
### ### # # # # ### # ##### ### # ### ###
#   #   # # #   # #  . . . .# #.#   #. .#
# ### ##### ### # ########### # ####### #
# #   #     # # # # #     #   #.#. . . .#
# ### ### # # # # # # ### # ### # ##### #
#       # # #   # #     # #. .#.#. .#   #
####### # # ##### ##### # # # # # # #####
#         # #   #   # # # #.#. .# #. . .#
### ##### # ### ### # # ### ########### #
#   #     #     # # #     #. . .#. . .#.#
# ### ### ####### # ##### ##### # ### # #
# #   #   #   #   #     #     #.#.# #.#.#
# # # ##### # # ####### ##### # # # # # #
# # #       #   #     #     #  . .#  . .#
# ################### ##### ### ##### # #
#     #               #         #     # #
##### ########### ### ### ####### ##### #
#   #   #       #   # #   #       #     #
# ##### # ##### ##### # ##### ##### # # #
#       # # # #       #   #   # #   # # #
# ####### # # # ##### ### # ### # # # # #
# #       #     #   #   # # #   # # # # #
# # # ####### # ### ### ### # ### # ### #
# # #   #   # # #   #       # #   #   # #
### ### ### # # # ##### ##### # ### # ###
#   # #   #   # #       #     #   # #   #
# ### # # ##### ##### ### ####### # ### #
# #   # #     # #     #           # # # #
# # ##### ##### # ##### ########### # # #
# # #       #   # #     #     #   #   # #
# # # ### ### ### # # ### ### # ####### #
#   #   #   # #   # # #     #       #   #
##### # ### # # ##### ############# ### #
#   # #   # # #   #   #   #       #     #
# # ##### ### ##### # # ### ######### # #
# #     # #     #   # # #   #       # # #
# ##### ### ##### ### # # ### ##### ### #
#     #     #     #   #       #         #
#########################################
