####################################### #
#                   #         #    . . .#
### ####### ### ### ### ####### ### ### #
#   #       #   # #           #   #.#   #
# ### ######### # ########### ##### # # #
#   # # #       #   #        . . . .# # #
### # # # # ##### # ### ##### ##### # # #
# # # #   # #   # # #   #. . .#     # # #
# # # ##### # # # # # ### # ######### ###
#   #     # # #   # # #  .# #. . . .#   #
##### ### # ### ##### # # ### ##### ### #
#   #   # #   #       # #. .#. .# #. .# #
# ####### # # ### ##### # # ### # ### # #
# #       # #   # #     # #. .#. .# #.# #
# ##### # # # # # # ### # # # ### # # ###
#       # # # # # # #   # # #.  #. .#. . 
### ####### # # # # ##### # # # ### #####
#   #       # # # # #     # #.#   #.#   #
# ### ##### # # ### # ####### ### # ### #
# #   # #   # # #   #       #. .# #. .# #
# # # # # ### # # ######### # # ##### # #
# # # #   #   # # #     # # # #. . . .# #
# # ####### ### # # ### # # # # ####### #
# # #   #   #   #     # #   # #   #   # #
### # # # ### # # # ### ##### ### # # # #
#   # #   #   # # #   #     #   #   #   #
# ### # ####### # ### ##### ### #########
#   # # #       #   #     #   #         #
### # ### ### ##### ##### # ######### # #
#   # #   #   #     #     #     #   # # #
# # # # ####### # ### ############# # # #
# # # #       # # #   #   #         # # #
# # # ####### ### ##### # # ######### # #
# # #       #   #       #     #       # #
# # ##### # ### ### ########### ### # # #
# # #   # #   #   #       #     #   # # #
# # # # # ### ### ######### ##### ##### #
# # # # #   # # #     #     # #     #   #
# # ### # ### # ##### # ##### ##### # ###
# #     #   #   #     #     #       #   #
#########################################
