############################### #########
#             #                .        #
# # ### ##### ### ##### ####### # #######
# #   #   # #     #     #      .#       #
# # # ### # ### # # ##### ##### ####### #
# # #   # #   # # # #     #   #. .#     #
# ### # # ### ### # ##### # ### # # ### #
#   # # #   #   # #   #   #     #.# #   #
### ### ### ### ##### # ######### # #####
# #   #   #   #       # #   #. . .#     #
# ### ### # # ######### # ### ######### #
#   #   # # # # #       #   #. .#       #
### ##### # # # # ######### # # #########
# #   #   # #   #           # #. . .#. .#
# ### # # # # ### ########### ##### # # #
# # # # # # #   # #         #     #. .#.#
# # # # # # ##### # ############# ##### #
# #     # #     # #        . . .#     #.#
# ### # # ##### # # # ##### ### ####### #
# #   # #   #   # # # #    . .#. . . . .#
# ##### ##### # # ### # ### # ##### # # #
# #     #     # # #   # #   #.#   # # # #
# # ##### ### ### # ### ##### ### ### # #
# # #     # # #   #   #   #  . .#   # # #
# # # # ### # # ####### # ### # ### # # #
#   # # #   # #   #   # #   # #. .#   # #
####### # ### # # # # ### # ### # ##### #
#       # #   # # # #   # #   # #. .  # #
# ### ### # ### # # ### ### # ##### ### #
# # # # # # #   # # # #   # #   # #.#   #
# # ### # # # ### # # ### ##### # # # ###
#   # # #   #   # # #         #   #.#   #
# ### # ######### # ######### ##### #####
# #   #   #       # #     # # #  . .#. . 
# # ##### ### # ##### ### # # # # ### ###
# # # #       # #   #   # # # # #. .#.# #
# # # # ######### # ##### # # # # # # # #
# #   #   #       #     #     # # #. .# #
# ### ##### ########### ### ### # ##### #
#   #       #                   #       #
#########################################
