################### #####################
#         #        .      #             #
# ### # # ### ##### ##### # ####### ### #
# #   # #     #. . .    #         # # # #
### ### ####### # # ### # ######### # # #
#   #   #. . . .# #   # #     #   # # # #
# ### ### # # ####### # ##### # # # # # #
# #   #  .# # #       #     #   # # # # #
### ### # ### # # ####### ####### # # # #
#   #   #. .# # # #     #     # # # #   #
# ######### # # # # ####### # # # # #####
#   #. . .#.# # # #       # # #   #   # #
### # ### # # # ######### # # ##### # # #
#   #.# #.#.# #         # # #   #   #   #
# ### # # # ##### ####### ##### ### ### #
# #  .#  . .#   #     #   #     #     # #
# # # ##### # ### ### # ### ##### ### ###
# # #. .#   #     #   # #   #       #   #
### ### ############### # ####### # ### #
#   # #. . . .          # #   #   # #   #
# ### # ##### ########### ### # ##### # #
# #   # #   #.#. . .    #   # # #     # #
# # ### # # # # ### ### ### # # # # ### #
# #   #   # #. .  #.  #   # # # # # #   #
# ### ##### ####### # # # # # # # # #####
#     #   # #   #. .# # # # #   # #     #
######### # ### # ### # # # ##### ##### #
# #     # #     #.#   # # #     # #     #
# # ### # ####### # ##### ##### # # ### #
# # # #  . .#  . .# #         # # # #   #
# # # ### # ### ### ### # ##### # # #####
#   #  . .#. .#.#   #   #   #   # #     #
####### ##### # # ### ##### # ######### #
 . . . .#    . .# #   #   # # #     #   #
############# # # # # ### # # # ### # # #
#       #     # # # #   #   #   # # # # #
# ####### ##### # # ### ######### # #####
# #     # #     # #   #       #   # #   #
# # ### # # # ### ####### ##### ### # # #
#   #     # #   #       #         #   # #
#########################################
