##### ########################### #######
#   #.#     #   # #     #   #    .  #   #
# # # ##### # # # # ##### # # ### # # # #
# # #.#. . .# #   #       # #   #.# # # #
# ### # ### # ### ####### ####### # ### #
#    . .# #.# # #       #      . .#     #
######### # # # ####### ####### #########
# # #   # #.#   # #   #        . . . . .#
# # ### # # ##### # ############# ##### #
# #   # #  . . . .#        . . .#     #.#
# ### # ######### ######### ### ####### #
#   # #         #.#    . . .# #. .#  . .#
### # ######### # ##### ##### ### ### # #
# #       #   #  . . .#. .#   #. .#. .# #
# ####### ### ####### ### # ### ### #####
#     #       #   # #. . .#. . .#  . . .#
# ##### ####### # # ####### ####### ### #
# # #   # #     # # #. . . .#. . .#   #.#
# # # ### # ##### # # ####### ### ##### #
# #   # # # #     # #.# #  . .# #.#  . .#
# ### # # # ####### # # # # # # # ### # #
#   #     #   #. . .#. .# #.# # #. . .# #
### ##### ### # ### ### ### # # ##### # #
# #     # # #  .# #. .#. .#.# # # #   # #
# ##### # # ### # ### ### # ### # # ### #
#     # #     #. .# #. . .#. .# #   #   #
# ### # ##### ### # ######### # ##### # #
#   # #          . .#      . .# #   # # #
### # ############# ####### ### # # ### #
#   # #            . . . . .#   # #     #
# ### ### ### ### ####### # # ### # ### #
# # # #   #   #     #     # #     # #   #
# # ### ### ### ### # ##### ##### # # ###
#       #   #   #   #     # #   # # # # #
##### ####### ### ####### # # # ### # # #
#     #       #   #     # # # #     # # #
####### ######### ### # # # # ####### # #
#       # #       #   # # # #   #     # #
# ####### # ####### ### ### ### # # ### #
#         #       #   #     #   # #     #
#########################################
