##################### ###################
#     #              . . . . .          #
##### # # ####### # # # ##### ######### #
#     # # #       # # #     #. .#. . .# #
# ### ### # ####### # ######### # ### ###
#   #     # #     # #     #   #. .  #. .#
# # ####### ##### # # # ### # # ##### # #
# # #     #     #   # #   # # # #. .# #.#
# # # ### # # # ######### ### # # # ### #
# #     # # # #         #     # #.#. . .#
# ### ### # ##### # ### # ####### ##### #
#   #   # # #   # # #   # #    . .#. .# #
# # ### ### # # # # ####### ### ### # # #
# #   #   # # # # #       # #  . . .#.# #
# ### ### # ### ##### ### # ######### ###
#   # #   #   #   #   #   # #   #   #. .#
### # # ##### ### # # # ### # # ### # # #
# # # #     #   # # # # # #   #     # #.#
# # # ##### # ### # ### # # # ######### #
# # #     # #     #   #   # #   #  . . .#
# # # ### # ##### # ### ### ##### # #####
# # #   # #     # #   #   # #     #. . .#
# # ##### ##### ##### ##### ### # # # # #
#   #     #   #     # #     #   # # # #.#
##### ##### ####### # # ##### ### # ### #
# #       # #   # # # #     #   # #   #. 
# # # ### # # ### # # ##### ### ##### ###
# # #   # # # # #   #     # #   #   # # #
# # ##### # # # ##### ### ### # ### # # #
#   # #   # # #       #   #   # # # #   #
##### ##### # ######### ### ### # # #####
#   # #     #   #       #     #   # #   #
# ### # ####### ### ####### # ##### ### #
#     #     #       #   #   #           #
# ######### ##### # # # # ### # #########
# #     # #   #   # # # #   # #         #
# ### # # ### # ### # # ### # ####### ###
#     #     #   #   # #   # #   #   #   #
########### ##### ### ##### ### # # ### #
#                 #         #   # #     #
#########################################
