# #######################################
#. . .          #           #   # #     #
# # # ### ##### # ########### # # # ### #
# # #.  # #   # # #       #   #   #   # #
# ### # # ### # # ####### # ##### ##### #
#   #.# #   #   #       # # #   #     # #
### # ##### ##### ##### # ### # ##### # #
# # #. . .#     # #   # #     # # #   # #
# # ##### ### ### # ### ####### # # ### #
# #   #. .  # #   # #         #   # #   #
# ### # ##### # ### # # ######### # # ###
#. .# #.#     # #   # #   #   #   # #. . 
# # ### # ### # # ### ### # # # ### # ###
#.#. . .# #   # #. .#   # # #   #   #.# #
# ####### # ### # # ### ### ##### ### # #
#. .#   # # #   #.#. .#   # # #. . . .  #
# # ### # ### ### ### ##### # # #########
# #. .#   #   #. .#. .#. . .#. .#       #
# ### ##### ### ### ### ### # ### ### ###
#   #.    #. . .  #. . .  #. .  # # #   #
# # # ##### ################# ### # ### #
# # #.  #. .#   #           #     # #   #
### # # # ##### # ######### ####### # ###
#   #.# #.#. . .# #     # #     #   # # #
# ### ### # ### # # ### # ### ### ### # #
# # #.#. .#.#  .# #   #   # #   # #   # #
# # # # ### ### # ####### # # # # ### # #
# # #.#.#  . .#.# #         # # #     # #
# # # # ##### # # # ########### ####### #
# # #.#. . . .#. .# #         #         #
# # # ########### # # ####### # #########
#   #.  #. .    #.  #   #   # #       # #
##### ### # ##### ### # # ### ####### # #
#   #. . .#.#. . .#   # #     #     # # #
# ### # ### # ### # ### ####### ### ### #
# #   # # #. .  # # # #       # # #   # #
# # # # # ### # ### # ####### # # ### # #
#   # # #   # #   #     #     #   # # # #
##### # ### # ### ### ########### # # # #
#     #     #   #                   #   #
#########################################
