########### ##### #######################
#    . .#  .    #.# #   # #   #       # #
##### # # # ### # # ### # # ### ##### # #
#. . .#.# #. .# #.  #       #   #   #   #
# ##### # ### ### ######### # ### # #####
#.#. . .# #. .#. .#     #   # # # #   # #
# # ####### ### ### ##### ### # # # # # #
#.#.#    . .#. .  # #         # # # #   #
# # ##### ### ##### # ######### # # #####
#.#.#. . .#. .  #   #             #     #
# # # # # # ##### ### ################# #
#.#. .# # #.      #   #       #   #   # #
# ####### # ####### ### ##### # ### # # #
#. .#. .# #.#     # #   #     # #   # # #
### # # ### # ### # # ######### # ##### #
#. .#.#. .#.# # #   # #   #       #     #
# ### ### # # # ##### # # # ### ##### ###
#.#. .  #. .  #         #   # #     # # #
# # ### ### ### ##### ####### # # # # # #
#. .  #   # #   #   #     # # # # # # # #
# ### ### ### ##### # # # # # ### ##### #
# #   # #           # # # # #   #       #
# ##### ############# # ### ### # # #####
#           #   #   # #   # # # # # #   #
##### # ### # # # # # # # # # # ### # # #
#   # #   #   # # #   # #     #   #   # #
# # ### # # ### ######### ####### # ### #
# #     # #   #         #       # # #   #
# ##### # ####### ##### ### # ### # #####
# #   # #       #     #   # #     # #   #
# ### ##### ### ##### # # ######### # # #
#   #     #   #   # # # #         # # # #
### ##### ##### # # # # ######### ### # #
#       #   #   # # # #         #     # #
# # ####### # ### # ##### ##### ####### #
# #     # #   #   #     #     #       # #
# ##### # # ########### ##### # ####### #
#     # #   #         # #   # # #     # #
# ##### ##### ### ##### ### # ####### # #
#     #         #           #       #   #
#########################################
