########################### #############
#                        . .            #
# ########### ######### # ### ######### #
# #     #   #   #       #. .#         # #
# ##### # ### # # # # ### # ### ##### ###
#       #     # # # # #   #.  #     #   #
############### # # ### ### # ##### # # #
#     #     #   # # #   #  .#   #   # # #
# ### # ### # ##### # ##### ### ##### # #
# #     #     #     #     #.  #     # # #
############# # # ####### # ####### # # #
# #           # #     #   #. .#     # # #
# # ########### # ### ####### ######### #
# # #           #   #       #. . .  #   #
# # ### ####### # # # ##### # ### # # # #
#   #   # #     # # # #   # #   #.# # # #
##### # # # ####### # ### # ### # # # ###
#     # #   # #     #     #   # #.# #   #
##### # ##### # ########### ### # ##### #
#     # #   # # #           #   #. .  # #
# ### # ### # # # ########### ##### # # #
# #   #     # # # #       #   #. . .# # #
# ########### # ### ####### ### # ### # #
#             # #   #       #. .# #   # #
# ####### # ### # ##### ##### ### # ### #
#       # # #   #       #    .#   # #   #
####### # ### # ####### # ### # ### #####
#     # #   # # #   #   # #. .# # # #   #
# ### # ##### # # ### ### # ### # # ### #
# #   #   #   # # #   #   #.#   # #     #
# ### ### # ##### # ### ### ##### #######
#   #     # #   #   #   #  . . .  #     #
# # ####### ### ##### # ####### ####### #
# # #       #   # #   # #     #.    #   #
### # # ####### # # ### # ##### ### # ###
#   # #     # # # #   #   #  . .# #   # #
# ########### # # ##### ### # # # ##### #
# # #   #       #     #   # #.#   #. . .#
# # # ### ######### # ##### # ##### ### #
# #                 #       #. . . .  #.#
####################################### #
