####### #################################
# #  . .  #. .    #     #         #     #
# # # # ### # # ### # # ####### ### ### #
#   #.# #. .#.#     # #     #   #   #   #
##### # # ### ####### ##### # ### #######
#    .# #.# #.  #   #   # # # #   # #   #
# ### # # # # # ### # # # # # # ### # ###
#   #.# #.# #.#     # # #   # #       # #
# # # ### # # ####### # ##### # ####### #
# # #.#. .  #.    #   #               # #
### # # ##### ### # ####### ### ### # # #
#   #.#.#. .#. .# # #     # # #   # #   #
# ### # # # # # # # # ### # # # # ### ###
# # #. .#.#.# #.# #   # # # # # #   # # #
# # # ### # ### # ##### # ### # ### # # #
# # # #. .#.#. .#       #   # #   # #   #
# # # # ### # ####### ##### # ### # #####
#   # #.#  . .#   #   # #   #   # #     #
####### ##### # ### # # # ### ### ##### #
 . . .#. .#   # #   #   #     # #   #   #
##### # # ##### # ############# # ### ###
# #. .# #. . .#   #   #         # #   # #
# # ### ##### ####### # ######### # ### #
# #.# #     #. .    # #     #     #     #
# # # ##### ### ### # ##### ### # #######
#  . . . .#   #.  #       #     # #   # #
######### ##### # ################### # #
# #     #. . . .# #   #             #   #
# # ### ####### # # # # ### ##### ##### #
# #   # #   #   #   #   #     #   #     #
# ### # # # # # # ####### # # # # # #####
#     #   # # # # #     # # # # # # #   #
##### ####### # # # ##### ### # # # ### #
#   #         # # # #     #   # # # #   #
# # # ####### ### # # ### # ### ### # ###
# # # #       #   # #   # # #   #     # #
# # ### ####### ### # # ### ### # ##### #
# # #   # #     #   # #   #   #     #   #
# ### # # # # ### ### ####### ####### # #
#     # #   #       #       #         # #
#########################################
