########### #############################
#. . .#    . . . . .                    #
# ### # ########### # ######### #########
#.#  .#     #. . . .#         #         #
# ### ####### ### # ##### # # ####### # #
#. .#. . . . .#   #     # # #     # # # #
### ##### ##### ####### ### ####### # # #
#. .#     #   # #   #   #       #   # # #
# # ######### ### # # ### # ### # ##### #
#.# #. . .  #   # #   #   #   # # #     #
# ### ### # ### ####### # ### # # # #####
#. . .  #.# # #     #   #   # # #   #   #
### ##### # # ##### # # # # # ######### #
 .# #. . .# #   # #   # # # # #         #
# ### # # # ### # ### # # # # # #########
#.#. .# # #     #     # # # #     #     #
# # ### # # ########### # # # # ### ### #
#. .#   # #   #         # # # #   # #   #
### ##### ##### ########### # ### ### ###
#   #     #     #       #   #   #     # #
# ### ### # ####### ### # # # ######### #
# #   #   # #       #     # #           #
# # ####### ### # ####### # # # #########
# # # #     #   # #     # # # #         #
# # # # ##### ##### ### # # ####### # ###
# # #   #     #     # #   #       # #   #
# # ##### ### # ##### # ######### ##### #
# #     # #   # #     # #     # #   # # #
# # # # ### # ### # ##### ##### ### # # #
# # # #   # # #   #     #     # # #   # #
# ### ### ##### ##### # ##### # # ##### #
#   #   #           # #     # # #       #
# # # # ############# ##### # # # ##### #
# # # #         #   #   # # #     #   # #
### # # ##### ##### ### # # ### ### # # #
#   # # #   #     #     # #   # #   # # #
# ### ### ### # # ##### # ### ### ### # #
# #   #   #   # # #   # #     #   #   # #
# ##### ### ##### # # # ##### # ####### #
#       #   #     # #   #     #         #
#########################################
