################# #######################
#     #          .      #       #       #
# ### # # ##### # ##### # ### # # # #####
# # # # # #     #. .  # # # # # # #     #
# # # ### ##### ### # # # # # ### ##### #
# # #     #     # #.# #   # #     #   # #
# # ####### ##### # ####### ### ##### ###
#   #   #     #   #. . . . .  #     #   #
##### ### # # # ########### # ##### ### #
#     #   # # #       #. . .#     #     #
# ##### ### # ####### # ######### #######
#     # #   #         #. . .    #     # #
##### # ######### ##### # # ### # ### # #
#     # #       #   #   # #.#   #   #   #
# ### ### ##### ##### # # # ##### # #####
# # #     #     #     # # #. .  # #   # #
# # ######### ### ### ### # # # ### # # #
# #         #     # # #   # #.#   # #   #
# # ####### ##### # # # ##### ### # #####
# # #     #     # #   # #  . .  # #     #
# # # ### ##### ####### # # # # # # #####
# # # # #     #   #     # #.# # # #     #
# # # # ######### ### ##### # # # ##### #
# # #     # #   #     #  . .# # #   # # #
# ####### # # ########### # # ##### # # #
# #     # #            . .# #     #   # #
# # ### # ############# ####### # # ### #
# # #   #      . .#  . .#     # # # #   #
# # # ######### # ### # # ### ### ### # #
# # #   #  . . .#. .#.# # #       #   # #
# # ##### # ####### # # # ####### # ### #
# #       #.#      . .# #   #   # #   # #
# ######### ########### ### # # ##### # #
# #        . . . . .#   # # # #     # # #
### ##### # # ##### ##### # ####### # # #
#   #     # #     #. . .  #       # # # #
# ######### ######### # ####### ### # # #
# #       #   #     # #. . .  #   # # # #
# # ### # # ### ### # ##### # ##### # ###
#   #   # #     #   #     #.#       #   #
########################### #############
