# #######################################
#. .  #. .            #   #     #       #
# # ### # ### ### ##### # # # ### ##### #
# #. . .#.  #   #       # # # #   # # # #
# # ##### ### ########### ### # ### # # #
# # #   #. .#           #     #   # # # #
# # # # # # ### ################### # # #
# # # # # #.  # #               #     # #
# # ### # # ### # ######### ### # ##### #
# #     # #.#   #. . . .  # # # # #   # #
# ####### # # ### ##### # # # # # # # # #
#       # #.# #. .#. . .# # # # # # #   #
# # # ### # # # ### ##### # # # # ### # #
# # #   # #.# #.# #. . .# # #   #     # #
# ### # # # # # # ##### # # ########### #
#   # # # #.# #. . .# #.# #     #   # # #
### ### # # ####### # # ### ### ### # # #
#   #   # #. . .  #.  #. .#   #     # # #
# ### # # ### # # # ##### ### ####### # #
# #   # #   # #.# #.#   #.  #         # #
# # ##### # # # ### # ### # # ######### #
# # #   # # # #.#. .  #. .# #   #       #
# # ### # # # # # ##### ### # # # #######
# #   # # # # #. .#. . .#   # # # #. .  #
# ### # ### # ##### ##### ##### # # # ###
#   # #     #   #. .#     #   # # #.#. . 
# # # ######### # # ######### # # # #####
# # #         # #.# #. . .  #   #. .    #
# # ######### # # ### ### ####### #######
# # #       # # #. . .  #. . . . .#     #
# # # ##### # # # ####### ### ######### #
# #   #     # # # #     #   #           #
############### # ##### ### #############
#               #         #         #   #
# ######### ### # ####### ### ##### # ###
# #         #   # #   #   #   #     #   #
# # # ####### ### ### ##### ### ##### # #
# # # # #   # # #     #     #   # #   # #
# # ### # ### # ####### ######### # #####
# #     #     #                         #
#########################################
