############### #########################
#         #    .  #. . . . . .    #. .  #
# # ##### # ### ### ##### ### ##### # ###
# # #   #   #  .#. .#   #   #. . . .#. .#
### # # ####### # ### # ### ### ####### #
#   # #      . .#.#   #   #   #   #   #.#
# ### ####### # # # ### ##### ### # ### #
# #   #  . . .# #.# #   #   #   #   #. .#
# # # # # ##### # ### ### # # ####### # #
# # # # #. .#   #.#       # #     #  .# #
# # ### ### # ### # ########### ### # ###
# #   # # #.# #. .  # #       # #   #. . 
# ### # # # ### ##### # ##### # # # # ###
#   # #   #. . .      # #   # # # # #   #
# # # ##### ######### # ### # # # # #####
# # #     # #       # #   #   # # # #   #
# # ##### # ### ##### ####### # # ### # #
# #     # #     #           #   # #   # #
# ##### # ####### ######### ### # # ### #
#     # # #   # #   #     # #   # #   # #
# ##### # # ### # # # ### # ##### ##### #
#     # #   #   # # # # # #     #       #
# # ### ##### ### # # # # ##### # #######
# #   #   #     # # #   #     # #   #   #
# ##### # # ##### # # ##### ### ### ### #
#     # #     # # #       # #     #     #
##### # # ##### # ####### ### # #########
#   # # #   #   # #     # #   #         #
# # # # ### # ### # ### # # # ######### #
# # # # #   # #   #   # # # #   #     # #
# ### # ##### # # ### # ### ##### ### # #
#     #     # # #     #   #         # # #
### # ##### # ### ####### # ########### #
#   #     # #   #   #   # #     # #   # #
####### # # ### ### # # # ##### # # # # #
#     # # #   # #   # # #     #   # # # #
# ### ### # # # # ##### # # ####### ### #
#   # #   # # # #   #   # #       #     #
### ### ### ### ### # ### ###############
#       #         #     #               #
#########################################
