############### ############# ###########
#      . .#  . .#. . .  #. . .#     #   #
# ##### # ### # # ### ### ##### # # # # #
# # #. .#. . .# #.  #. . .#     # #   # #
# # # ######### # ##### ### ##### ##### #
# # #.#. . . .# #.#   #     #   # #   # #
# # # # ##### # # # # ######### # # ### #
# # #.#. . .#.# #.  #         # # #     #
# # # ##### # ### ####### ### # # #######
#   #. . .#.#. . .      #   #   #       #
# ### # # # ### ####### ### ########### #
# # # # #. .  #   #   #   #     #   #   #
# # # # ##### ### # ### # # ### ### # ###
#   # #   # # # # # #   # #   # # # #   #
##### ### # # # # # # ### # # ### # ### #
#       # # # # # #   #   # # #   #   # #
# # # ### # # # # ########### # ##### # #
# # #   # #   #     #     #   #       # #
# # ### # ########### ### # ### #########
# # #   #               # #             #
# # ####### ############# # ### ####### #
# #       #           #   #   # #     # #
# ### ### # ##### ### # ##### ### # ### #
# #   #   # #   # #   # #   #     #   # #
# # ### ##### # # ##### ### # ####### # #
# #   #   #   # # #       # #       # # #
# ### ### # ### # # ##### # ####### # # #
#   #   #   #   # #   # # #       # # # #
### ### ######### ### # # ####### ### # #
# # # #       #     # #   #   # #     # #
# # # # ### # # ### # ####### # ####### #
# # # #   # # #   # #       #         # #
# # # ### # # ### # ### ### # ##### # # #
# #     # # #   # #   # #   #     # # # #
# ####### ##### # ### ### ### ##### ### #
#       #     # #   #   #   # #   #   # #
####### # ### # ####### ### # # # ##### #
#     # #   # #       #   # # # #     # #
# ### # ##### ####### ### ### ####### # #
#   #         #         #           #   #
#########################################
