######### ###############################
#   # #  . .    #   #                 # #
### # # # # # ### # # ####### ####### # #
#   #   # #.#     # #       #     #   # #
# ####### # ####### ### ##### # ### ### #
#         #. .    #     #   # #   # #   #
### ######### ### ####### # ####### # ###
# # #      . .#   #       #     #   # # #
# # # ##### # # # # ########### ##### # #
# # #   #. .# # # # # #       #     #   #
# # # # # ##### ### # # ######### # ### #
# # # # #. . .#   #. .  #. . .  # #     #
# # # # # ### ### # # ### ### # #########
#   # # # # #. .# #.#. . .  #.#   #     #
####### # # # # ### ######### ### ##### #
#       #   # #. . .  #. . . .  #     # #
### # # ### # # # # ### ####### ##### # #
#   # #   # # # # # #. .#. . .#     #   #
# ####### ### # # ### # # ### ##### # ###
# # #   # #   # # #. .# #. .#. . .# #   #
# # # # ### ### ### ### ### ##### # #####
# # # # #   # #   #.#   #  .# #. .#     #
# # # # # ### # # # # ##### # # ##### # #
# #   #   #   # # #.#     #.# #. .  # # #
# ####### # ##### # ##### # # ### # ### #
#       # # #     #. . .# #.#   #.#   # #
# # ### ### ### ##### # ### ### # ### # #
# #   #   # #   #   # #. . .#   #.#   # #
# # ##### # # ### # # ### ### ### # ### #
# #     #   # #   # #   #   # #  .# #   #
# # ######### # ####### ##### # # # # ###
# #         # #       #       # #.# #   #
# ######### # ### ####### ##### # ##### #
#     #   # #           # #   # #. . .# #
# ### ### # # ######### ### # # # ### ###
#   #   #   #     #   # #   # # #   #. . 
### # # ########### # # # ### # #########
#   # #   #         # #     # #       # #
# ####### # ######### ####### # ##### # #
#       #           # #       #     #   #
#########################################
