############################# ###########
#   # #     #     # #        .#. . . .  #
# ### # ### ##### # # ##### # # ##### ###
# # # # # # #     # #   #   #. .#   #. .#
# # # # # # # ##### ### # ### # ### # # #
# # # #   #   #   # # # # #   # #   # #.#
# # # ### ##### ### # # # ####### ##### #
#   #         #     # # #   #     #. . .#
# ########### # ##### # ### # ##### #####
#     #   # # # # #   # # #   #  . .#. .#
# ##### # # # # # # ### # # # # # ### # #
# #     # # #     #   #   # # # #.#. .#.#
# # ####### ##### ### ##### ### # # ### #
# #   #     #             # #   #.#.# #.#
# ### # ##### ########### # # ### # # # #
#   #     # #   #       # # # #  . .  #.#
### ##### # ### # ##### # ### # ####### #
# # #   # #   # # #   #       # #. . . .#
# # # # # ### # # # ########### # ##### #
#   # # # # #   # # #           #.# #   #
# ### # # # ##### # # ### ####### # # # #
#   # #           #   #     #   #.#   # #
### ######### # # ### # # # # ### #######
# #           # # #   # # # #   #.#. .  #
# ############# # ##### # # ### # # # # #
#               #     # # # #   #. .#.# #
### ### # ########### # # # # ### ### # #
#   #   # #         # # # #     # # #.# #
# # ##### # ### ### # # ####### # # # ###
# # #   # # #   # #   #     #   # # #. . 
# ### # ### ### # ######### # ### # # ###
#   # # #   #   #         # # #   # #   #
### # ### ### ######### # # # # # # #####
#   #     #           # #   # # # #     #
# # ######### ##### # # ##### # ####### #
# # # #     #     # # #   #   #     # # #
# # # # ### ##### ### # # ####### # # # #
# # # #   #   #   #   # #     # # #   # #
# ### ### ### ######### # ### # # ##### #
#       #   #           #   #   #       #
#########################################
