####################################### #
#   #              . . . . . .#     #  .#
# ### # # ######### ######### ##### # # #
# #   # # #    . . .#. .#    . . . .# #.#
# # ### # # ### ##### # ########### ### #
# #   # # # #. .#. . .#. .#. . . .#. . .#
# ### # ### # ### ####### # ##### #######
#     # #   #.#. .      #.#. . .#. . . . 
####### # ### # ####### # ##### #########
#       #   #. .      # #. .  #. . . .  #
# # ### # # ######### ### # ######### ###
# #   # # #         #   # #. .#. . . .  #
# ### # ####### # # ### ##### # ####### #
#   # # #     # # #   #     #. .#     # #
##### # # ### ### ### # ### ##### ##### #
#   # # # # #       # # #   #       #   #
# # # # # # # ### # # ### # # ####### ###
# #   # # #   #   # #   # # # #   #   # #
### ### # ##### ### ### # ### # # # # # #
#   #   # #     #     # #       # # # # #
# ### ### # # ####### # ######### # ### #
#   # #   # # #     # #         # #     #
### # # ### ### ### # # # ### # # ### ###
#   # # # #   #   # # # # #   # #   # # #
##### # # ### ### # # # ### # ##### # # #
#     #   # #   # # # #   # # #     #   #
# ### ##### ### # # # ### # ### # #######
# #   #       #   # #   # #   # # #     #
# ##### ### ########### ##### # ####### #
#       # #   #   #   # #   # #       # #
# # ##### # ### # # # # # ### ### ##### #
# #   # # #     #   # #   #   # #       #
# ### # # ########### ##### # # # #######
#   #   #     # #   # #     #   #   #   #
# # ######### # # # # # ########### # ###
# #       #     # # # # #   #     # #   #
# # # ### # ##### ### ### # ##### # ### #
# # #   # # #   #   # #   #     # #   # #
# ##### ### # # ### # # ######### # ### #
#     #       #     #             #     #
#########################################
