############### #########################
#         #    . . . .#. .  #. . . .    #
# ####### # ##### ### # # # # ##### #####
# #. . .# #     #   #. .#.# #.#. .#. . .#
# # ### # ##### ######### ### # # ### # #
# #. .#.#       #. . . .#. . .#.#. .# #.#
# # # # ######### ##### # ##### ### ### #
# # #.#. .#. . . .# #. .# #. . .#  . .#.#
# ### ### # ####### # ### # ######### # #
#   #.# #.#.#     #. .#   #.#        . .#
### # # # # # ### # ### ### ########### #
# # #.# #. .#   # #. .# #. .#   #       #
# ### # # # ##### ### ### ### # # ##### #
#    .# # # #   #    . . .# # #   #     #
##### # # # # # ######### # # ### # #####
 . . .# # # # #   #       #   #   # #   #
##### # # # # ### ### ##### # ##### ### #
#   # #   # # #       #     # #     #   #
# # ####### # ############### # ##### ###
# #       # #   #   #       # # #       #
# ####### # # # # ### ##### # # # #######
#   #       # # # #   #       #         #
# # # ####### # # # ######### # # ##### #
# # # #     # # # # #     # # # # #   # #
# # ### ### # # # # # ### # # # # # ### #
# # #   #     # #   # # # #   # #   #   #
### # ######### ### # # # ##### ##### # #
# # #       #     # # #           #   # #
# # ### ### # # # ### ######### ### # # #
#     #   # # # #   #   #   #   #   # # #
##### ##### ### ### ### ### # ### ##### #
#   #   #   #     #   #   #   # # #     #
# # ### # ######### # ### ##### # # #####
# # # # # #   #     #   #       # # #   #
# # # # # # ### # ##### ######### ### # #
# #   # #     # # #     #       #     # #
# ##### # ##### # # ##### ##### ##### # #
#       # #   # # #       #   #     # # #
####### # ### # ########### # ##### ### #
#       #     #             #     # #   #
#########################################
