######################### ###############
#    . . . . . . .# #   #. .            #
# ### ########### # # ### # ##### ### ###
# # #.#   #     #.# #     #.    #   #   #
# # # # # # ##### # ####### ### # ##### #
#   #.# # #. . . .#    . . .#   #   #   #
##### # ### ########### ##### ##### # ###
#. . .#   #. . .#      .#     #     #   #
# ### ### ##### ####### ######### # #####
#.#   # # #    . . . .#. .  #     # #   #
# ##### # ########### ### # # ##### # # #
#. . . .#           #. . .# # #     # # #
# # # # ########### ##### # # ####### ###
# # # #. . .      #   #   # #         # #
# # ####### ######### # ### ########### #
# #       #.#. . .  #   #   #   #. . . . 
# ####### # # ### ####### # ### # #######
#       # #. .  #. . .  # # #   #.# #   #
### ### # ### # ##### # # # # ### # # # #
# #   # #   # # #   #.# # # # # #. .# # #
# # ### # # # ### ### ### ### # ### # # #
#   #   # # #   # #. .#   #   #. . .# # #
##### ##### ### # # # # ### ### ####### #
#     #       #   #.# #     #  .#   #   #
# ### # # # ####### # ######### ### # ###
# # # # # #     #  .#         #.    # # #
# # # # # ##### # # ######### # ##### # #
# #   # #   # # # #. . . . .# #.#       #
# ##### # # # # # ##### ### ### # #######
#     # # # #   #     #   #. . .  #   # #
# ##### # # ######### ### ### ##### # # #
#   #   # #     #   #   #   # #     # # #
# ### ### ##### # ### # ### ### ### ### #
#   # # #     # #     #   # #   # # #   #
### # # ##### # ### # ### # # ### # # ###
# # # #     # #   # #   # #     #   # # #
# # ### ##### # # # ##### ########### # #
# #       #   # # # #   #         #   # #
# ######### ### # ### # ########### ### #
#           #   #     #                 #
#########################################
