############################### #########
#   # #   #         #          . .      #
# # # # # # ####### # ########### ##### #
# # #   # # #   #     #  . . . .#.#     #
# # # ### # ### # ####### ##### # # #####
# # # #   #   #   #  . . .# #. .#.# #. .#
# ### ####### ##### # ##### # ### ### # #
#   # #     # #     #.#   # #.#. .#. .#.#
### # ##### # # ##### # # # # # # # ### #
 . . .#. .#   # #. . .# # #. .#.# #.# #.#
##### # # ####### ### # # # ### ### # # #
#    . .#.#    . .#   # #  .#  . . .  #.#
# ####### ##### ####### ### ##### ##### #
# #     #. . .#.#       # #. . .#   #. .#
### ### ##### # ######### ##### ##### # #
#   #   #. . .#. .      #   # #. . . .# #
# ##### # ####### ### # ### # ##### # # #
# #      . . .#. .  # #   # # #     # # #
# # ######### # # # ####### # # ##### # #
# # #     #  . .# #   #     #   #     # #
# # ##### # ######### # ######### ##### #
# #   #   # # #     # #   #       #     #
# ##### ### # # ### # ### # ### ### ### #
#     # #   # # #     #   # #   # # # # #
##### # # ### # # ####### ### ### # # # #
#   #   #     # # #           # # #   # #
### ########### # # ########### # ##### #
# #             # # #                   #
# ### ### ##### ### # ### ### ##### ### #
#     #   #     # # # #   #   #   # #   #
####### ### ##### ### # # ####### # # # #
# #     #   #     #   # # #       # # # #
# # ##### ### ##### ### # # ######### # #
# # #     # # #     #   # # #         # #
# # # ##### # # ### # ### # ### ##### # #
# # # #       # #   # # # # #   #     # #
# # # ##### ### # # # # # # # ######### #
# # #     # #   # # # #   # # # #   #   #
# ####### # ##### # # ##### # # # # # # #
#         #       # #     #   #   #   # #
#########################################
