############# ###########################
#  . . . . .#.            #             #
# # ####### # ##### ##### ############# #
# #. .#   #.#. .  #     #         #     #
# # # # # # # # # ##### ####### # # #####
# # #.# #  .# #.# #   #   #     # # #   #
# ### ##### ### # # # # # ######### # ###
#   #.#   #. . .#   # # #           #   #
### # # # ### ##### # ### ### ######### #
#   #.# #     #   # #   #   #           #
# ### # ####### # ##### ### # ### #######
# #. .#     #   # #       # #   #       #
# # ####### # ##### ##### # ### # ##### #
# #. .#     #       #   # # #   #     # #
# # # ################# ### # ######### #
# # #. . . . . . .    #     # #     #   #
# ########### # # ### ######### ### ### #
#   #       # # #. .#     #     # #   # #
# # # ##### # # ### ##### # ##### ### # #
# #     #   # #   #. .  #     #   #   # #
# # ##### ### ### ### # # ##### ### # # #
# # #   # #     # #. .# # #     #   # # #
# # # # ### # ### # # # # # ##### # ### #
# # # #     # #   #.# # #   #     #   # #
# # # ### ##### ### ### ##### ##### # # #
# # #   # #   # #  .#   #     #   # # # #
# ### # ### # # ### # ### ####### # ### #
# # # #   # #   #. .# #   #       #   # #
# # ### # # ##### # # # ### ##### ##### #
# #   # # # #. . .# # #   #   # # #     #
# ### ### # # ### # # ### ### # # ### # #
# #       # #. .# # #   # # # #       # #
# ##### # # # # ### # # # # # ###########
# #   # # # # #. .# # # #   # #         #
# # # ### # # # # # # # ##### # ####### #
# # #     # # # #.# # # #   # # #     # #
# ######### # ### # ### # ##### # ### # #
#   #       #   #.# #   #       # # # # #
### ####### ### # # # ##### ##### # # # #
#   #       #   #.# #             #   # #
################# #######################
