########### #############################
#    . .#. .    #               #       #
# ### # # ##### # ### ####### # # ##### #
#   #.#. .#   # # # # #     # # #     # #
##### # # # # # # # # # ### # ### ### # #
#. . .# # # # # #   #   # # #   #   # # #
# # ##### # # # # ####### # ### ### # ###
#.# #   # # #   # #       #   #     #   #
# # # ### # ##### # ####### # ##### ### #
#.# #   # # #       #     # # #   #   # #
# # ### # # # ####### ### # # ### ##### #
#.# #   # # # #         # # #   #   #   #
# # ### ### # # ######### # # ##### #####
#.#   #     # #. . . .#   # #     #     #
# ### ####### # ##### # # ####### ##### #
#.  # #     # #.#   #.# # #     #     # #
# # # ##### # # ### # # # # # # ##### # #
#.# #       #. .    #.# # # # #   # # # #
# ########### ####### # ### # ### # # # #
#.#. . .  #. .#. . . .#     #   # # #   #
# # ### ### ### ##### ########### # #####
#. .  #. . .  #.#     #. . .    #   #   #
# ########### # ####### ### ### ##### # #
#       #   # #. .  #. .#. .  #   # # # #
# ##### # # ### # ### ### ### # # # # # #
#   # #   #   # #. . .  #. .# # # #   # #
# # # ####### ### ##### ### ### ### #####
# # #   #   #   #     #   #. .#     #. . 
### ### # ##### ##### ##### # ####### ###
#   #   #         # #     # #. . .  #.# #
# ### ### ##### # # # ### ####### ### # #
#   #   # #   # #   # #   #     #. .#.# #
# # ### # # # # ####### ### ### # # # # #
# #     # # #     #   #     # # # #. .  #
# ####### # ### ### # # ##### # # #######
#       # #   # #   # #   #   # # #   # #
####### # ### # # ### ### # ### # # # # #
#   #   #   # # #   #   #   #   # # #   #
# # ####### # ### ##### ####### # ##### #
# #         #         # #       #       #
#########################################
