# #######################################
#.        # #. . .  #           # #     #
# ####### # # ### # # ### ##### # # ### #
#. . .  #   #.#. .# #. .#     #   # # # #
# # # ####### # ### # # ### ####### # # #
# # #. . . . .#.#   #.#.  #       # # # #
# ############# ##### # ##### ### # # # #
#       #     #. .  #.#. .#   #   #   # #
####### # ##### # ### ### ############# #
 . .# # # #. .# #. . .  #. . .          #
### # # # # # ##### ### ##### ####### ###
#  .# #   #.#. . .#   #     #.  #   #   #
### # ##### ##### ### ##### # # ### ### #
#  . . . .#. .#  . .# #. .# #.#     #   #
# ####### # # ##### ### # ### ###########
# #   #  .# #. . .#. . .#. . .#         #
### # ### ####### ####### # # ######### #
#   #    . . . .#.#     # # #         # #
# ############# # ##### # # ####### # # #
# #     #   #. .#.  #   # #       # # # #
### ### ### # ### # ### ### ##### # ### #
#   # #     #.#  .#   #   #     # #   # #
# ### ####### ### ### ### ##### # # # # #
#   #        . . .#   # #     # # # # # #
### ### ######### # # # ##### # # # # # #
# #     #         # # #   # # # # # #   #
# ####### ### ##### ##### # # ### # # ###
#     # #   #   #   #     #       # #   #
# ### # ####### ### # ########### # ### #
# # # #         #   #   #         # #   #
# # # ### ####### # ### ### ####### # # #
# # #   # #       # # #     #       # # #
# # ### # # ### ### # ####### ##### # ###
# # # #   # #   #   #         #   # #   #
### # ####### ### ### # ##### # # # ### #
#   #       # #   #   # #     # # #   # #
# ######### # # ##### # # ##### ####### #
#       #     # #     # # # #   #       #
####### ####### # ####### # # ####### # #
#               #       #   #         # #
#########################################
