####################################### #
#           #          . .#. . . . .#  .#
# # ####### ### ### ### # # ####### ### #
# # #     #     #     #.#. .#     #. . .#
# # ##### ######### # # # ### ### ### # #
# #     #         # # #.# #   # # #   # #
####### ### ##### ### # ### ### # # ### #
#   #   #   #         #.#   #   #   #   #
# # # ### ### ######### # ### # ##### ###
# # #   # #   #    . . .# #   # #       #
# ####### ##### ### ####### ### ####### #
#         #     #. .#       #     #     #
### # ##### ##### # ############# # ### #
#   # #     #    .#   # #     #     # # #
##### # ######### ### # # ### ####### # #
#   # # #  . . . .  # #   #   #     # # #
# # ### ### ### # # # ##### ### ### # # #
# #   # #. .# # # # #         #   #   # #
# ##### # ### # # ### ### ####### ##### #
#   #   #.#   # #   #   # #   # #     # #
### ### # # ### ### ### ### # # ##### # #
 .#     #.#     #     #     # #         #
# ####### ####### # # # # ### ####### # #
#. . .#  .  # #   # # # #   # #     # # #
##### ### # # # ##### # ### # # ### ### #
#    . .#.#   # # #   # #   # #   #   # #
####### # ##### # # # # ##### ####### # #
#      . .# #   #   # #   #         # # #
# ##### # # # # ##### ### ### ### # # # #
#   #   #   # # #     # #   #   # # #   #
# # ######### # # ##### ### ### # #######
# # #   #     # # #   #   #   # #       #
# # # # # # # # ### # ### # # # ### #####
# # # # # # # #   # # #   # # #   #   # #
### ### # # # # # ### # ##### ### # ### #
#   # #   # # # #       #       # #     #
# # # ####### # ######### ####### # #####
# # # #   #   #   #   #   #   #   # #   #
# ### # # # # ##### # ### # ### # # ### #
#     # #   # #     #     #     # #     #
#########################################
