---------------Q-Q--------------Q-----Q--------------Q--QX-----------------Q-----Q--Q----Q-----------Q-Q----------------
----Q-Q-Q-Q-QQ----Q-Q-Q-Q-Q-Q-Q--Q-QQ---Q-QQ-QQ-Q-Q---QQ--Q-Q-Q-QQ-Q-Q-Q-Q---Q-Q------QQ---QQ-Q-QQ-QQtQ--QQ-Q-Q-Q-Q-Q---
---------------Q-------------Q--------Q-------X-----Q-Q--------Q-----------Q-----Q-Q-Q---Q-Q------------Q-------Q--Q----
----Q-Q-Q-QQ-Q---Q-Q-Q-Q-Q-Q---QQQQ-Q---Q-Q-Q---Q-Q-----Q-Q-Q----Q-Q-Q-Q-Q---Q-Q-----QQ-Q---Q-Q-Q-Q-Q-Q--Q-Q-Q--Q-------
-----------X--Q-Q-------Q----Q--------Q--Q----QQ----QQ--Q---Q-Q-Q--QQtQ---Q--QQ--Q-Q---Q--Q--Q--------------------Q-----
---Q-Q-Q-Q--------Q-QQQQ--QQ---Q-Q-Q-Q-----Q-Q---Q-Q-X----QQX----Q--tQ--Q---Q---Q----Q---Q--Q-Q-QQ-Q-QQ-Q-Q-Q-Q-Q-------
---X-------Q-Q-Q----Q-Q--Q---Q---------Q-Q-Q---Q--Q---Q-Q---Q-QQ--Q-Q-----Q--Q-Q-Q-Q---Q-Q---Q----Q----------Q----Q-----
----Q-QQ-Q----QX-Q------Q--Q---Q-Q-Q-QQX-----Q------Q-----Q--Q-X------Q-QQ-------Q---QQ----Q---Q----Q-Q-Q-Q----Q-Q------
----Q------QQ-QX---Q-Q---Q-Q-Q-----Q-----Q-Q---Q-Q-Q--Q-Q--------Q-Q-Q--Q--Q-Q-Q---QQ-X-Q-Q--Q-Q-Q-Q--------Q-Q--Q-QQ---
-----Q-Q-QQ--QX--Q-----Q------Q-Q-Q--Q-Q-----Q---Q-Q--Q---Q-Q-QQ--Q-------Q------QQ--------Q---------QQQ-Q-Q-Q-----Q----
-----Q--------Q-Q--Q-Q---Q-Q---Q---Q-Q---Q-Q---Q-----Q-Q-------X--Q-Q-Q-QQ--Q-Q-Q---Q-Q-Q-Q--Q-Q-Q-QQ---QX-----Q-Q------
-M-----Q-Q-QQ-----Q----Q-----Q---QQ-Q--Q----Q-Q--Q-Q-----Q-Q-QQ-QQ---------Q------Q-------------Q---QQ-----Q-Q-----Q--F-
XXX-Q-Q--Q----Q-Q---Q-Q--Q-Q---Q--X---QX-Q-Q----QX--Q-Q--Q-------X-Q-Q-Q-Q--Q-Q-QQ--QQ-QQ-QQ-Q----Q----Q-Q-Q---Q-QQ---X-
XXXQtQtQQtQQQQtQtQQQtQtQQtQtQQQtQQtQQQQtQtQtQQQQQtQQtQtQQtQQQQQQQtQtQtQtQtQQtQtQQtQQQtQQtQQtQtQQQQtQQQQtQtQtQQQtQQtQQXXX