....................................................................................................
###.#..#.###.###...##.#.#.###...##..###.##....#.##..##..#.####.###...####...#..#...##.#.#.#...##.##.
.....#.....#...##.....#.....##....#...#..#..#.#...#...#.#..........#....##..#...#...#.#.#...#..#..#.
.##...####.#.......#..##..#..#.....#..#..##.....#..##.#.###.##..#...##...##.##..#...#....##.#..##...
....#....#.###..##.##......#.##.##.##..#...#..#.##..#.#.......#.###...#...#............#....#...###.
.##.#.#.......#.......####.#........#...#..##.......#......##.#.....#.##....#..#.##.#..###..#.....#.
..#...#..#.##.#####......#..#..##.#..#...#....#......#.###.....#..#.#..##...#.....#......#..####....
#.###..#..........####...##..#..#.##.#....#...#.####.......#.#..#.#......##.##.##..##.#..#..........
#...#..###.######......#.....##....#..###.#........##..#...#.##....###....#..#..##....##...##..####.
#...............######.##.#....##..##.......#.......#..##......#.#...##.#.##.#...##....###..........
##...#..#######.............#...##..#.#####..####.#..#...#####.#.##........#.##....#......##.#.##.#.
.#...##.......###.#...#.##..##...#..#.....#..........#.#.....#.#...######......#...#............#...
.##...#..#..#...#..##.#...#...##.##.##.##.##....#..#....#.#....###......#.##...#.#..##.#.#.##.#...#.
...#..#.....#.#..#..#.#.#.##.........#..#....##.##.##............####.#....#.#...#.....#.#.....#..#.
#...#.####....#...#.#...#..#....#..#.##.......#......##.............#.#..#.#.##....##..#.......##.#.
#.#.#....#......#...###.##..##..#......#....#.###.##..#......#...#..#.#....#..#..#.....#.###.#..#...
..#.##...###.#..##....#..##......###.#..#.#.#...#..##...#..#.###.##.#..##..##.#....###........#..##.
#.#..###...#.#...#..#..#..#.##..............###......##..#.#........#.........##.....#.#.##.#.......
#..#....##.#...#..#.##..#.....###...##.##.#.....#..#..##.#.#.#......###.#..#......#.......#.##.#.##.
##..###....##........#..#..##........#....##.#..#..##..#.#...#.#......#........#..#.#...#......#....
.......#.#....#.#.##.#...#...##..###.#.#...#.#..#....#.#.###....##..#.#.####.#........#.#.#......#..
#####..#....#...#..#...#.#.#..#.........##.#.#...#.....#...#.##...#........#.#####.##.....##.###.##.
........#...##..##..##........####.#..#..#.....#.#.#.#...#.#..###.##...##........#...##...........#.
..#.###.###..#...##..##.#####.......#..#..#..#.#.#.#...#.#.##.......#...##....#..###..##..#####.....
#.#..........#....##...........##......#..#..#...#..#....#.....####..##..##.........#.........#####.
...#...#.#.#.###....###.##...#..#..#...##.#...#..#..####.##.#......#..#......#..#.#..#.#..#.#.......
##...#.........###.......##..##..#.###....###..#.##....#..#..#.##..##.#.#....#..#..#.#.#..#..#.#.##.
..#..#..##...#....#.#.....##...#.#....##....##.........##.#......#..#....###.##.#..#......#....#..#.
..##.##..##...###...#......#.#.........#.##...#..##.##....#...##.#..##.#........#...#.###...#..#..#.
#..#..##..#.#...##....###..#....#.#.##.#...#...#.....#..#......#..#..#.#..#...#...#.#...###.##.#....
#..##..##...###..#..#......#.#..........#....#..#.#..##.###.....#..#.#.#........#.#.#.....#..#..#.#.
##..#.....#...##..#..####..#..#.#####.#.##.#.#..#..#......#..##..#.#....##..#.#.....##..#.##..#...#.
.##..##.#...#.....#.....##.#..#.......#..#...##.##.##.###.#...#..........#..#..#......#.#..#...##.#.
...#....##.....#..#.#.#....##....####..#.###..#.........#.##....###..###.##..#..#.......#..###......
#..###....###...#...#..##...##......##......#.#.######..#....#............#..##..###.....#....#..##.
#.......#....#...#...#..#.....#.###..####.#.#...........#.##..#..######.#..#..##....####..###..#....
#.#..##..##....#.#....#.#..#.......#....#......#.#..#...#..##..#........#.......#.#....#....#.......
#.#........#.#...#.##...##...##.##...##..###.#.#....#...#......#.##...#...##.#....###..####....####.
#.#######..#...#.#...##....#.....#.#..#......#..#.#.##..#...##....#.#.##...#.#.#..........#..#......
#........#..#....#.#..##...#........#.##.###.##...#..##.###...###.#.#..#.#...#.#....#.##.....##..##.
#.####.#..#..#.....#...###.###..###.#......#..##..##..#...###.....#..#...##..#..#.#.#..#####..##....
.......##..#.#.##...#.............#..####..##...#..##...#...#.##.....##......#.......#......#...##..
####....##.#.#...##.....###.#.##..#......#..#.#.##...#...##.#..####.....#....#..#.....#####...#.....
...####..#...###..#####...#.#.......##.#....#.#.......#...#.#.....####..#.#..#..##.##.....##..#.###.
#.....#..#.#....#......##...##.####....##.#.....#.##..#.#....####.......#.#...#..#..#..#....#.#...#.
.##.#.#..#.####..##.#...###..#....#.#...#.####..#.....#..##.....###...#.......##.#..#.....#.#.#.#...
....#.##.#....#...#...#....#.###..#.#.#.#.......###.#..#..#.#......#...#####.....##.#.##....#.#.#...
###.........#..#..#.#.#.#......#..#...#..#...##........##.#..#####.##.......####..#....#.#..#.#..#..
.....#..#.#.#..##.#......#..##.##.###.........#..##..#..#.#......#..###.#.........###..#..#...##.##.
...#.##......#..#.#...#..##..#.......#.###....##...#.##.#...#.##.#....#..##..#.##...#..........#..#.
.#....#..##........#.........##.##...#...##....#.#......#......#..#....#...#....#...#####.#.##..#.#.
.#..#.#....#..###..#.###...#..#...##.#....#.#....#.##.#..#......#.####.###.#.##..#...........#....#.
.##......#.#....#.......##....###....###....#.##......##...####......#...........#..##.##..#.##.#...
..#.###....#..#.#..####...#.#...##......#...#....####...##.....##..#.#..#.##.#.#.#.......#....#..#..
#.#...#.##..#...##....#...#..##..###.#..##..#.##....#.......##..#..#.#..#......#..##.#...#.##.#..##.
............#.#...###.###......#......#..#.....###..#.#.#.#..#..#....##..###.#.#.....#......#.#...#.
#######.#.#.#..##.......###.....##.#...#.###.#...#..#.#.#.#...#..###...........##.#..#.#....#..#..#.
..........#.....#####.....##..#.....#..#...#.#..........#...#.##.....#..##.###....##.#....#.##.#....
.####.....#.#.#.......#.....#...#.#.#....#.#....###..#..#.#.#....###.##......###.....#.#........##..
....####..#...##.#.##.#.........#.#.#..#...####.......#.....###....#...##.##...####........#..#..#..
..#....##...#..#.#..#.#..##.#.....#..#.###....#..##...#.........##.##........#......#..##..##.......
...###..#.#.#....##.#.##....#.#.#..#......###.........#.#.#.#.#..#..##...#....##..#..#..#....##.###.
.....##.#.#.##....#.#...#.#.#...##.#....#....##.....#.#.#.#...##.....###..#....#..##.##.###.........
###...#.#....##.#.......#.#.#.#..#.###..#..#..##.#..#.....###..#.......#..#.##.##.....#...###.##.##.
...#......#.....#..#......#.#.##.#...#...#.#........#.#.#...#.....##.#.......#..#.###.##..........#.
...####.#.#..##.#..#.#.##...#..#.###..#....##.##....#...###...#.#..#..##.#.#.##........##.#...##....
........#.......##...#...##........##..#.......#..........#.#.#..#.....#.#.#...##.#.##..#.##...###..
.#.#..#.#.#####...##.#.#..##.##........##.##.#.#.#.#.###....#.##..#.#......##.....#..##....#.#......
.#.##.#.......###..#....#.....#.##.###..#..#.#.#.#.....#.#..#...#...#.####..###.#.##..####....#..##.
.#..#......##...##.#.#..###.#.........#.##.......#.###.#.#...##...............#.#..#.....###..#.....
.....###.#..##...#.#..#...#..#....##.........##......#.#.#.#...##############.#.##.###......#...#...
####...#..#..###.#....###.....###..###..#.##....###..#...#..................#.#..#.....#.##...#.#...
...###.#...#.....#..#...##......#....##.#..###.......###.#..##.##.####.#....#.##.#####.#..#.#.#.#.#.
.#...#..##.#...#....#.#...####...##...#.........#.#..........#..#....#.#.......#.....#..#.......#...
.###.##.....##.#.##.....#.....#...#.#......##...#.#.#.####.#.#...#.#......####..#.##....###.#.#.###.
........#.#..#......#...###...###...#.##.#..#.#.#...#....#.......#.#..#.#....#......##....#.#.#...#.
#.#...#.#.#..#..#.#.#.#...#.#....##.#..#.##...#.###..##..#..#.##........###..#####....#...#...#.#.#.
#..##...#.##.##.#...#..#....#.....#.##.#...#.............#.....#####.#....#......#....#.#..#..#...#.
##..#...#..#..#.###.#........##.#.#....##....#.##.###....###.......#.####.#..#.#..#......#.##.###.#.
.##...#.#.....#...#..#...##...#.#.#.#....##..#......##.#...#..###.......#.##......###....#..#...#.#.
....#...###...###.....##..##..#.....#.##.....#.#.#...#..##.##...###..#.....##...#...###..##..##.#...
##..###...#.#...#..##...#..#...#.##.#....#........##.#........#....#..##.#....#..#.....#..#......##.
......##..#..#......##.....#.#....#.####.###.###..........##...##..#.......#...#..#..#.##.#.##....#.
#..#...#.......#..#...#.##.#....#......#........###..##.#...##.....###.#...###.......#..#......##...
##.#.#.#.###.#.#...#.......#....#.#.#...#..........#..#...#..###.#.......#....#..#.#.#....###.....#.
...#.#.....#.#......#.#.##.###..#.#.#.#..##.#.#..#..#.#........#.###..##...##..#.#.#.#..#...#..##...
##....#.#......#.#....#.............#..#......##.##...###..#.#.........##........#....#.##..#...##..
...##....####..#..#.......###..#.##..#..##.##..#...#....##.......#..##..#...####...#..#..#..#.#..#..
##..#.#.....#.....#.##.#....#..#...#.....#...#.#.#.#..#...##...#.#...#..##.....#.#.#...#.#..#....##.
....#.##..#...###.#.....#....#..#..####......#.#.#.#...#.........###.....#####...#..#..#..#..#......
##..#..##.###.....#.##..###..##..#....#.####.#.#.#...#..######.#.....#.......###.......#...#.###.#..
.##.##......##.#..#..#....##..##.#.#.......#.#.#..##.#.......#...###.####.#.....##.###...#.#...#....
.....#.#..#..........##.....#..#.#.#.#...#.#.#.#...#.###.##.............#.#..#...#...##..#..#...#.#.
#....#.#.....##.####....##..#......#.##........#.............##......##.#.#..###.###..##.##..##...#.
.###.#..##.#..#.......#...#..#####.#....#...##.#####.##....#..######......##.......##.....##..###.#.
......#....#.....##.#.#...##.....#.#..#...#........#................#.#.....###..#..#...#..##.....#.
.##.#.##.#..####..#.#.#.#...##...#.#..###......#....##..#.#.##.#..#.#...#.#......#.......#...#......
...............#......#.#....#.#...#......##......#...#.#.........#.#......##..#.####..#.#...##.....
####.######..#...##.#.....##....##.###.##..#.####.###.#.#######...#.###.....##.......#.#...#....##..
..........##..#...#...##.....##..#......##......#...#.#........#......#.#.#..#....#..#..##.##....#..
