################################### #####
# #   #       #        . .#        .    #
# # # # ##### # # ##### # ######### ### #
# # # # # #   # #   # #.#. . . .#  .  # #
# # ### # # ####### # # ####### # # ### #
#       #     #   #   #.#   # #.# #.#   #
############# # ####### # # # # # # # # #
#   #     # # #   #    .# # #. .# #.# # #
# # # ### # # ### # ### # ### ##### # ###
# # # # # #     # #   #.#    . . . .#   #
# ### # # ##### # ##### ######### # ### #
# #   # #     #  . . . .  #       # # # #
# # # # ##### ### ##### # ### ##### # # #
#   # # # #      .#     #   # #   #   # #
##### # # # ##### ######### # # # ##### #
#     # #   #  . .#   #     #   #   #   #
####### ##### # ### # # ##### ##### # # #
#   #   #     #.#   # # # # #     # # # #
# # # ### ##### ##### # # # ####### ### #
# # # #       #. . .#   # # #       #   #
### # ####### ##### ##### # # # ##### # #
#   #         #. .#. .    # # # #     # #
# ############# # # # ##### ### # ### # #
#        . . . .#.# #. .  #     # #   # #
# # ##### ####### # ### # ######### #####
# # #    .#     #.#   #.#     #     #   #
### # ### # ##### ##### ##### ### ##### #
#   # # #.#      . . .#.#   # #   #   # #
# ### # # ########### # # # # # ##### # #
# #   # #. .    #. .#. .# #   # #     # #
# # ### # # ##### # ##### ####### ##### #
# # #   # #. . . .#.#     #   #   #     #
# # # ### ##### ### ####### ### ### #####
# #     #     # # #. .#. . .    #   #   #
##### ####### # # ### # ### ##### ### ###
#   # #   #   # #   #. .  #. . . .      #
# # ### ### # # ### ##### ### ### ##### #
# #     #   # #   #     #   #   #. .# # #
# ######### # ### ##### ### ### ### # # #
#           #   #       #     #   #.#   #
################################### #####
