############################# ###########
#                  . . . .#  .        # #
# # ####### ####### ##### ### ### ### # #
# #   #     #      . .#  . . .  #   # # #
# ### ### ########### # # ####### # # # #
# # #   # #  . . . . .# # #   #   # #   #
# # ### # # # ##### ##### # ### # # # ###
#   #   # # #. .#   #. .# #     # # #   #
# ### ### # # # # ### # # # ### # # ### #
# #   #   # # #.#   #.#.# # #   # #   # #
### # # # # # # ##### # # ### ### ### ###
#   # # # # # #. . . .#.#   #   #   #   #
# ### ### # ####### ### ### ########### #
# #   #   # #     # #. .  #     #     # #
### ### ##### ##### # # # ### # # ### ###
#   #       # # #   #.# #   # #   # #   #
# ### # ### # # # ### # ### # ### # # # #
# #   # # #     #   #.#   # #   #   # # #
# # ### # ####### # # ##### ### ##### # #
# # # # #       # # #. . .#   #   #   # #
# # # # ####### # # # ### # # # # ##### #
# # # #   #   # # # #   #.# # # # #   # #
# ### # ### # # # # ### # # # ### # # # #
#   # #     #   # #   # #.# # #   # # # #
##### ########### # # ### # ### ### ### #
#   #       #   # # # #. .#   #     #   #
# ######### ### # ### # ##### ######### #
#         # #   #   # #. .  #         # #
######### # # ##### # # # ########### # #
#       # # #       # # #. . .  #     # #
# ##### # # ######### # ##### # # ### # #
# #   # #   # #       #     #.# #   # # #
# # # # # ### # # ########### # # # ### #
#   # #       # # #    . . . .# # #   # #
##### ####### ### ##### ##### # ####### #
#   # #     #   #   # #.#   # # #   #   #
# # # ### # ### ### # # ### ### # ### ###
# #   #   # #     #   #. .# #   #     # #
# ##### ### ##### ##### # # # # ####### #
#     #   #             #.#   #         #
######################### ###############
