##################### ###################
#           #        . .      #. .    # #
# ########### ### # # # ####### # ### # #
#       #   #   # # # #.#. . . .#.#   # #
# ##### ### ### # ### # # ####### ##### #
# #   #       # # #   #. .      #. .    #
# # # ####### ### # ### # ####### # #####
# # # #   #       # #   # #. . .# #. .  #
# # # # # ### ### # ####### ### ### # # #
# # # # #     #   #     #. .#  . .# #.# #
# # ### ####### ### ### # ####### ### ###
# # #   #       #   #   #. . .# #. .#. .#
# # # ### # ######### ### # # # ### # # #
# #   #   #   #       #   # #.#   #.# #.#
############# ### ### ##### # ### # ### #
#             #   #   #   # #. .#  . . .#
# ##### ### ### ####### ### ### ####### #
#     # #   #             #   #. . . .# #
# ### # # ### ### ##### ##### # # ### ###
# #   # #   #   #     # #   # # #   #. . 
# # ### # # # # ##### # # ### # ### #####
# # #   # # # # #   # # #     #   # #   #
# # # ##### ### # ### ######### # # # # #
# # # # #   #   # #   #       # # # # # #
##### # # ### ### # ### ##### # # # # # #
#     # # #     # #     #   # # # #   # #
# ##### # ##### # ######### # # # # ### #
# #   # #     # #           # # # #   # #
# ### # ####### ####### ### # # # ##### #
#   #     #     #       # # # # # #     #
### ##### ### ##### ### # # ### # # #####
# #     #   # # #   #   # #     # # #   #
# ##### ### # # # ### ### ####### # # # #
#     # #     #   #   #   #     # #   # #
# # ### ####### # # ### ### ### # # #####
# # #   #     # # # #       #     #   # #
# # # ### ### ### # ####### ######### # #
# # # #   #       #   #     #       # # #
# # ### ########### # ####### ##### ### #
# #     #           #             #     #
#########################################
