##################### ###################
#        . . .#. . . .        #   #   # #
# ####### ### # # ### # ### ### # ### # #
# # #. . .# #. .# #   #   #   # #       #
# # # ##### ### # # ######### # #########
#   #. . .#     # #   #     #     #   # #
##### ### ####### # # # ### ### # # # # #
 . .#   #. . .#   # #     #   # # # #   #
### ### ##### # ######### ### ### ##### #
# #. .#     #.#       # #   #   #       #
# ### ##### # ####### # ### # # #########
#   #. . .# #. . .#   #     # #         #
### ##### # ##### # ######### ##### ### #
# #   #  .# #. .#.#         #   #     # #
# ### ### ### # # ##### ######### # ### #
#   #   #. . .#.#. .  #     #     # #   #
# # ### ####### # # # ##### # # ### # # #
# #   #       #.# #.#   #   # # #   # # #
# ### ####### # ### ##### ### ####### # #
#   # #     #  . . .#     #   #       # #
# # # # ### ##### # ### ### ### ### ### #
# # #   #         # #   #   # #   # #   #
# # # ##### # ##### # ### ### ### ### ###
# # # #     # #     # #   #     #   #   #
### ### # ### # ### ### ### ### ### ### #
#   #   # #   # #     # #   # #   #   # #
### # ##### # # ### # # # ### # ##### # #
#   # #     # # #   # # #     #     # # #
##### # ##### # # ### ### ##### # # # ###
#     #     # # #   #     #   # # # #   #
# # ####### # # ####### # # # ### # ### #
# # #   #   # #       # # # # #   #   # #
# ### # ##### # ##### # ### # # ##### # #
#     # # #   #     # #     # # #     # #
####### # # ####### # ####### # ####### #
#   # # # # # #   # #     # # # #     # #
# # # # # # # # ### ### # # # ### ### ###
# #   #   #   #   #   # #   #   # # #   #
# ############### ##### ####### # # # # #
#                             #     # # #
#########################################
