####################### #################
#     #      . .#  . .#. .              #
# ### # ##### # ### # # # ### ####### # #
# #   #   #  .#. . .#.# #.#         # # #
# ####### # # ####### ### # ####### ### #
#       # # #.#  . . .#. .#       # #   #
####### # # # ### ##### # ####### # # ###
#         # #. .#.#  . .# #     # # # # #
########### # # # # # ##### ### # # # # #
#   #       # #.#.# #. .#   #     # # # #
### # # ####### # ##### # ##### ### # # #
# # # # #    . .#. . . .#     # #   # # #
# # ### # ### ##### ######### # # ### # #
#   #   # #  .#     #. . .#   # # #     #
# ### ### ### # ##### ### ####### #######
# #   #   #. .# #. . .  #. . .  #     # #
# # # # ### # ### ########### # ##### # #
# # # # #. .# #. .  #. . . . .#     #   #
# ### # # # ### ##### # ##### ### # #####
#     # #.# #. .#. .#.# #     #   #     #
##### # # ### ### # # # # ##### # #######
# #   # #. .#.# #.#. .# # # #   # #     #
# # ### # # # # # ### ### # # ##### ### #
#   #   # #.#.  #.#   #   # #       # # #
##### # # # # ### # ### ### ######### # #
#     # # #. .#. .#   #   #. . .#. .  # #
# # ### # # ### ##### ##### ### # # ### #
# # #   # #   #. . .# #. .#.  #. .#.  # #
### # ### ### ##### ### # # ### # # ### #
#   # #     #     #. . .#. .  # # #.# # #
# # # # ### ##### # ####### # # ### # # #
# # # # #   #   # #   #   # # #   #.#   #
# ### ### ##### # ### ### # # ### # #####
#   # #   #   # #   #     # #   # #. . . 
# # ### ##### # # # ######### # # #######
# #   #       #   #   #     # # #   #   #
# # # ######### ####### ### # # ### # # #
# # # #       # #       #   # #   # # # #
# ########### ### ####### ##### # # ### #
#             #   #             # #     #
#########################################
