################### #####################
#   #              . . . .    #         #
# # ### ########### # ### # ### ### ### #
# # #   # #         #   #.#     # # #   #
### # ### # ### ######### ### ### # #####
#   #     # #   #  . . . .  #     #     #
# ######### ##### # ### # # ########### #
#   #   #       # #. .# # #     #     # #
### # ### ##### # ### # # # # ### ### # #
 .# # #   #     # # #.# # # #     #   # #
# # # # ### ##### # # # # # ### ### ### #
#.# # #   # #   #   #.# # #   #   # #   #
# # # ##### ### ##### # # ### ##### # # #
#.  #       #. . . . .# #   # #     # # #
# ########### ##### ### # # ### ##### # #
#.#     #  . .#     #   # # #   #     # #
# # ### # # # # ##### ##### # ### ##### #
#.# # #   #.# # #     #     #   # # #   #
# # # ##### ### # ####### ##### # # # # #
#.#   #. . .#   # #       #     # #   # #
# ##### # ### ### # ### # ### # # ##### #
#.#. . .# #   #   # #   # # # # # #     #
# # ### ### # ### # # ##### ### # ### # #
#.#. .# #   # # # # #   #   #   #   # # #
# ### # # ### # # ##### # ### ### # ### #
#. . .# # #   # #   # # # # # # # #   # #
####### # ##### # # # # # # # # # ### # #
#     # #     # # # # #     # # #   # # #
# ##### # # ### # # # ### ### # ##### # #
# #     # #   # # # #   # #   #   #   # #
# # ### # ### # # # ### ### ##### # ### #
#   # # #   #   # #   #     #       #   #
##### # ########### # ############# # # #
#     # #       #   #   #       # # # # #
# ##### ### ### # # ### ####### # # # ###
# #     #   #   # #   #     #   #   #   #
# # # ### ##### # ### # # # ### ####### #
# # # #   #   # #   # # # #   #     #   #
# ### # # ### # ##### # ##### ##### # # #
#     # #     #       #     #     #   # #
#########################################
