############### ############# ###########
#   #     #   #. . .#       #. .    #   #
### # # # ### ##### ####### # # ### ### #
#   # # #   #     #. .# #   # #. .#     #
# ##### ### ##### ### # # ### # # #######
#       # #     #    .# #     # #. . . .#
####### # ##### ##### # ####### # ### # #
#       #     #     #. .# #     #   # #.#
# ########### ##### ### # # ####### ### #
#   #           # #    .#   #. . .# #. .#
##### ####### # # ##### ##### ### ### # #
#     #       #       #.#    .#  . .#.# #
# ##### # ########### # ##### ##### # # #
# #     #     #        . . .#.#   #.#.# #
# ########### ############# # # # # # # #
#           #   #     #   #. .# # #.#.# #
# ##### ####### # ##### ### # # ### # # #
# #   # #       # #   #   # # #   #. .# #
# # # ### # ##### # # ### ### ### ##### #
# # #     # #     # #       # #         #
### ####### # ##### ####### # ### ##### #
#   #       # #     #         #   #     #
# ######### # ### ### # ####### ### ### #
# #   #     #     #   # #     # #   # # #
# ### ############# ### # # # # # # # # #
# #     #     #   #   # # # # # # # # # #
# ##### # ### ### ### # ### # ### ### # #
#     #   #       #   # #   #   #   #   #
# # # ########### ##### # ##### ### #####
# # # #   #             #   #       #   #
# # # # ### ##################### # ### #
# # # # #   #         #           # #   #
# # # # # # ######### # ########### # ###
# # # # # # #     # # #   #         # # #
# ### # # # # ### # # ### # ##### ### # #
# #   # # # #   # #     # # #     #   # #
# # # # # ##### # ##### # # # ### # ### #
# # # #   #     #   # # # # # #   #   # #
# # # ##### ####### # # # # # ##### ### #
# # #             #   #   # #           #
#########################################
