##################### ######### #########
#   #               #. . . .#  .    #. .#
# ### ### ######### ####### # # ##### # #
#     #   #       #   #. . .# #. .#. .#.#
####### ######### ### # ######### # ### #
#       #       #   #  .#  . . .#. .# #.#
# # ########### ### ### # # ### ### # # #
# # #         #       #.# #.# #. .#   #.#
# # # # ##### ####### # ### # ### ##### #
# # # # #   #     # # #. . .# #. .#  . .#
# ### ### # ##### # # # ### # # ##### # #
#   #     #   # # # # # #   # #. .#. .# #
# # ########### # # # ### ### ### # ### #
# #     #     # # #     #   #    . .#   #
# # ##### ### # # ##### ### ##### # # # #
# #   #   # #   #         # #   # # # # #
# ### # ### ############# ### # ### # # #
# #   #     #                 #     # # #
# ######### ######### ####### ####### # #
#     #   #   #       #   #   #       # #
# # # # ##### # ####### # # ### ### #####
# # # #   # #   #       # # #   #       #
# # # ### # ######### ### ### # # # ### #
# # # #   #           #   #   # # # #   #
# # ### ######### ####### # ##### # # # #
# #     #         #         #     # # # #
########### ### ######### # # ####### # #
#     #   # #   #       # # # #   #   # #
# ##### # ### ### ##### ### # ### # ### #
#       #     #   #     #   #     # #   #
############### ####### # ######### # # #
#               #     # # #         # # #
# # ######### # ##### # ### ##### # # # #
# # #   #     # #     #     #     # # # #
# # # ### ##### # ################### # #
# # # #   #     #   #             #   # #
# ### # ### # ##### ##### ####### # ### #
#   #   #   # #   #   #   #   #   #   # #
### ##### # ### # ### ##### # ### ### # #
#   #     #     #   #       #         # #
#########################################
