################# #######################
# #     #   #  . .        #       #     #
# # ##### ### # # # # ### # ### ### ### #
#   # #   #   #.# # # # # #   #       # #
# ### # ### ### # ### # # # ### ####### #
# # #   #   #. .# #   # # # # #     #   #
# # # ### # # ### # ### # # # ####### ###
# #     # # #.#   # #   # # #         # #
# ##### ### # ##### # ### # ########### #
#   #       #. . .# #     #             #
### ### ##### ### # ####### ### #########
# #   # #   # #. .#     #     #         #
# ### # # # # # ##### ### ###############
# #   # # #   #. .  #             #     #
# # ##### # ### # # ############# # ### #
# # #     # #   #.#       #       # # # #
# # # # ##### ### ##### # ######### # # #
#   # # #   # #. .#   # #       #   # # #
# ##### # # # # # ### # ### ### # ### # #
#   #   # # # #.#     #   #   # #   # # #
### # ##### ### ########### # ### ### # #
#. .#       #. .          # #     #   # #
# # ######### # ######### ##### # # ### #
#.#. . . . . .# #. . .  #     # # # #   #
# ### ####### ### ### # ### # # ### # ###
#. .# #. .#   #. .#. .#   # # #     # # #
# # ### # ##### ### # ### # # ##### # # #
# #. . .#. .  #.# #.# # # # #     # #   #
# # ####### ### # # # # # ##### # # #####
# #   #   #. . .# #.# # #     # # # #   #
# ### # # ####### # # # ####### # ### # #
#   # # #         #.# #       # #   # # #
# # ### ########### # ### ### # ### # # #
# #     #    . . . .# #   #       # # # #
# ##### # ### ####### # # ##### # # # ###
# #   # # #  . .#     # # #     # # #   #
### # ### # ### # ####### # ####### ### #
#   # #   # # #.#   #   # #   # #     # #
# ### # # # # # ### # # # # # # # ##### #
#   #   # #   #.#   # #   # #   #       #
############### #########################
