########### #############################
# #        .    #       #     #   #     #
# # ####### ### # ##### # ####### # ### #
#   #    . .  # #     # # #     # # #   #
######### # # # ##### ### # # ### # # ###
#    . . .# # #     # #   # #     # #   #
##### ### # ##### # # # ### ########### #
#. . .#   #     # # #   #   #         # #
# ############# ### # ### ##### ##### # #
#.#. . . .    #   # # #   #     #   #   #
# # ##### ####### # # # ### ##### # ### #
#.#. .# #. . .  # #   # #   #   # # # # #
# ### # ##### ### # ### ### # ### # # # #
#. . .#     #. .# #   # #   #   # # #   #
# ######### # # # ### # ####### ### # ###
# #         # #.#   # # #     #     # # #
# # ########### ### # # # # ### ##### # #
# #     #  . . .#   #   # #     #   #   #
# ##### # # ############# ####### # ### #
# #     # #. . . .      #     #   #   # #
# # ### # # # ### ##### ##### # ### ### #
#     # # # #   #. .#     # # # # # #   #
# ### # # # ####### # ### # # # # # # ###
# # # # # #       #.# #   # # # #   #. . 
# # # # # ######### # # ### # # ##### ###
# #   # #   #  . . .# #   #   # #. . .  #
# ######### # # ##### ##### ### # #######
#   #       # #. .#   #     #   #.# #   #
### # # ### # # # # ### ##### ### # # # #
#   # # #   # # #.#   #. .    #. .  # # #
####### ##### ### ### # # ##### ##### # #
#       #   #   #. .# #.#.  #. .      # #
# ### ### ### # ### ### # ### ###########
#   # #   #   #   #.#. .#. . .#         #
# # # # ######### # # ######### ####### #
# # # #   #       #. .      #       # # #
# # ##### # ####### # ##### # ##### # # #
# #     # # # #     #     # # # # #   # #
# ##### # # # # # # ##### ### # # ##### #
#     # #   #   # #     #       #       #
#########################################
