########################### #############
#           #            . .  #       # #
# ### ##### ######### ### # # # ##### # #
# #   #         #     #  .# # #     # # #
# # ########### ### ##### # ######### # #
# # #   #     #   # #  . .#           # #
# # ### # ### ### # # # # # ### ####### #
# #   # # #. .# #   # #.# #   #         #
# ##### # # # # ####### # ### ###########
#     #   #.#. . . . .#.#   #   #   #   #
##### ##### ######### # # # ### # # # # #
#   # #    .#       #. .# #   # # #   # #
# ### # ### # ####### ### ### # # ##### #
# #   # #  .#   #     #     # # # #   # #
# # ### # # ### # ##### # # # # # # ### #
#   #   # #. .#   #     # # # #     #   #
# ### # ##### ####### # # # # # ##### # #
# #   # #   #. .  #   # # # # #   # # # #
### # ### # # # ### ##### ### ### # ### #
#   #     # # #. .# #     #     # #   # #
# ### ##### ### # # ####### ### # ### # #
# # #     #   # #.#       # #   #   # # #
# # ######### ### ####### # ######### # #
# #       #   #. .  #   # #       #   # #
# ##### ### ### # ### # # ### # ### ### #
#     #     #  .# #   #     # #     #   #
##### ######### # ####### # ####### # # #
#   # #   #  . .# #   #   #   #   # # # #
# ### # ### # ### # # ##### # # # ### ###
#     #     #.#   # #     # # # #   #   #
####### ##### # ######### ### # ####### #
#     # #  . .#         # #   # #       #
### # ### # ########### # # # # # #######
#   #     #. . . . .  # #   # #   #     #
# ####### # ####### # # ########### ### #
# #       #     #. .# #         #     # #
# # ############# ####### ##### # ##### #
# # #         # #.#     # #   #     #   #
# ### ####### # # # ##### # # ####### # #
#           #   #.#       # #         # #
################# #######################
