######### ###############################
#      . .              #           #   #
### ### ### ########### # ######### # # #
#   # #. .#   #       # #         # # # #
# ### ### ### # ##### ### ##### ### # ###
#     #. .  # #     #     #   # #   #   #
####### ##### ### ##### ### # # # ##### #
#. . . .#     #   #   #     # # # #     #
# ############# ### # ######### # # #####
#.#. . . .      #. .#   #     # # #     #
# # ##### ####### # ### # ### ##### ### #
#. .    #. .  #. .#.  #     #         # #
# # ### ### ### ### # ####### ######### #
# #   #   #. . .  #.#       #   #       #
# ### ##### ### # # ####### #############
#   #     #   # # #.    #   #     #     #
# # ### # ### ### # ##### ### ### ##### #
# #   # #   # #   #. . .# #. . .#       #
# ### ##### # # ### # # ### ### #########
#   # #     # #   # # #. .#.# #.#. . . . 
### # # # # # ### # ##### # # # # #######
# # # # # # #   # #     #.#.# #. .      #
# # # # ### # # # ####### # # ### ##### #
# # # # #   # # # #. . . .#.#   #     # #
# # # # # ### # ### ##### # ### ##### # #
#   # # #   # #   #.#     #.  #   # # # #
##### # ### # ### # ####### ##### # # # #
# #   #   # #   # #. . . . .      #   # #
# # ### ### ##### # # ##### ########### #
#   #   #   #     # #     #     #       #
####### # ### ### # ### # ##### # #######
# #     # #   #   #   # #   #   # #     #
# ### ##### ### ### # ### # # ##### ### #
#     #   # # # #   # #   # #       # # #
####### # # # # # ### # ### ######### # #
#     # #   #   # #   # #   # #       # #
# ### ########### # ### # ### # ##### # #
#   #         #   # #   #   #   #   # # #
# # ######### # ### # # ##### ### ### # #
# #   #         #   # #           #   # #
#########################################
