######### ###############################
#        .    #. . .      #     #       #
# ### ### ### # ### ##### ### ### # #####
# #   #  . .# #.# #.#     #   #   #     #
# ### ##### ### # # ####### ### ####### #
# #   #   #. . .  #. . . .#. . .#     # #
# # ### # # ####### ### # # ### ##### # #
# #     # #       #   # #. .  #. . .#   #
# # ##### ####### ### ######### ### #####
# #     #       # # #   #     #   #. . .#
# ####### ##### # # # # # ### ### ### # #
# #     # #     # # # # # #   # #   # #.#
### ### ### ##### # ### ### ### ### ### #
#   # #   # #     #   # #   #  . .# #. .#
# ### ### # ######### # # ##### # ### # #
#   #     #     #   # #   #  . .#. .#.# #
# ############### # # ##### # ##### # ###
# #       #       #. . .#   #.#  . .#. .#
# # ### # # ####### ### ##### ### ##### #
# # #   #   #. . . .# #. . . .#  . . . .#
# ### ####### ### # # ####### # # ##### #
# #   #      . .# # #         # # #     #
# # ######### # ### ########### ### #####
# # # #. . .# #.#   #       #     # #   #
# # # # ### ### # ####### # ##### # ### #
# #   #.#  . . .# #       #   #   #   # #
# ##### ##### ### # # ####### # # # # # #
#      . .#   #   # # #   #     # # # # #
####### # # ### ### ### # # # ##### # # #
 . . .# #.# #   #   #   #   # #     #   #
##### ### # # ### # # ##### # # ##### # #
#   #.#. .# # #   # #   #   # # # #   # #
# ### # ### # ##### ### ##### # # # ### #
#   #. .#   #   #     # #   # # #   # # #
### # ####### # ####### # # # # ##### # #
# #   #     # # #   #   # #   #       # #
# ##### ### ### # ### ############### # #
# #     #       #   #   # #       #   # #
# ############# ### ### # # ##### # ### #
#               #       #   #       #   #
#########################################
