######################### ###############
#        . .#       #  . .        #     #
# ####### # ####### # # ####### ### # ###
#     #. .#. . . . .# #. . . .#     #   #
####### # ######### ######### ####### # #
#. . . .# #        . .#. . .#.  #   # # #
# ### # ### ######### # ### # # # ##### #
#.#   # #   #   #   #.#.# #. .# # #     #
# ##### # ##### # ### # # ##### # # # # #
#. .#   #     #      . .#     # # # # # #
# # # # # ### ####### # ##### # # ### # #
# #.# # #   #   #     # #       #     # #
# # # ######### # ### # ########### # # #
# #.#       # # # #   # #     #   # # # #
# # ####### # # # # ### # ### # # ### # #
# #. . .#   # # # # #       # # # #   # #
####### # ### # ### # # ##### # # # ### #
 . . . .# #   # #   # #   #   # # #   # #
### # ##### # # # ### ##### # # ### # # #
#   # #     # # # #   #     # #   # # # #
# ### # ######### # ### ### # ### # # # #
#   # # #         #   # #   # # # # # # #
##### # ####### ####### ##### # # ### # #
#     #         #       #     # #     # #
# ############### ### ### ##### ####### #
#         #     # #     # #   #         #
####### # # ### # # # # # ### # # ##### #
#     # # #   #   # # # # #   # # #     #
# ### ### ### # ### # # # # ### # # # # #
# #         # # #   # # # # #   # # # # #
# ### ####### # # # # # # # # ### # ### #
#   # #   #   # # # # # #   # #   #   # #
# # ### # # ##### ### ####### # ##### # #
# # #   #   #   #   # #       #     # # #
# ### ##### ### # # ######### ####### # #
# #   #   # #   # #     #     #     # # #
# ####### # # ######### ######### # # ###
# #     #   # #         #   # #   # #   #
# # ### ##### # # ####### ### # ### ### #
#     #       # #           #   #       #
#########################################
