# #######################################
#. .    #. . . . .        #   #     #   #
# # ### # ####### ### ### ### # ### # # #
# #. .# #.#     #.  #   #     #   # # # #
# ### ### ##### # # ####### ####### # # #
#   #. .#. . .# #.#       #       # # # #
### ### ##### # # ####### ##### # # # # #
 .#   #.  #. .  #.  #       #   # # # # #
# ### # # # ##### ### # # # # ### # # ###
#.#   #.# #.  #. .#   # # # # #   # #   #
# ##### ### ### ### ##### # # # ### ### #
#. . .#. . .#. .#   #     # # # #       #
##### ####### # # ######### # ### #######
#    . . . . .# #         # #           #
# ########### # ##### ### # ######### # #
# #         # #     #   # #     #   # # #
### ######### # # # # # ####### ### ### #
#   #         # # # # #     #   #   #   #
# ### ####### # # # ### ### # ### ### # #
#     #     # # # #   #   # #   #     # #
# ##### ### ### # ### ### ### # #########
# #     #       #   #   #   # #         #
### ########### ### # # ### # ### ##### #
#   #   #       #   # # #   # #       # #
# ### # # ####### ### # # ##### # ##### #
# #   # # # #     #   # # #     # #     #
# ##### # # # # ##### # # ### ##### #####
#     #   #   # #     # # # # #   #     #
# ### ######### # # ##### # # # # ##### #
#   #       #   # #     # #   # #   #   #
# # # ### # # # ####### ########### #####
# # #   # # # # #     #           #   # #
### ######### ### ### # # # ### ##### # #
#   # #     #       # # # #   #       # #
# # # # ############# # # ### ######### #
# # #   #         #   # #   # #     #   #
# ##### # ### ### ### # ### # # ##### # #
#     # # #   #     # #   # # #       # #
##### # ### ####### ### # # ### ####### #
#     #     #           # #     #       #
#########################################
