################# #######################
# #    . . . . . .        #     #       #
# # ### # ##### ##### ### ### ### ##### #
# # #  .# #     #   #   #       #     # #
# # # # ### ##### ### # ##### # ##### # #
# # # #. .# #         #     # #     # # #
# # # # # # # ####### ##### # ### ##### #
#   # # #.# # #       #   # #   #     # #
# ### # # # ### ####### # # ### # # # # #
# #   # #.#   # #       #   # # # # # # #
### ### # ### # ####### # # # # ### ### #
#   #   #.# # #     #   # #   #   #     #
# ####### # # ##### ### # # ### # #######
# # #. . .# # # #   #   # #   # #   #   #
# # # # ### # # # ### # # ##### ### # # #
#   #.# #   # #   # # # #     # # # # # #
##### # # ### ##### # ####### # # # # ###
#    .# #       #   #       # #   # #   #
##### ########### # ##### ### ##### ### #
#. . .#. . .      #     #   # #       # #
# # ### ### ####### ### ### ### # # ### #
#.# #. .  #. .    #   #   #   # # # #   #
# ### ####### ### ### ### # ### # # # ###
#. . .#     #.  # # #   # # #   # # # # #
# # # # ### # # # # # # # # # ##### # # #
# # # # # # #.# #   # # # # # #   # #   #
# # ### # # # ####### # # ### # ### ### #
# #       # #. . .  # # #   #   #   # # #
# ######### # ### # ### ### ######### # #
#       #   #   #.# #     #             #
# # ### # ####### ### # # # # # #########
# # #   #   #   #.#   # # # # #         #
# # ######### # # # ### # # # # ####### #
# #       #   # #.#   # # # # # #     # #
# # ### # # ##### ### # # # ### # ##### #
# #   # # # #  . .  # # # # #   #       #
# ##### ### ### ### # ### # # ###########
#     #   # #. .# # #   # # #           #
##### # # # # # # # ##### # ##### ##### #
#     # #   #.# #   #     #     #     # #
############# ###########################
