##### ###################################
# #  .  #. .            #               #
# # # ### # ########### # ### ##### ### #
# # #. . .#.  #. .#     # # # #   # #   #
# # # ### # # # # ####### # # ### ### # #
# # #   # #.# #.#. . .    # #   #     # #
# # ### ### ### ##### ##### ### #########
# #   #   #. . .    #.    #         #   #
# # # ### ### ####### ############# # # #
#   #   #   #       #. . .    # #   # # #
### ####### ####### ### # ### # # ##### #
#   #     #     # #   # #. .# # #       #
##### ### # ### # ### # ### # # #########
#     #   # #   #     # #. .# #       # #
######### ### ######### # # # ####### # #
#   #         #  . .#   #.# #       # # #
# ### ######### # # ##### # ### ##### # #
#     #         #.#. .#  .# #     #     #
######### ####### ### ### # # ##### #####
#         #. . . .#  . . .# #         # #
# ######### ######### ### # # ####### # #
#   # #  . .#. . .#   #   # # #     # # #
### # # # # # ### # ### ### # # ### # # #
# # #   #.# #.# #.# #   #   #   # # # # #
# # ##### # # # # # # ### # ##### # ### #
#   #    .# #. .#.# # #   #   #   # #   #
######### ##### # ### # # ##### # ### ###
 . . .#  . . . .#. .# # #       #       #
##### # # ######### # ################# #
#    .# # # #. . . .#   #           #   #
##### ### # # ##### # # # ##### ### # ###
#   #. .#   #.#   # # #   #   # #   #   #
# # ### ##### # ### # ####### ### ##### #
# # # #. . . .#     #       # #   #   # #
# # # ##### # ### # # ##### # # # ### # #
# #   # #   # # # # # #   # # # # #   # #
# ##### # ### # # # ### ### # # # # ### #
# #   #   #   #   #   #   #   # # # #   #
# # # ##### ######### ### ####### # # # #
#   #       #         #           #   # #
#########################################
