################### #####################
#           #  . . .  # #. . . . . .    #
### ####### # # ### # # # ######### ### #
#   #   #     #.#   #   #. . . .  #.# # #
# ### # ####### ############### ### # # #
#   # #        . . .  #. . .  #.#. .# # #
# # ########### # # ### ### ### # # # # #
# #         #   # #. . .  #. . .#.# #   #
# # ### ### # ########### # # # # #######
# # # #   # #           # # # # #. .#. . 
# # # # ### ########### # # # ##### # ###
# # # #   # #           # # #   # #.#. .#
# # # # # # # ### ####### # ### # # ### #
# #   # # # # #   #     # #   #   #. . .#
# ####### # # ##### ### # # ####### # ###
#       # # #     #   # # #       # #   #
# # ### # # # # # ##### # ##### # # ### #
# #   # # # # # #     # # #   # # # #   #
# ##### ### # # ####### # # ### # # # ###
# #     # # # #       #   # #   # # #   #
# ### ### # # ####### ### # # ##### #####
# #   #   # #   #   #   # #   #   #     #
# # # # ### # # ### ### # ####### # ### #
# # # #     # #     #   #         # #   #
### # ####### ####### ############### # #
#   # #     #   #     #             # # #
# # # # ##### # # ##### ### ####### # # #
# # # # #     # # #     #   #   # #   # #
# ### # ### ### # ########### # # # # # #
#   # #   #   # #           # #   # # # #
# # # ### # # ########### # # ##### # # #
# # #     # #       #   # # #     # # # #
# # ### ### ### ### ### # ####### ### # #
# #   #   #   #   #   # #       #     # #
# ### ######### # ### # ####### ####### #
#   #         # #   #   # #   #   # #   #
### ######### # # # ##### # # ### # # # #
# #     #   # # # #   #   # #   #   # # #
# # ### # ### # # ##### ### ### ##### # #
#   #   #     # #         #   #       # #
#########################################
