######################### ###############
#   #     #   #          .    #         #
# ### # ### # # ####### # ### # ####### #
#     #     # #   #     #.  #   #       #
# ############# # # ##### ###############
#       #     # # # #   #. .#. . . .  # #
####### # ### ### # ### # # # ##### # # #
#     # # # #     #     # #. .#. .#.#   #
##### # # # ########### # ##### # # #####
#     # #   #         # #   #. .#.#. . .#
# ### # ########### # ####### ### ##### #
# #           #     #    . . .# #. . .#.#
# ##### ##### # ######### # ### ##### # #
# #     #   #   #      . .# #   #    . .#
# # ### # # ########### # ### ### ##### #
# #   # # #      . . . .# #   #   #     #
# ##### # ####### # ##### # ### ##### # #
# #     # #. .#  .# #     #     #     # #
### # ##### # ### ### ############# ### #
#   # #  . .#. . .#   #   #         #   #
# # # # # ####### # ##### # # ### # # # #
# # # # #. .#     # #   # # # #   # # # #
##### # ### ####### # ### # # ##### # # #
#     # # #.#       #     # # #     # # #
####### # # # ######### ### # # ##### # #
#       # #.# #           # # # #   # # #
# ### ### # # ########### ### # # ### # #
#   # #   #.#         #       #   #   # #
# # ### ### ######### ####### ##### #####
# #     #  . .      #       # #     #   #
######### # # ##### ######### # ### ### #
#   #   # # #.    #     #   # # #   #   #
# ### ### # # ######### ### ### ##### ###
#   # #   # #. . . . .#   # #   #   # # #
### # # ### ### # ### ### # # ### ### # #
#   #   # #   # # #. .  #   #   # #     #
# ####### # # # ### # ### ##### # # ### #
# #     #   # #   #.#   # #   #   # # # #
# ### # ##### ### # ### ### # ##### # # #
#     #       #   #.  #     #       #   #
################### #####################
