####################################### #
#   #     #       #      . . . . . .#. .#
# # # ##### ####### ##### ######### # # #
# # # #     #       #    .#   #. .#.#.# #
# # # # ##### # ######### # ### # # # # #
# # #         # #  . . . .# #. .#.#.#.# #
# # ### ##### ### # ####### # ### # # # #
# #   # #     #   #. . . .#. .# #.#.#.# #
# ####### ##### ### # ### # ### # # # ###
# #       #     #   # #. .#.# # #. .#. .#
# # ### ##### # # ##### ### # # ##### # #
# # #   #     # # #  . .#  . . . . .# #.#
# ### # # # ### # ### # ##### ##### ### #
#     # # #   # #   #.# #   # #. .#. .#.#
# ####### # # ##### # # # ### # # ### # #
# #       # #   #   #.# #     #.#. .#. .#
### # ### # ### ##### ######### ### # # #
#   # #   #   #     #.#. . . .#.  #.# # #
# ##### ########### # # ##### # ### ### #
# #     #           #. .  # #. .#. .#   #
# ####### # ####### # # # # # ### ### ###
#       # #   #     # # #   #   #.#   # #
# # ### # ##### ##### # ######### # ### #
# #   # #   #   #   # # #     #. .#     #
# ##### ##### ### # # # # ### # # #######
#     #   #   #   #   # # #   #.#   #. . 
##### # # # ### ##### # ### ### ##### ###
#   # # # #   #     # #     #  . . . .  #
# # # # # ### # # # # ####### # ####### #
# # # # #   # # # # #   #   # # #     # #
### # # ### # # ### ### # # # # ##### # #
#   # #   # # #   #   # # # # #     # # #
# ### # # ### ### ### # ### # ##### # ###
# #   # # #   #   #   #   # #     # #   #
# # ##### # ### ### ##### # # # # # ### #
#   #   # # # #   # #   #   # # # #   # #
####### ### # ### # # ####### # # ### # #
#     #   # #   # #   # #   # # #   # # #
# ### ### # ### # # ### # # ### ### # # #
#   #         #   #   #   #     #   #   #
#########################################
