################### #####################
#     #            . . .#. .            #
# ### # ### # # ##### # # # ### ##### ###
# # # # #   # # #   # #. .#.  #     #   #
# # # # # ### ### ##### ### ##### ##### #
# # # # # #     #     #   #. .  #     # #
# # ### # ### # ##### ### ### # ### # # #
# # #   #   # #     #   #   #.#   # # # #
# # # ##### # # ### ### ### # ### # # # #
# #   #     # #   # #   # # #. .# # # # #
# ####### ##### # ### ### # # # # ### # #
#         #   # #         # # #.#   # # #
# ######### # ####### ##### # # ### # # #
# #         #       # #     # #.  # # # #
### ### # ######### ### ##### # ### # # #
#   #   # #       #   # #     #.#   # # #
# ######### ##### ### # # ##### # ### # #
#     #     #   #   # # # #   #.#   # # #
####### ####### ### # # ### # # ### # # #
#       # #     #     #     # #.# # # # #
### ##### # ### ### ########### # # # # #
#   #     #   #              . .# # # # #
# ### ### ################### ### # # # #
#   # #     #        . . . .#. .#   # # #
##### # ### # ####### ##### ### ##### # #
#     # #     #    . .#    . .#.  #   # #
### ##### ######### ### ##### # # ### ###
#   #   #   #  . . .#   #. .#. .#   #   #
# ### # ##### # ### ##### # # ##### # # #
# #   # #     #.#   #. . .#.# #     # # #
# # ### # # ### ##### ##### ### # ### # #
# #   #   # #  . . . .    #.#   # # # # #
# ########### # ##### ##### # ### # # # #
#     #   #   # #   # #. . .# #   # # # #
# ##### # # ### ### # # # ### # ### # ###
#   #   #   #       # #.# #   # # # #   #
##### ################# # # ### # # ### #
#     #   #     #    . .# # #   #   # # #
# # ### # # ##### ### ### # ##### ### # #
# #     #   #     #  .#   #         #   #
##################### ###################
