####################################### #
# #     #     #     #      . .# #      .#
# # ##### ### # ### # ##### # # # ##### #
#           # # #     #  . .#.#   #. . .#
########### ### # ####### ### ##### # # #
#   #           #   #  . .#  . . . .# # #
# # # ### ##### ##### # ####### ### ### #
# # #   #   #   #     #. . .#   #   #   #
### ####### # ### # ####### ##### ### # #
#   # #   # # #   # #     #. . .# #   # #
# ### # ### # # # # # ### # # # ### #####
#   #       # # # # # # # # # #. .#     #
### ######### # # ### # # # ### # ##### #
# #           # #     # # #   # #.    # #
# ######### ### # ##### # ### # # ##### #
# #         # # #       #   # # #.  #   #
# # ##### ### # ######### ### # # # # ###
#   #     #   # #         #   # #.# #   #
####### # # ### ####### ### ##### # # # #
#     # # # #   #       #   # #. .# # # #
# ### # # # ### ######### # # # # # ### #
# #     # #     #     #   # # #.# # #   #
# ### ########### ### # ##### # ### # ###
#   # #             # # #     #. .# #   #
### ### ############# # # ##### # # ### #
# #   # #          . .#   #     #.#   # #
# ##### # # ####### # ##### ##### ##### #
#       # #   #  . .#. . .# #. . .  #   #
### ### # ### # # # ##### ### # # # #####
#   #   #   # # #.# #. .#. . .# # # #   #
##### ##### # # # ### # ### ##### # # ###
#     #     # # #.#. .#.#   #     # #   #
# ##### ##### # # # ### ##### ##### ### #
# #   # #     # #. .  #. . .# #   #     #
# ### # # ######### # ##### # # #########
# #   # #         # # #   #.#   #. .    #
# # ### ####### # # # ### # ##### # ### #
# #   # #   # # # # #   # #. . . .#.# # #
# ### # # # # ### # ### # # ####### # # #
#     #   # #     #   #   #       #.#   #
################################### #####
