##### ###################################
#. . .    #. .                  #   #   #
# ######### # ##### ####### ### # # ### #
#. . .  #. .#. .# # #   # #   # # #   # #
# # # ### ##### # # # # # ### ### ### # #
# # #. . .#. .#.#   # #   # #   #   # # #
# ##### ### # # ######### # ### ##### # #
# #. .#   #.#. .#     # # #   #       # #
### # ### # # # ##### # # ### ######### #
 . .#.#   #.# #     #   #   # #     #   #
##### ##### ##### ### ### ### # ##### # #
#   #. . .#. . .#     #   #   # #     # #
# ####### # # # ####### ### ### # ##### #
#   #   #.# # #. .          #     # #   #
### ### # # # ### ########### ##### # # #
# #   #. .# #   #. .          #   #   # #
# ### # ### ####### ######### ### ### # #
#   # #.# #       #. . .    #     #   # #
### # # # ####### ##### ### ########### #
# # #  . .#   #   #. .#.  # #     #     #
# # ##### ### # ### # # ### # ##### # # #
#   #   #. . .# #. .#. .#   # #     # # #
# ### # ##### # # ####### # # # # ##### #
#   # #     #.# #.#   #   # #   # #     #
### # ##### # ### # ### # # ### ### ### #
# # #   #   #.#. .# #   # # #   #   #   #
# # ### ##### # # # # # ### # ### # #####
# # # #      . .# #   # #   # #   # #   #
# # # ####### ### ### ### ### # # ### # #
#   #   #   # #   #   #   #   # #   # # #
# ##### # # ### # ##### # # ### # # ### #
#     #   # #   # #     # # #   # #     #
##### # ##### # # # ####### ####### #####
# # # #     # # # # #   #   #     #     #
# # # ##### # # # # # ### ### ### #######
#   #         # # # #     # # # # #     #
# ############# # # ####### # # # # ### #
# #   #   #     # #       #   #   # # # #
# # # # # ####### # ### ##### ##### # # #
#   #   #         #   #             #   #
#########################################
