########################### #############
#               #          . . . . . .  #
# ####### ### # # # # ##### # ####### # #
#   #     #   #   # # #     #     #. .# #
##### ####### ##### ### ### ##### # #####
#     #       #       # #   #     #. . .#
# ##### ### # ##### # # # ############# #
# #   # #   # #     # # # #  . . . .#. .#
# ### ### ### # ##### # # ### ##### # # #
#     #   #   # #     # #   #. .#  . .# #
####### ####### # # ### # # # # # #######
#   #   # #     # # #   # # # #.# #. . .#
# ### # # # # ### # # ##### # # ### ### #
# #   # #   # #   # #   #   # #. . .  #.#
# # ### ####### ### ### # ##### ####### #
#   #   #   #   #     # #     #     #. .#
##### # ### # ### # # # ##### ##### # ###
#     # #   # #   # # # #   #     # #. .#
# # ### # ### ##### # # ### ##### # # # #
# # #   #     #     # # #         # # #.#
# ### # ####### ##### # ######### # # # #
# #   # #   #   #     #   # #     # # #.#
# # ### # # # # ######### # # ##### # # #
# # #   # # # #         # #   #     # #.#
### ##### # # ########### ##### # ### # #
# #       # #     #   #   # # # #   # #.#
# ########### ### ### # ### # # # # # # #
# #         #   # # #   #     # # # # #.#
# ### ##### ##### # ####### ### ### # # #
#     #   # #     #         #   #   # #.#
####### # # # ### ######### ##### # # # #
#     # #     #   #       #       # # #. 
# ### # ### # # ### ##### ### ##### # ###
# # #   #   # # #   #   #     #     #   #
# # ######### # ### ### ####### ####### #
# # #     # # #   #   # #     # #       #
# # # # # # # ### # # # # ### ### ##### #
# # # # # # #   # # # # #   #     #   # #
# # ### # # ##### # # # ######### # ### #
# #     #         # #   #         #     #
#########################################
