######################### ###############
#                        . .  #. . . .  #
# ######### ############### # # ##### # #
#   # #   # #        . . . .# #.# #. .# #
# # # # ### # ####### ######### # # #####
# # #   #   # #. . . .#. . . . .# #. . .#
# # # ##### # # ##### # ####### # ##### #
# # # #     # #.#     #. .#   # #     #.#
# # # # # ### # ######### # # ####### # #
# # # # # #   #.#. . .  #.# #       # #. 
### # ### # ### # ### ### # ##### # # ###
#   #     #   #. .  #. . .  #   # # #   #
# ##### # # # # ############### # # ### #
# #   # # # # #     #         # # #     #
# ### # # ### ### # # ### ### # # #######
#   #   #   #   # #     #   #   #       #
# # ####### # # # ####### # ########### #
# # #     # # # #       # #       #   # #
# # ##### # # # ####### ### ##### # ### #
# #   # # # # #   #   # #       # #     #
# # # # # ### ### # ##### ####### #######
# # # # #     # # # #     #         #   #
# ### # ### # # # # ### # # ####### # # #
#   # # #   # # # #     # #   #     # # #
### # # # ### # # ##### # # # ####### ###
# # # #   # #   #   #   # # #     #   # #
# # ####### ####### # ### # # # ### ### #
# # #               # #   # # #       # #
# ### ##### # ##### ### # # ### # ##### #
#     #     # #   # #   # #   # #       #
# ########### # # ### # ##### # #########
# #           # #     # #     #     #   #
### ########### # ####### ### # # # # # #
#   #     #     # #       #   # # # # # #
# # # ##### # ##### ##### ####### # # ###
# # #   # # #     #   #   #       # #   #
# # ### # # # ### ### ##### ########### #
# #   # #   # # # # #     #   # #       #
# ##### ##### # # # ### ####### # #######
#           #   #     #                 #
#########################################
