######### ###############################
#    . .#.    #   #. . . .      # #     #
# ### # # ### # # # ##### # ##### # ### #
# #  .#. .  # # # #.#   #.#   #   #   # #
# # # ####### # # # # # # # ### ####### #
# # #. . . .#   # #. .# #.#   # #     # #
# # ### ### ######### ### ### # ### # # #
# #   #   #. . . .  #.#. .# # # #   # # #
# ### ######### # # # # # # # # # ### # #
#   #         # #.# #.#.# #   #   #     #
# # ######### ### ### # # ######### #####
# #         #   #.#. .#.#           #   #
# ### # ####### # # ### ############# # #
#   # #     #   #. .  #. . . . . .    # #
# # ### ### ####### ######### ### ##### #
# #   #   #       #   #     #   #. . .# #
# ### ##### ### # ### # ### ##### ### # #
#   #     #   # #   # #   #     #   #.# #
### # ### ### ##### # # ####### ### # ###
# # #   #   # #   # # #       #   # #. . 
# # ####### # # ### # # ####### # # #####
# # #       # #   # #         # # #     #
# # # # # # # ### # ### ### # # # ##### #
# # # # # # #   # #   #   # # # # #   # #
# # ### # # # # # ### ### ### # # # ### #
#   #   # # # # #   #   # #   # #   #   #
##### ### # # # # ##### ### ####### # ###
#     #   # # #       #   #   #   # # # #
# # ### ### ### ####### # ### # # ### # #
# # #   #     # #     # #   #   #   # # #
# ### ####### # # ### # # # ##### # # # #
# #   #       # #   # # # #   # # # #   #
### ### ##### # ##### # # ### # ### # ###
#   # #   #   #       # #   # # #   #   #
# ### # # ##### ####### ### # # # ##### #
# # #   #     # #       #   # #   #   # #
# # ####### # ### ####### ### ##### ### #
# #     #   # #   # #     #   # # #     #
# ##### # ##### # # # # ####### # #######
#     #   #     # #   #                 #
#########################################
