################### #####################
#         #      . .                #   #
##### ### # ##### # ### ##### ######### #
#     #     #. . .#   #     #         # #
# ########### ####### ########### # ### #
# #       #  . . . .#           # #   # #
# # ##### ### # ### ########### ##### # #
# #   #   #   # # #. . . .    #     # # #
# ### ##### # # # # ### # ######### # # #
#   # #   # # #   #   # #.#         # # #
# # # # # # # ##### # ### # ######### # #
# # # # #   #     # # #. .# #. . .  #   #
### # # # ####### ### # ##### ### # #####
#   #   # #   # #   # #. . . .#. .# #   #
# ####### # # # ### # # ##### # # # # # #
#     #   # #   # # # # #   # #.# # # # #
# # # # ### ### # # # # ### ### ### ### #
# # # #   # # #   # # #   #   #. .#     #
# ### ### # # ### ### ### ### # # #######
# #     # #   #         #     # #. . .  #
# # # ### ##### ### # ### ##### ### # ###
# # # #   #   # #   #   #     #   # #. .#
# # ### ### # ### ##### ######### ### # #
# #   #     #   #   #   #       #   # #.#
# ### ######### ##### ### ##### # # ### #
# #   #   #   # #   # #   # #   # # #. .#
# ####### ### # ### # # ### # ##### # # #
#         #   #     # # #   #       #.# #
# # ####### ########### # ########### ###
# # #           #   #   #   #        . .#
# # # ####### ### # ### ### ######### # #
# # # #     # #   #   # #       #     #. 
# # # # ##### # ##### # # ##### # # ### #
# #   #   #   # #       # #   # # # #   #
# ####### # ### ########### # # ### #####
#         # #   #           #     #     #
############# ### ############### ### # #
#     #       #   #     #       #     # #
##### # # ########### # ### ### ####### #
#       # #           #     #           #
#########################################
