########################### #############
#   #     #        . . .#  .            #
### # ##### ##### # ### ### # ###########
#   # #     #     #.#  . . .#     #     #
# ### # ####### ### ####### # # # # ### #
# #   # #   #   #  . .#     # # # #   # #
# # ### # # # ##### # ####### # ####### #
# #   # # #   #     #. .  #   #       # #
# ### ### # # # ####### # ##### ### # # #
#   #     # # # #. . . .#     # #   # # #
### ######### # # # ### # ### # # # ### #
# #       #   # #.# #   #   # # # # #   #
# ####### # ### # # # ####### ### # # ###
# #     #   #   #.# # #   #   #   # # # #
# ##### ##### ### # # # # # ### ##### # #
#     # # #   #  .# # # # #   # #     # #
##### # # # # ### ### ### ##### # ##### #
#   #   #   #   #. .#   # #     # #     #
# # # ######### ### ### # ### ### # #####
# # # #       # # #. .# # #   #   #. . . 
### # ### ### # # ### # # # ### ### #####
#   #     #   #   #. .# #   #   #. .    #
# ######### ####### ######### ### #######
# #       # #      . . . .    #. .      #
# ####### # # ##### # # # ##### ####### #
# #     #     #     # # #. .  #.      # #
# # ### ####### ##### # ### ### ##### ###
# # #   #       #   # # #. .#. .#   #   #
# # ##### ##### ### # ### ### ### # ### #
# #       #         #   #.#. .#   #   # #
# ##### ### ### # ### # # # ######### # #
#     # #   #   #   # # #. .        # # #
##### ### ### ##### # # ######### ### # #
#   #     #     # # # #         #     # #
### ######### # # # ####### ### # ##### #
#       #     # #   #     # # # #   #   #
# ##### # ##### ##### ### # # # ##### ###
#     # # #     #   # # # # # #     # # #
# ### # ### ####### # # # # # ##### # # #
# #   #     #         #     #       #   #
#########################################
