# #######################################
#. .    #. . .      # #     #           #
# # ##### ### # ### # # # # # ####### # #
# #.#. . .  #.# #   # # # # # #     # # #
# # # ####### # ##### # # ### ##### # # #
# #. .#   #. .# #       #     #     # # #
# ####### # ### # ### ######### ##### # #
#         #.#   # # #   # #     #   # # #
########### # ### # # # # # ####### # # #
#. . . . . .#     # # # # # #   #     # #
# ### ############# # # # # # # # #######
#.#   #. . . . .    # # # #   # # # #   #
# ##### ##### # ##### ### ##### # # # # #
#. . . .#. .# #. . .#           #   # # #
# ####### # # ##### ### ############# # #
#   #. . .#.#     #.  #         # #   # #
##### ##### ####### # ##### ### # # ### #
#  . .#    . . . . .#     #   # #     # #
# # ############### ### # # # ### ##### #
# #. . . . . .#. .#   # # # #     # #   #
# ### # ##### # # ### # # ##### ### # ###
#   # #     #. .#.#   # #     #     # # #
# # # ####### ### ##### ##### ####### # #
# # # #   # #   #. . .#     #       # # #
### # # # # ### # ### # ######### # ### #
#   # # #   # # #   #.#         # # #   #
# # ### ##### # ##### ##### ### # # # ###
# # #   #   #   #  . .  #     # # #   # #
# # # ### ### ### # ##### # # # ### ### #
# # # # #   # #   #.#     # # #   #     #
# ### # ### ### ### # ####### ### #######
#       #       #. .#   #     # #       #
# ############### # # # ####### ##### # #
#     #        . .# # #         #     # #
####### ####### ### # ####### ### #######
#       #   #  .# # #   #   # # # #     #
### ##### # # # # # ### # # # # # # #####
#   #   # # # #.# #   #   # # # # #   # #
# ##### # # # # # ### ##### # # # ### # #
#       # #   #.#     #     #   #       #
############### #########################
