####### ################### #############
#  . . .        #   # #   #.#     #   # #
# # ### # ### ### # # # ### # ### ### # #
# #.# # #   #     #   # # #.# #     #   #
# # # # ### ########### # # ####### ### #
# #.#   # #       #   # # #.# #   #   # #
# # ##### # ####### # # # # # # # ### # #
# #.    # #     #   #   # #. .# #   # # #
# # ### # ##### # ####### ### # ##### # #
# #. .#   #   # # #. .#. . . .  # #   # #
# ### ####### # # # # # ######### # ### #
#   #. . .    #   #.#. .#           #   #
### ##### ######### ##### ########### ###
#   #. . .  #     #.# #   #       # # # #
# ### ### # ##### # # # ### # ### # # # #
# #. .#   #     # #. .# #   #   #   # # #
# # ######### ### ### # # ##### ##### # #
# #.#. . . .#   # # #.  # #   #         #
### # ##### ### # # # ### # # ###########
#. .#.    #. .#   #  .#   # #           #
# ### ####### ####### # ### ########### #
#. . .      #. . .  #.# # #   #     # # #
# ### # ### ### # # # # # ### # ### # # #
#   # #   #   # #.# #.# #   # # # # #   #
# # # ##### # ### ### # # ### ### # #####
# # #     # #   #. . .  #     # # # #   #
# # ##### ##### ### ######### # # # ### #
# #     #   # #   #         #   # #   # #
# # ### ### # ### ######### ### # ### # #
# # #   #   #   #         #   #   # # # #
# # # # # ##### ##### ### # # ### # # # #
# # # # #       # #     # # # #     # # #
# # # ########### # ##### # ### ##### # #
# # #         #   #     # #       #   # #
# # ### ######### ##### # # # ##### ### #
# #   #     #       #   # # # #       # #
# ####### ### ##### # ### # ### ####### #
#   #   #     #   # # # # #   # #       #
# ### # ####### # ### # # ### # # #######
#     #         #   # #     #           #
#########################################
