######### ###############################
#   #    . .                #     #     #
# # # ### # ############# ### ### # ### #
# # # #   #. . . .      #     # #     # #
# # # # # # ### # ############# ####### #
# #   # # #   # #. . . . .      #     # #
# ####### ### # # ####### ########### # #
# #   #     # # #       #. . .      # # #
# ### # # ### # ####### ##### ##### # ###
#     # # #   #   #   # #   #. .# # #   #
####### # # ##### # ### # # ### # # ### #
# #     # # #     # #   # # #. .# #   # #
# ##### # # ####### # ### # # # # # # # #
#   #   # #       # #     # #.# # # # # #
### # # ##### ### # ##### # # ### # # # #
# # # #     #   # #     # # #. .#   # # #
# # # ### # # ### ##### # # ### ### ### #
# # # #   # #   #     # # #   #.  # #   #
# # ### # ##### ####### ####### # ### ###
# # #   # #   # #     #      . .#   # # #
# # # ### # # # # ### ####### # ### # # #
#     #   # #   # #   #    . .# #   #   #
##### ##### # # # ##### ### ### # ##### #
#     #     # # #       #. .#   #     # #
### ### ### ### ##### ### ########### # #
#   #   #   #   #     #  . . .#     # # #
# ####### ### # # ##### # ### # ##### # #
# #       #   # # #     #   #.#       # #
# ######### ##### # # ##### # ######### #
#       #   # #   # # #   # #. . . .    #
# # ### # ### # ##### ### # # ##### #####
# #   # #   #   #   #     # #     #. .  #
# ### # ### ##### # ##### # ##### ### # #
#   # # # #       #     # #   #   # #.# #
### # # # ############# # # ### ### # # #
#   # # # #       #     # #   #     #.# #
##### ### # ##### ########### ####### # #
#     #   # #     #         #       #.# #
# ##### ### # ############# ####### # # #
#       #   #                       #.# #
##################################### ###
