########################### #############
#     #   #              . .            #
##### # ### ##### ####### ####### ##### #
#     #     #     #      . .    #     # #
# ########### # ######### # ### ##### # #
#             # #         #.  #     # # #
####### ######### ##### ### # ##### ### #
#         #     # #   # #  .# #. .# #   #
# ##### # ##### # ### ### # ### # ### ###
# #     #       #   #   # #. . .#. .#   #
### ##### # ####### ### # ### ### # ### #
#   #     #       #   # #   #   # #.  # #
# ################# # # # # ### ### ### #
#       #           # # # #   # #. .#   #
##### ### # ######### # ### # # # ### ###
#   #   # # # #   #   #   # # # #.# # # #
# ##### ### # # # # ##### ### ### # # # #
#   # #   # # # # # #   #     #. .#   # #
### # ### # # # # ### # ####### ####### #
# # # # # # #   #     #        . .      #
# # # # ### ################### # #######
# # # #       #       #         #. . . .#
# # # # # # # # ####### ############# # #
# # #   # # #   #   #   #     #. . .# #.#
# # ##### # ##### # # ### ##### ### ### #
# # #     # #   # # #     #. . .#  . .#.#
# # ### ### # # # ######### ######### # #
# #   # # #   #   #    . . .#       #.#.#
# ### # # ######### ### # ######### # # #
# # # # #           #  .# #       #  . .#
# # # # ######### ##### ### ##### ### # #
# # #   #         #  . .#   #   #   # # #
# # ####### # ### # # # # ### # ### ### #
# #   #     # #   # #.# # #   # # #     #
# ### # # ##### ### # # # # ### # ##### #
# #   # # #     #   #.# #     # #   #   #
# # ##### # ##### ### # ########### # # #
# #       #   #   #. .#     #     # # # #
# ############# ### # ##### # ### # # # #
#               #  .#     #   #   #   # #
################### #####################
