##### ###################################
#  . .              # #   #             #
# # ####### # ##### # # # ### ###########
# #. . .  # #   #   # # #               #
# ### # # ##### ##### # ############### #
#   # #.#     #                   #   # #
### # # ##### # ##### ########### # # # #
# # # #.  #   # #   #       #   # # # # #
# # # # ### # # # ### ##### # # # # ### #
# # # #.#   # #   #     #   # # # #     #
# # ### # ######### ##### ### # # #######
# #   #.# # #       # #   #   # # #     #
# # # # # # # # ### # # # ##### # # #####
# # # #.# #   #   # #   # #   #   # #   #
# ### # # ##### # ######### # ##### # # #
#   # #.#     # #           #   #     # #
### # # ### # # ############# ### ##### #
# #   #.  # # #       #     # #   #   # #
# ##### # # ######### ##### # # ##### ###
#  . . .# #         #     #   #     #   #
### ##### ######### ### ########### ### #
#  . . .#   #     #   #         #     # #
# ##### ### # ### ### ### ####### ##### #
# #   #.#   #   #   #   #     #   #     #
# ### # ########### # ##### # # ### #####
#     #. .        # # #   # # # #   #   #
####### # ####### # # # ##### # # ### # #
#     # #.      # # # #   #   #   #   # #
##### # # ##### # # # ### # # # ### ### #
 . .#   #. .  # #   # #     # # #   # # #
### ####### # # ##### ######### # ### # #
#. .#. . . .# #   #   #         # #   # #
# ### ####### # # ##### ######### # ### #
#.#  .#   #   # #       #           #   #
# # # ### # # # ### # ### # ######### ###
#.# #.#   # # #   # #     #   #     # # #
# ### # ### ##### # ####### ####### # # #
#. .#.# #   #     #   #   #     # #   # #
### # # ### # ######### # ### ### ##### #
#  . .#     #           #   #           #
#########################################
