########################### #############
#         #      . .#. . .#. .          #
# ####### # # ### # # ### ### # ####### #
# #   #   # # #  .#. .# #. . .#       # #
# ### ### # ### # # # # ########### # # #
#   #   # #   # #.# # # #       #   # # #
### ### # ### ### ### # # # ### # ### # #
#   # # #     #. .#   # # # #     #   # #
##### # ####### # # ### # # # # # ##### #
#   # #    . . .# # #     # # # # #     #
### # ##### ### ### # # ##### # # # ### #
#. . . . . .#   #   # # #     # # # #   #
# ### ##### # ### ### # # ### # # # #####
#.#   #   # # #   # # # # #   # # #     #
# # ### # ### # # # # # # ##### # ### # #
#.# # # #   # # # #   # # #     #   # # #
# # # # ### # ### ##### # # ######### # #
#.#   # # #   #     #   # #     #     # #
# ##### # ##### # ### ### ##### ### ### #
#. . .#   # #   #   # # # #     #   #   #
# ### ##### # # ### # # # ####### # # # #
# # #. . .# # #   # #   #     #   # # # #
# # # # # # ##### ########### # ##### ###
#   # # #.#     # #       # # # #   #   #
# ### # # ##### # # ##### # # ### # ### #
# #   # #. .  #   # #     # #   # #   # #
# # ### # # # ####### ##### ### # ### # #
# # # # # #.#   #         #     #   #   #
# # # # # # ### # #######################
# # # # # #.# # #. . .                  #
### # # # # # # # ### ### ######### #####
#   # # # #.#   #.#. .  #         #     #
# ### # # # ##### # # # ##### # # ##### #
#   # # # #. . . .#.# # #   # # #   #   #
# # # # # ######### # # ### ### ##### # #
# # #   #       #. .# #     #   #     # #
### ############# ########### ### ### ###
#         #     #.#   #       #   #   # #
# ######### ##### # # ##### # # ####### #
#           #    .# #       # #         #
################# #######################
