# #######################################
#. .    #. . .        #. .      #       #
# # ### # ### ######### # ### ### ##### #
# #.#   #. .#. . . . . .#. .#   # #     #
# # # ##### ######### ##### ### ### #####
# #.#     #.#       # #. . .  #   # #   #
# # ####### # ##### # # ##### # # # # # #
# #.#. . . .#   #   # #.#   # # #     # #
# # # ##### # ##### # # # ### # ### #####
# #. .#   # # #   # # #.#     #   # #   #
# ##### # ### # # ### # ##### ### ### # #
#       #     # #     #. .  #   # #   # #
######################### # ##### ##### #
# #  . . . .#  . .#. . .#.#     # #   # #
# # # ##### # # # # ### # ##### # # # # #
# # #. . .#.# #.#. .#  . .  #   # # #   #
# # # # # # ### ### ######### ##### #####
#   # # #.#. . .#   #. . . .#           #
# ### ### ########### ##### ##### #######
# #   #. .#. . . .  #.#   #.    #   #   #
### ### # # ##### ### ### # ### ##### # #
#   #. .# #. .  #. . .#   #. .#   #   # #
# ### # ##### ### ##### ##### ### # ### #
# #. .# #. . .  #   #   #. . .# #   # # #
# # ##### ##### ### # ### # # # ##### # #
# #. .#. .#   #   # # #  .# #   #. . .# #
# # # # ### # ### # # # # ####### ### # #
# # #. .#   #   # # # # #.#. .  #.# #.# #
# # ##### ##### # ### # # # # # # # # ###
# # #     #   # #     # #. .#.# #.  #. . 
# # # ####### # ####### # # # ### #######
# # # # # #   #       # # # #.#. .#     #
# # # # # # ##### ##### # # # # ### ### #
# #   # # # #     # #   # # #. .    # # #
# ##### # # ### # # # # # # ### ##### # #
#   #     #   # #   # # # #   # #     # #
# ### ####### ####### # # ### ### ### ###
# #   #     #   #     # #   # #     #   #
# # ####### ### # ### # ### ### ####### #
#           #     #   #   #     #       #
#########################################
