####################################### #
# #    . . .#  . . . . . . .#          .#
# # ### ### # # # ######### # ######### #
# # # #.#  .# #.# #       #.# #. . . . .#
# # # # ### ### ### ##### # ### ### # # #
# # # #. .#.#. .#   # # # #. . .#   # # #
# # # # # # # ### ### # # ##### # ### # #
# #   # #.#. .# # # #   #       # #   # #
# # ##### ### # # # ### ######### # ### #
# # #  . .#   #   #   #   #       # #   #
# ### # # # ##### ### ### # ####### # ###
# #   #.# # #     # # #   #       # # # #
# # ### # # ####### # # ########### # # #
# # #  .# # #       # # #           # # #
# # ### # # # ##### # # ### ######### # #
#   #. .# #       #   #     #     #     #
##### ### # ########### ### # ### # # # #
 . . .#   #   #   # #   #   # #     # # #
# ##### # ##### # # # ### ### ### # # ###
# #     # #   # #   # #   #   #   # #   #
# # ### # # ### ##### # # ### # ### # # #
# # #   # #   #       # # #   # #   # # #
# # ##### ### ########### # ##### ##### #
# #     # #     #         # #     # #   #
# # # ### ##### # ### ##### # ##### # # #
# # #   #     # #   # #     #       # # #
# ##### ##### # ##### ### ########### # #
#   # #   #   #   #   #   #         # # #
# # # # # ####### # ### # # ######### # #
# # # # #       #   #   # #       #   # #
# # # # # ### # ##### ### # ##### ### # #
# #   # #   # # #     #   # #   #     # #
# ##### ### # # # ### # ##### ####### # #
#     #   # # # # #   #   #   # #   # # #
######### # ### ### ##### # ### # # ### #
#         # # #   # #   # #   #   # #   #
# ######### # ### ### # # ### ##### # ###
#   #     # # # #   # # #   # #   # #   #
# # # ### ### # # # # # ##### ### # ### #
# #     #       # #   #           #     #
#########################################
