############### #########################
#     #        .    #. . .  #         # #
# ### ##### ### ##### ### # # ####### # #
# # #   #   #  .#. .#.# #.#   #. . .# # #
# # ####### # # # # # # # ##### ### # # #
#   #       # #.#.#. .# #. . . .  #.# # #
# ### ### ##### # ##### # ######### # # #
# #   #   #. . .#. . .# #   #     #.#   #
# # ### ### # # ##### # ##### ### # #####
# # #   #  .# #     #.#   #   #   #.#. . 
# ### # # # # ####### ### # ### ### # ###
#     # # #.# #. . .#. .  # #   #  . .  #
######### # ### ### ### ### # ######### #
#   #   # #. . .# #. . .    #       # # #
# ### # # # ##### # # ############### ###
# #   #   # #     # # #             #   #
# # # ### # # ### # ### ########### ### #
# # # #   #     # #   #   #       #   # #
# # # # ####### ##### # ### ####### ### #
#   # # #     #     #       # #   #     #
##### # # ### ####### ####### ### ### ###
#     # # # #       #           #   #   #
# # ### # # ####### ####### ### ### #####
# # #   #         #       # # #   #     #
# # # # ### ######### ### # # # ####### #
# # # #     #       #   # #   #     #   #
# ### ##### # ##### # # # ####### ### ###
#   #     # # #   # # # #       #       #
# # ##### # ### ### # ######### # #######
# #     # # #     # # #     #   #       #
# ### ### ### ### # # # ### # # # ### # #
# # #   #     # #   # # # # # # #   # # #
# # ### ####### ##### # # # # # ### # # #
# #   #     #   #     # # #   #   # # # #
# ### ### # # ### ##### # ####### # ### #
#   #   # # # #   #     #   #   # # #   #
# # ### ### # # ########### # # # # # # #
# #   #   # #   #         # # #   # # # #
# ####### # ##### ####### # ######### # #
#         #       #       #           # #
#########################################
