########### #############################
#. .# #    .              #             #
# # # # ### ### # ######### ##### ##### #
#.#.# # #  .  # #     #         # #   # #
# # # # # # ### ### # # ####### ### # # #
#.#.#   # #.#   #   # # #     #   # #   #
# # ####### # # # # ### # ### ### # #####
#.#. .#  . .# # # # #   # #     # #     #
# ### # # # # # # ### ##### ##### #######
#. .#.# #.# # # #   #       #     #     #
# # # ### # # ##### # ####### ##### ### #
# #.#. . .# #     #   #     #         # #
# # ####### # # # ##### ### ######### # #
# #. .#     # # #   #   # #         # # #
# # # ######### ### # ### # ####### # # #
# # #.#. .    #   # #     # #     # # # #
# # # # # ### ### # ### ### # ##### # # #
# # #. .#. .# # # #     #   # #     # # #
# ######### # # # ####### ### # ####### #
#         #.#   #   #   #   # #   # #   #
########### ##### # # # ### # ### # #####
 .#. . . . .  #   #   #   # #     # #   #
# # # ### ### # # # ##### ######### # ###
#. .# #   # # # # # #   #         #     #
##### # ### ### # ### # ### ### ### ### #
#   # #   #     #     #   #   #       # #
# # # # # ##### # ####### ### ####### # #
# #   # #   #   # #     #   #       # # #
# # ### # # ####### ### ### ####### ### #
# # #   # #     #   #           # # #   #
# ### ######### # ##### ### # # # # #####
#   # #       # # #   # #   # # # #     #
# # # # ####### # ### ### ### # # ##### #
# # # # #       #   # #   #   #   #   # #
### # # # ### # # # # # ####### ### ### #
#   # #   #   # # # # # #     # #   #   #
# ### ##### ### # ### # # ### ### ### # #
#   #   # # #   # #   # # # #     #   # #
### ### # # # ##### ### # # ####### ### #
#   #   #   #         #   #         #   #
#########################################
