############################# ###########
#  . . .#    . . . .#        .          #
### ### ##### ##### ######### # ####### #
#. .#  . . . .#. .#. .#  . . .# #       #
# ####### ##### # ### # # # ### # #######
#.#       #. . .#.# #.# #.# #   # #     #
# ######### ##### # # ### ### ##### # # #
#. . . . . .    #.#  . . .#   #     # # #
# ############### ##### # # ### ##### # #
#           #. . .#     # #         # # #
############# ##### ##### # # ####### # #
#      . . .#.#     #     # #   #     # #
####### ### # # ##### ##### ### # ##### #
 . . . .#  . .# # #       #   # # #     #
####### ##### # # # # # # # ### # # #####
#   #   #   # # #   # # # #   # # # #   #
# # # ##### ### ### # ### ### ####### ###
# # # # #   #     # #   #   #   #       #
# ### # # ### # # ##### # ##### # ##### #
#     # #   # # #     # #   #   # #   # #
### ### ### # # ##### # # # ##### ### # #
#   #   #   # # #   # # # #           # #
# ### ##### # # # # # # ############### #
# # # #       #   # # #       #     # # #
### # ##### # ##### # # ##### ##### # # #
#   #   #   #   #   # # #   #         # #
# ##### # ##### # ### ### # # ######### #
# #   #   #     # #       # #   #     # #
# # ####### ##### # # # ### ##### ### # #
# #         #     # # #   #     # #   # #
# ##### # ##### ### # ### ##### # ##### #
# #   # # #     # # #   # #   # #       #
# # # # ### # ### # ### ##### # ### ### #
#   #   #   #   # #   #     #   #   #   #
######### # # # # ################### # #
#   #     # # # #           #     #   # #
# ### # ##### # ########### # ### # # # #
#     # #     #       #   # # # #   # # #
######### ### # ####### # # # # ####### #
#         #   #         # #   #         #
#########################################
