##### ################################# #
#   #. .#    . . .#  . .#    . . .#  . .#
# # ### ##### ### ### # # ### ### # # ###
# # #  . . . .#  . . .#.#   #.#  .# #. .#
# # # # ####### ####### ##### ### # ### #
# # # # #     # # #    . . .#. .#.# # #.#
# ### # # ##### # # ####### ### # # # # #
#     # #     #   # # #   #. . .#.#   #.#
##### # ##### ##### # # ######### ##### #
#     # # #   #     #   #       #. . . .#
####### # # ### # ##### # ##### ##### # #
#       # # #   # #       #   #       # #
# ##### # # ##### # ##### # ########### #
# #     #     #   #   #   #         #   #
# ########### # ####### ### ### ### # # #
#         #     #       #   #   # # # # #
# ##### # ##### # ########### # # # ### #
# #   # #     # # #   #       # # #   # #
# # # # ### # ### # # # ####### # ### # #
# # # #   # #   #   # #   #   # #       #
# # # ### ##### ######### # # # ##### # #
#   #   #     # #   #   #   # #   #   # #
# ### # ####### # # # ######### # # ### #
#   # # #       # #   #         # # #   #
# # # # ######### ##### ##### ##### # # #
# # # #   #       #     #     #     # # #
# # # ### ### ##### ##### # ### ##### # #
# # #   #   #       #     # #   #     # #
# # ### ### ######### ##### # ##### ### #
# #   # #   #     # # #     # #     #   #
# ### # # ####### # # ####### # ### # ###
#   # # # #     #   # #       # #   # # #
### # # # ##### ### ### ####### ##### # #
#   # # #     # # #   # #   #     #   # #
# ### ######### # ### # # ### ### # ### #
# # #       #   #       #   #   # #   # #
# # ####### # ############# ##### ### # #
# #       # #         #       #   # # # #
# ####### # ######### # # ### # # # # # #
#         #         #   # #     #   #   #
#########################################
