############################# ###########
# #       #     #     #      .  #. . . .#
# # ####### ### ##### ### ### ### ##### #
#   #     #   # #   # #   #  . .#. .#. .#
# ### ### ### # # ### # ### # # ### # # #
# #   #     # # # #   # #   # #. .#.#.# #
# ####### # # # # # ### # ####### # # ###
#         # # #     #   # #. . .#. .#. .#
########### ##### ##### ### ### ##### # #
#     #         #     #   #.# #. . .# #.#
# ### ######### ##### ### # # ##### # # #
#   #         #           #.# # #. .# #.#
########### # ####### ##### # # # ##### #
#     #     # #       #  . .# #. .#  . .#
# ######### # ##### ### # # # # ### # # #
# #         #       #   #.# # #.# # #.# #
# ### ### ####### ### ### ### # # # # ###
#     #   #     # #   #  . .#  .#   #. .#
##### ##### ### ### # ### # ### ####### #
#     #   #   # #   #   # #. .#. . . . .#
# ##### # ##### # ##### # ### ### ##### #
# # #   # #     # #   # # #. .#   #   # #
# # # ######### # ### # ### ### ### ### #
#   # #   #     #     #   #.#   #       #
##### # # ##### ######### # #############
#   #   #     #   #       #. . .        #
# # ######### ### # ##### # # # #########
# #   #   # #       #     # # #. . . . . 
# ### # ### ####### # ##### # # #########
# #   #         # # # # #   # #         #
# ############# # # # # # # # ###########
#   #     # #   #   #   # # #     #     #
### ### # # # ########### # # ### # ### #
# # #   # #   #   #       # # #   #   # #
# # # ### ### # # # ### # # ### ####### #
# #   # #       #   #   # #   #         #
# ##### ######### ### ### ### ###########
# #             # #   #   # #   #     # #
# # ### ####### ### ### # # # # # ### # #
#   #         #     #   #   # #     #   #
#########################################
