####### #################################
#      . . . .                          #
########### # ### ##### ####### #########
#. . . . .# #.  #     #       #   #     #
# ####### # # # ##### # ######### # ### #
#.# #. . .# #.# #   # #         # # # # #
# # # ####### # ### # # ##### # # # # # #
#.# #.#  . .#.#   #   # #   # # #   # # #
# # # ### # # ### ####### ### # ##### # #
#.# #. . .#. .  #   #   #     # # #   # #
# # ##### ### # # # # # ####### # # ### #
#.#   #   #   # # #   #       # # # #   #
# ### # ### ### # ####### # # # # # # ###
#.  # # #   # # #       # # # # #   #   #
# # # ### ### # ####### # ### ### ##### #
#.# # #   #   #   #   # #   #         # #
# ### # # # ### # ### # ### # ######### #
#. .#   # # #   #     #   # # #     # # #
# # ####### # # ####### ### # # # ### # #
# #. .  #   # #   #     #   # # #     # #
# ### # # ### ##### # # # ### # ####### #
#   #.# #     #     # # # #   #   #   # #
##### # ####### ### # # # ##### ### # # #
#. . .# #   #   #   # # #     # #   # # #
# ### # # # # ### ### # ##### # # ##### #
#.#   # # #   #   # # #     #   # #     #
# # ### # ##### ### ####### ### # ### # #
#.# #   # #     # #   #   #   # #   # # #
# # # # ######### ### # ##### ##### # # #
 .# # #       #     #   #   #       # # #
##### ##### # # ### ### # ########### # #
# #     #   # #   #       #   #     # # #
# # # ### ### # ########### # ### # # # #
# # # #   #   #         #   #   # #   # #
# # ### ####### ######### ##### # # ### #
# # #   #   #   #         # # # # # #   #
# # # ##### # ### ######### # ### # # ###
# # #       # #   #   #   # #   # # # # #
# # ######### # ### # # # # ### # # # # #
#                   #   # #       # #   #
#########################################
