################### #####################
#        . . . . . .        #   #     # #
# ####### ####### # # ####### # # ### # #
# #     #.#. . .# # #   #     # # #   # #
# ##### # # ### # # # # # ##### # ##### #
#     # #. .  #.# # # # # #   #         #
### ### # ##### ### # # # # #############
# #     # #. . .#   # #     #     #     #
# ####### # ##### # # ####### ### # ### #
#       # #.#   # # #           #     # #
####### # # # # # # ############# ##### #
 . . .#   #.# #   #   #         #   #   #
##### ##### ########### ### ### ### # ###
#    . . .#. .      #     # #   # # #   #
######### ### ### # # ##### # ### # # # #
#       #.#. .  # # # #     #   #   # # #
# ##### # # # # # ### # ### ### ####### #
# #     #.#.# # #     #   #   # # #   # #
# ####### # ### ### ##### ##### # # ### #
#   #   #.#. .#   #     #   #   # # #   #
### ### # ### ### ##### ### # ### # # ###
# #   #  . .#. .#     #   # #   #   # # #
# ### ##### ### ### ##### # ### ### # # #
#   #   #  . . .  #     # #   #   # #   #
### ### # # ### # ### # # ####### # #####
# #   #   # # # #   # # #     #   #   # #
# ### ##### # # ##### # # # # ####### # #
#           # # #     # # # #           #
# ### ####### # # # # # # ########### ###
# #   #   #   # # # # # #   #       #   #
# # ##### ### ### ### # ### ####### ### #
# #     #   #   # #   #   #         #   #
# ##### ### ### # # ##### ########### # #
# #   #   # #     #     #         #   # #
# # ### ### ##### ##### # ####### # #####
# #   #   #       #   # #       # #     #
# ### # # ########### # ####### ####### #
# #   # #     #     # #       # #     # #
# # ### ##### # ##### ######### # ##### #
#     #     #       #           #       #
#########################################
