################################# # #####
#     #   #     #         #     #.#. . .#
# ### # ### ### # ######### ### # ### # #
# # # # #     #   # #   #   #   #. .# #.#
# # # # # ######### # # # ######### # # #
# # # # # #       # # # # #. . .  #.# #.#
### # # # # ##### # # # # # ### ### ### #
#   # # # #   # #   # # #. .#. .#. .#. .#
# ### # # ### # ##### ### ### ### ### ###
# # # # #   # #       #. .  #. . .#  . .#
# # # # ### # # ####### ############### #
# # # #   # # # # #. . .#      . . .#. .#
# # # ### # # # # # ##### ##### ### # # #
# # # # # # #   #  .#     #    .#  . .# #
# # # # # # # ##### ########### ####### #
#   # #   #        .#. . . .#  . .#     #
# ### # # ######### # ##### ### # #######
# # #   # #        . .#    . .# #. .    #
# # ##### # ### ############# # ### ### #
# #   #     #   #     #   #  .#   #.#   #
# ### ####### ##### # # # ### ##### #####
#   #     #   #     # # #    . . .#. . .#
### ##### # # ##### ### ######### # ### #
# #     # # # #   #     #   #   #.#   #.#
# ##### # # # # # ####### ### # # ##### #
#         # # # #   #     #   # #. .#. .#
######### ### # ### # ##### ####### # # #
#       #     #   # #     #        . .# #
##### # ### ####### ##### ########### # #
#     #     #     # #   #             # #
# ########### ### # ### ######### ##### #
#   #         # # # #       #     #   # #
# # ########### # # # ##### # ##### ### #
# # #       #     # # #   # #     #   # #
### # ##### # ##### # ### # ##### ### # #
#   # #   #   #     #   # #     #     # #
# ### # ### ####### ### # ##### ####### #
# #   # # # #     # # #   #     #       #
# ##### # # ### # # # ##### ### ##### # #
#       #       #           #         # #
#########################################
