######### ###############################
#. . . . .    #     #     #     #       #
# ##### # ### # ### ##### ##### # ##### #
#. .#   #   #     #     #     # #   #   #
# # ####### ### # # # ####### # ##### ###
# #. . .  #   # # # #           #       #
# ### # # ### # # # ######### ### #######
#   # #.#   # # # #   #     #   # #     #
### # # ### # ### ### ##### # ### # ### #
#   # #.#   #   #   #       #     #   # #
# ##### # ##### ### ############### ### #
#     #.# #     #   # #         #   #   #
# ### # # # ##### ### # ####### # ### ###
#   # #.# #   # # #   # #   #   #   #   #
##### # ##### # # # ##### # # ##### #####
#     #. .#   #   #       #       #     #
# ##### # ################### ######### #
#   #   #. . .      #                   #
# # ##### ### ### ### ####### ###########
# #     # #. .  #     #     #           #
####### # # ########### ### ####### #####
#     # # #. . .#. . . . .#       #     #
# ### # # # ### # ####### ### ### ##### #
#   # # # #   #. .      #.  # #   #   # #
### # # # ############### # # ##### ### #
#   # # #   #       #. . .# #         # #
# ### # # ### ##### # ### # # ### ### # #
# # # # # #   #. .# #.#   # #   # #   # #
# # ### # # ### # ### # ### ### # # ### #
# # #   #   #. .#. . .# #     # # # # # #
# # # ####### # ### ##### # ### # # # # #
# # # #    . .# #   #     # #   # # #   #
# # # # ### ### # ### ####### ### # #####
#   # # #  .#   # # # # #     #   #     #
### ### # # ##### # # # # ##### ### ### #
# #     # #. .  # # # #   #     #   #   #
# ### # # ### ### # # ############# # ###
#   # # # # #. .# # #     #     # # #   #
### ### # # # # # # # ### # ### # # #####
#       #   # #.#   #   #     #   #     #
############### #########################
