##### ############################### ###
#    .  #. .    #. . .      #. .    #.# #
# ### # # # ### # ### ####### # ##### # #
# #  .# #.#. .# #. .#. .#. . .#. .#. .# #
# # # ### ### # ### ### # ####### # ### #
# # #. . .# #.#   #.# #. .      #.#.# # #
# # ####### # ##### # ######### # # # # #
# # #       #. . .#. .#     # # #. .  # #
# # # ######### # ### # ### # # # ##### #
# #   #       # #. .#.  # # #   #   #   #
# ##### ##### # ### # ### # ######### ###
#         # # #   #. .    #             #
# # ### # # # ### ### # ######### ##### #
# #   # #   #   #   # #         #     # #
# ### ######### ### # # ####### ##### # #
#   #   #         # # #       #   #   # #
# # ### ########### # ##### # # ### ### #
# #   #     #   #   # #   # # # #   #   #
# # ####### ### # # # # # # # # # #######
# #       #     # # #   # # # # #       #
# ### ########### # ####### # # ####### #
#   # #           # #       # #     #   #
### # # ##### ### ### ##### # # # # #####
# # # # #       # #   #     # # # #     #
# # # # ##### # ### ### ##### # ##### ###
#   # #   #   #   # #   # #   #     #   #
##### ### # ##### # ##### # ########### #
#       # # #     #       # #         # #
# # # ### # # ### ##### ### ######### # #
# # #   # # #   #     #   #   #         #
# # ### # # ######### ### ### ####### # #
# #   # # #         #   #   #       # # #
# # # # # ######### ############### # # #
# # # # #         #             #   # # #
# # # ######### ############# # # ##### #
# # #         # #         #   # #     # #
# # ### ##### # # ######### # # ##### ###
# #   #     # # #   #   # # # # #   #   #
# ######### # # # ### # # # # # ### # ###
#         # # #       # #   # #     #   #
#########################################
