########### #############################
#        . .#. .              #   #     #
### ### # # # # ### ######### # # ##### #
#   #   #.# #.#.  #         #   #       #
# ### # # ### # # ### ##### #############
#   # # #. . .#.#   #     #     #   #   #
# # # # ### ### ####### ####### # # ### #
# # # #   #   #. . . .#       #   #   # #
# # ### # ### # ##### ##### ########### #
# #   # # #   #   #. .    #     #       #
##### # # ######### # # # ##### # #######
#   # # #     #. . .# # #     #         #
# ### # ##### # ### # ####### ######### #
# #   #     # #.#   #   #   #   #     # #
# ### ####### # ####### ### ### ##### # #
#   # #       #. . . .#   #   #     # # #
### # ### ### # # # # ### ### # # ### # #
# # # #   #   # # # #.  # #   # #   # # #
# # # # ### ### # # # ### # ####### # # #
# #   #   # #   # # #. .# #. .  # #   # #
# ####### # # ### ##### ### # # # #######
# #       # #   #   # #. . .#.#   #     #
# ####### ##### ### # ####### ##### ### #
# #     # #     # #   #. . . .  #. . .# #
# # ### ### # ### ##### ### ##### ### # #
#   #   #   # #  . . . .#   #. . .  #.# #
####### # # ### # ########### ####### ###
#     #   # #   #. . .#. . . .  #   #. . 
##### # ### # ### # # # ##### # # # # ###
#     # #   # #   # #. .#   # # # # #   #
# ####### ### # # # ####### # # ### ### #
# #       #   # # #     #   # #       # #
# ### ##### # # ######### ### ######### #
#     # #   # #     #     #   #   # #   #
####### # ### ### ### ##### # # ### # ###
# #     # #     #     #   # # #   # # # #
# # ####### # ######### # # # ### # # # #
#   #       #     #   # #   #   # #   # #
# ####### # ##### # # # ######### ##### #
#         #     #   # #                 #
#########################################
