############# # #########################
#   # #. . .#.#.                      # #
### # # ### # # # ######### # ####### # #
#   # #.  #. .#.#   #     # # #     # # #
# ### # ####### ### # # # ### ##### # # #
# # #. .#   #  .  #   # #   #     #   # #
# # # ### # # # ####### ### # # ##### # #
#. .#. .# #   #. .#   #   # # #     # # #
# # ### ######### # # # # # ##### # ### #
#.#.  #. .#    . .# # # # #     # #     #
# # ##### ##### # ### # # ##### # ### ###
#.#. . . .#. . .# #   # #     # #   #   #
# ######### ### # # ### ####### # # #####
#. . . .#. .#   # #     #       # #     #
# ##### # ### ### ##### # ####### ##### #
# #    . .#   #   #   # # #   #       # #
# # ### ####### # # ### # # ### ### # # #
# # #   #       # #     # #   #   # # # #
### ##### # ### # ####### ### ### # # # #
#   #     # #   # #             # # # # #
# ### # # ### ### # ########### # ### # #
# #   # # #   #   # # #       # # #   # #
# ### ### # ### ### # # ##### # # ### # #
#   #   # #   # #   # #   # # # #   # # #
### ### # ##### # ### ### # # ##### ### #
#   # # # #     # # #   # # # #     #   #
# ### # ### ##### # ### ### # # # ### # #
#     #   #   #   # # #   # #   # #   # #
# ##### # ### ##### # # ### ####### # ###
# # #   #   #               #       #   #
# # # ### # ####### ################# # #
# # # #   #       #   #       #   #   # #
# # # # # ####### ##### ### # ### ##### #
# # # # #   #   #       #   # #         #
# # # # ### ### ######### # # # # ##### #
#   # #   #     #     #   # # # # #     #
##### ########### ##### ##### ### # #####
#     #       #       # #   #   # # #   #
# # ### # ##### ####### # # ### # # ### #
# #     #       #       # #     # #     #
#########################################
