######### ###############################
#. . . . .                      #       #
# ### ################# # ####### # #####
#.#   #. . .  #. . .  # #     #   #     #
# ##### ### ### ### # # ### ### ####### #
#. . . .  #. .#.#. .# #   #     #   #   #
# ### ### ### # # ### # ######### # # ###
#   #   #   #. .#.# # #     #     # #   #
# # ### ##### ### # # ### ### ##### ### #
# #   #     # # #.#   # #     #   # #   #
# # # ##### # # # ##### ####### # #######
# # #   # # #   #. . . .    #   # #     #
# # ### # # ########### ### ##### # ### #
# # # # # #     #     #. .#     # # #   #
# # # # # ##### ##### # # ##### # # #####
# # #   # #   #       # #.  # #   #. . . 
# # ##### # # ##### ### # # # ##### #####
# # #   # # # #   # #   #.#   #. .#.#   #
# # # # # # # ### # # ### ##### # # # ###
# # # #   # #     # # #  .    #.#. .#   #
# # ### ### ######### ### ##### ####### #
# #         #       #   #. .#. .      # #
# ##### ### ####### # # # # # ####### # #
# #   #   # #     # # # # #. .#   # #   #
# # # ### ### ### # ### ##### # # # #####
#   #   #     # # #   # #   # # #     # #
# # # ######### # ### # # # # # ##### # #
# # #     #     #     #   # # #     #   #
# ####### # ############### # ######### #
#       #       #     #   # #           #
############### # ### # ### ### ##### # #
#         #     # # # #       # #   # # #
######### ####### # # # ### # # ### # ###
#     #   #       # # # #   # #     #   #
# ### ### # ####### # ### ### ### ##### #
#   #   #   #     #       #     # #     #
### ### ######### ######### ### # # #####
# # #   #       #           # # # # #   #
# # # # ### ### ######### # # # # # ### #
#   # #     #             # #   # #     #
#########################################
