# #######################################
#.    #. . . . .                  #     #
# ### # ####### ### ####### ### ### ### #
#. .# #.#. .# #.  #       #   # #   #   #
# # # # # # # # ####### # ### # # ### ###
# #.# #. .#.# #.#. . .# #   # #   # #   #
### # ##### # # # ### # ### # ##### #####
#. .# #. . .  #. .  #.#   # #     #     #
# # ### ######### ### ### ### ##### ### #
#.# #. .# #. . .# #. .# #   #     #   # #
# # # ### # ### ### # # ### ##### ##### #
#.# #.    #.#  . . .#   #   #   #   # # #
# ### ##### ### ######### # # ##### # # #
#. . .    #. .# #   #     # #       #   #
# ####### ### ### # # # ### ### ####### #
# #. . .#   #. .# #   # #   #   #     # #
# # ### ##### # ####### # ####### ### # #
# #.# #. . .# #. .  #   #       # #   # #
### # ##### # ### # ########### # # ### #
 . .#    . .# # #.#           #   #   # #
### ##### ### # # ##### ##### ######### #
#   #   #.# #   #.    #     #     #     #
# ### # # # ##### ### ##### ### # # #####
# #   # #.#  . .#.  #     #   # #       #
### ### # ### # # # # # ##### # ### #####
#   #   #. .#.#. .# # #   # # #   #     #
# ######### # ### # # ### # # ### ##### #
#     #    . .#   # #   # #     # #   # #
##### ### ######### ##### ####### # # # #
#   #     #   #   # #       #     # #   #
### ####### # # # # # # ### # ### # #####
#   #       #   # # # #   # # #   #     #
# ### ### ####### # # ### # # # ####### #
# #   #   # #   #   # #   # # # #     # #
# ### # ### # ######### ### # ### # ### #
# #   # # #             #   # #   # #   #
# # ### # ### ######### # ### ##### # ###
#   #   #   # #   #   # # #     #   #   #
####### ### ### # # # ### # # ### ##### #
#       #       #   #     # #     #     #
#########################################
