######### ############# #################
#      . .#. . .    # #. .#             #
##### # ### ### ### # ### ############# #
#     #.#. .  #.  #   # #. . .  #       #
# ##### # ##### # ##### ##### ### #######
# #   #. .#. . .#   #. .  #. .    # #   #
# # ### ### ### ##### # ### ####### # # #
# #   # # #. .#   #. .#.#. .#         # #
# ### # # ### ##### ### # ### ##### ### #
#     # #   #. . . .  #.#. .# #   # #   #
# ##### ### # # # ### # ### # ### # #####
#     #     # # #   # #. . .      #     #
# ### # ##### # ### ### ########### # # #
# #   #     # #   #   # #     #   # # # #
# # ######### # ##### ### ### # ### # ###
# # #         #     #   #   # #   # #   #
# # # ############# ### ##### ### # ### #
# # #       #     #   #         # #   # #
# # # # ### # ### # # # ####### # ##### #
# # # #   # #   #   # # #     # #     # #
### # ##### ### ### # # # ### ####### # #
#   #     #   #   # # #   # #       # # #
# ####### # ##### # # ##### ####### # # #
#     #   # #   # # #       #   # #   # #
# ### # ### # # # # ##### ### ### ##### #
# #   #   #   # # # #   # #     # #     #
# # ####### ### # ### ### # ##### # ### #
# # #     # #   #     #   # #     # #   #
# # # ##### # # ### ### ### # ##### # # #
# #   #   # # #   # #   #   #   #   # # #
# ##### ### # ### ### ### ##### ### # # #
#   #   #   #   #   #         #   # # # #
# # # ### # ####### ############# ### # #
# # # #   # #     #             #     # #
# # # # # ### ### ##### #################
# # # # # #   # #     #   #         #   #
### # # # # ### ### ### # # ### ### # # #
#   # # # #   #   #   # # # # #   # # # #
# ### # ### ##### # ### ### # # # # ### #
#     #           #   #     #   # #     #
#########################################
