# ### ###################################
#.  #.#  . . . .#  . . .# #         #   #
# ### ### ##### ### ### # # ##### ### # #
#. .#. . .#   #.#. .# #.  # #   #     # #
# # ####### # # # ### # ### # ######### #
# #.  #. . .# #. .# #. .    # #       # #
# # ### ### ####### # ####### # ### ### #
# #. . .# #. . .  #. .            # #   #
# ### ### # ### ### ############### # # #
#   #     #   #.#. .#       # #     # # #
# # ######### # # ### ##### # # ### # # #
# #       #   #.#.#   #   # #   #   # # #
# ### ### ##### # # ##### # ######### ###
#   #   #   # #. .  #     #     #   #   #
# # ### # # # # # ### ####### # # # # # #
# #   # # # # # #     #     # #   # # # #
### # # # # # # ####### ##### ##### # ###
#   # # # # #   #   #     #   #     #   #
# ### # # # ##### ### ##### ### ####### #
# #   # # #               #   #   #   # #
# ##### # ##### ######### ### ### # ### #
#   #   #     #         # # #   # #     #
# # # ####### ##### ### # # # # # #######
# # #       #     #   # #   # # #       #
# # ### ### # ### ##### ##### ####### # #
# # # #   # #   #     #     #     #   # #
# # # ### ##### ### # ##### ### # # ### #
# # #     #       # #     #   # # #   # #
# # ####### # # # ####### ### # ##### # #
# #       # # # #       # # # #   #   # #
# ##### ### ### ######### # # ### ### # #
# #   # # #   # #   #     # #   #   # # #
# ### # # ### ##### # ##### # ##### ### #
#   # # #   #       #     # #     #   # #
### # # # ##### ######### # # # # ### ###
# #   #       #   #   # #   # # # # #   #
# # ### # ### ##### # # ####### # # ### #
# #   # # # # #     # #         #   #   #
# ##### # # # # ##### ####### ####### # #
#       #   #   #     #       #       # #
#########################################
