########### #############################
#     #  . .#. . .          # #. . . .  #
# ### # # # # ### ######### # # ##### # #
# #   # #.# #. .#. .#       #. .# #. .# #
# # ### # # ### ### # ####### ### # ### #
# #     #.#   #.# #.#     #. .    #. .# #
# ####### ##### # # ####### ######### # #
#   #   #. . . .  #. . . . .#. .#. . .# #
# # # # # ##### ############# # # ### # #
# #   # #     # #     #     #.#. .#   # #
# # ### ### # ####### # ### # # ### ### #
# #   #   # #       #   # # #.# #   #   #
# ##### # ####### ####### # # ### ### ###
#     # #     # #           #. .# #   # #
# # # ####### # ##### ######### # # ### #
# # #       # #     # #      . .# #   # #
# ######### # ##### ### ##### # # # # # #
#   #       #       #   #. . .# # # #   #
### # ############### ### ### # # ### ###
#   # #   #     #     #  . .# # #   #   #
# ### ### ##### # # ####### # # ### ### #
# #     #     # # # #  . .#.# #   #   # #
# # ### ##### # ### # # # # ##### ### ###
# # #     #   # #   # #.#. .#   #   #   #
# # # # ### ### # ### # ### # # ####### #
# # # # #   #   # #   #.#   # #         #
# ### # # ### ### # ### # ####### ##### #
# #   # #         # #. .#       # #     #
################# # # # ####### ### #####
#   #       #     # #.#     # #   #     #
# ### ##### # ##### # ##### # ### #######
#   #   #   # #     #. . .# #   #   #   #
### ##### # ### ######### # ### # # ### #
# #       #   #     #. . .# #   # # # # #
# ### ####### ####### # # # # ### # # # #
#         # #      . .# # #   #   #   # #
##### ### # ####### # ### # ### # ##### #
#   #   # # #  . . .# #   #   # #     # #
# # ##### # # # ####### ####### # ### # #
# #       #   #.#       #       #   #   #
############### #########################
