##### ####### ###########################
#   #.#     #. . . .    #   #     #     #
### # ##### # # # # # ### # ##### ##### #
#   #. . .#   # # #.#     #     # #     #
# ####### ##### # # ##### ### # # # #####
# #     #.#   # # #.    #   # #   # #   #
# ##### # ### # # # ### ### # # ### # # #
# #   # #. .#   # #.  #   # # # #   # # #
# # # # ### ####### # # # # # ### ##### #
#   # # # #.#  . . .# # # # #   # # #   #
##### # # # ### ##### # # # ### # # # ###
#   # #. . .#. .#     # # #   # # # # # #
# # # # ##### ### ##### # # # # # # # # #
# # #. .# #  . .# #     # # # #     #   #
# ### ### # ### # # ##### # # ### ##### #
#. . .#. .# #. .# # #     # #   # #     #
# ##### # ### # ### # ##### ### ### #####
#.#. . .#. . .# #   # #       #         #
# # # ##### ##### # # ##### #############
#. .# #     #     # #     #             #
####### ##### ##### # ### # ### ####### #
#       #     #     #   # #   # #       #
# ####### ##### # ####### ### # # # #####
# #       #     # #   #     # # # # #   #
# ##### # # ####### # # # ### # # ### # #
#   #   # #   # #   # # # # # # #     # #
# # ######### # # ### # # # ### ##### # #
# #   #     # #   # # # # # #       # # #
# ### # ### ### ### # # ### # ##### ### #
# # #   # #         # #     # # #   #   #
# # # # # # ####### # ####### # # ### # #
#   # #   # #     # # #       #   #   # #
# ### ####### ### # ######### ##### ### #
# # #         # # #       # # #   # #   #
# # # ######### # ##### # # # ### ### ###
# # #     #   # # #   # # # #   #   # # #
# # ##### ### # # ### # # # ### ### # # #
# #     #   # # #   # # # # #     #   # #
# ### ##### # # ### # ### # # # ####### #
#         #   #     #     #   #         #
#########################################
