################################### #####
#     #       #   #          . . .#. . .#
# ##### ##### # ### # ####### ### ##### #
#           # #     # #    . .# #. . .#.#
########### ######### # ### ### ##### # #
# #     #             # #  . .#   # #.#.#
# # ### ### ##### ### # # ### ### # # # #
# # #       #     #   # #   #. .# #. .#.#
# # ######### ### ##### ##### # # # ### #
# #   #       # #     #     # #.#. .#. .#
# ### # # ##### # # ####### # # # ### # #
# # # # # #   #   #     #   # #.#.#  .# #
# # # # # # ######### ### ##### # # # # #
# #   # # #           #   #  . .#.# #.# #
# ####### ##### ### # # ### # ### ### # #
# #     # #     #   # # #   #.#  . . .# #
# ### # # # ### ##### # # ### ###########
#   # #   # #   #     # #   #.#. . . . . 
### # ####### ### ##### ### # # ##### ###
# #   #     #   # # #     # #. .#   # # #
# ### # ### ##### # # ### # # ### # # # #
# #   #   # #     # # #   # #     # #   #
# # ### # # # ##### ### # # ####### #####
# # # # # #   #   #     # #       #     #
# # # # # ##### ### ##### # ### # # ### #
#   #   #     # #   #     #   # # # # # #
####### # ### # # ### ######### # # # # #
#   #   #   # #   #   #   #     # #   # #
### # ##### ####### # # # # # ### ##### #
#   # #   #   #     # # #   #   #   #   #
# ##### # ### # ####### ####### ### # ###
#       #     # #       #   #   # # # # #
##### ######### # ####### # # ### # # # #
#     #         # #       # # #   # # # #
####### ### ### # # ####### # # ### # # #
#       # # #   #   #     # # # #   # # #
# ####### # ######### ####### # # ### # #
#     #   #       # #     #   #   #     #
# ### # ####### # # ##### ### ##### # ###
#   #   #       #   #         #     #   #
#########################################
