################### #####################
#     # #        . .          #   #. . .#
# ### # ### # ### ####### ##### ### ### #
# # #   #   # #  . . .#   #     #. .# #.#
# # ##### # ### ##### # ### ##### ### # #
# #       # #   #   #.#     #. . .    #.#
# ### ### # # # ### # ####### ######### #
# #   #   # # # #   #. . . . .#   #. . .#
# # # # ### # ### ### # # ##### ### ### #
#   # # #   #     # # # #       #. .#   #
####### # ### ##### # # ######### ### ###
#       # # #     #   # # #  . . .#   #. 
######### # ##### ##### # # # # ####### #
#         # #   #     # #   #.# #. . .#.#
# ### ##### # ####### # ##### ### ### # #
#   # #   #   #     # #   #  . . .  #. .#
# # ### # # ##### # ### # # # # ##### ###
# #     # #       #   # # # # # #   #   #
# ### ### # ######### ### # # ### # ### #
#   #   # # #             # #     #   # #
### ##### ### ############# # ####### ###
# # #   #   # # #           #       #   #
# ### # ### # # # # ### ### ########### #
#   # #   # # # # #   # #   #           #
### # ### ### # # # # ### ### # # ### # #
#     # #   # #   # #   #   # # # #   # #
# ### # ### # ##### # # ##### # ### ### #
#   # #         #   # #     # #   #   # #
##### ####### ### # # # ### # # # ##### #
#   # #       #   # # # #   # # #     # #
# # # # ####### ### # # # # # ######### #
# # # # #       #   # # # # #   #     # #
# ##### ### ##### ### # # ##### ##### # #
#   #   #   #     #   # #     #       # #
### # ### ########### # ### # ######### #
#   # #   #       #   #   # # #   #     #
# ### # # # ### ### ##### ##### ### #####
# #   # # #   #   #   #   #     #   #   #
# # ### # # ##### ### ##### ##### ##### #
#   #   #       #   #       #           #
#########################################
