################### ############### #####
# #       #      . .    #     #   #.#   #
# # ##### # ##### # # ### # ### # # ### #
#   #  . .#     #.# #     # #   # #.#   #
# ### # # ####### # ####### # ##### # ###
# #   #.#. . .#. .#   #   #   #. . .  # #
# # ### ##### # ##### # ####### ####### #
# # #. .#    . .#     # #. .  #.#       #
# # # ### ############# # # ### # ##### #
# # #.#   # #. . . . . . .#. . .# #   # #
# # # ##### # ############### ### # ### #
# # #. .  #. .  #     #     #     # # # #
### # # ### ##### ### # ### ####### # # #
#   # #. . .      # #   # #     #     # #
# ### # ########### ##### # ##### ##### #
#   # #   #       #       #       # #   #
# # # ##### ##### # ##### ##### ### # ###
# # #   #   #   #       #     #     #   #
# # ### # ### ########### ### ####### # #
# #   #   #           #   # #       # # #
# # ####### ######### ### # ### ### ### #
# #       # #       # #   #   #   # #   #
# ### ##### # ### # # # ##### ##### # ###
#   #       # # # # # #     #       #   #
# # # ####### # # # # ############# # # #
# # # #       # # # #         #   # # # #
### # # ####### # ####### ### # # # # ###
#   # #         #   #   # # # # # # #   #
# # # ##### ########### # # # # # ### # #
# # #                   #   # # #   # # #
# # ######################### # ### ### #
# # #         #               # #       #
# # # ####### ############### # ##### # #
# # #   #   # #       #       #     # # #
# # ### # ### # ##### # ####### # # ### #
# #   # #   # # #     # #   #   # #   # #
# ### ### ### # ####### # # # ####### # #
#   # #     # #         # #   #     # # #
# # ### ##### ################### # ### #
# #           #                   #     #
#########################################
