########### #############################
#          .    #                       #
# ######### ### # ############# ####### #
# #   #    .#   #. . .#. . .  # #     # #
# # # ##### ##### ### # ### # # # ##### #
#   # #. . .#. . .  #. .  #.# # # #     #
####### ### # ############# # ### # # # #
#  . . .#   #.#   #. . . .#.#     # # # #
### # ####### # # # ##### # ######### # #
#. .# #. . . .# # #.#   #.#.    #   # # #
# ### # ######### # # ### # ### ### # # #
#. .# #.#         #.#    . .  # #     # #
### # # # ######### ######### # ### ### #
#. .# #.# # #      . . .#     #   # #   #
# # ### # # # ##### ### # ####### # # ###
#.# #. .  #   #. .# #. .# #     # # #   #
# ### ######### # ### # ### ### # #######
#. . .  #. . . .#.#. .# #   #   #       #
# ####### ####### # # # ####### ####### #
# #     #.#      . .# # #               #
# # ### # ####### # # # ############# # #
# #   # #. .#. .# # # #       #       # #
# ### # ### # # ### # ##### # ######### #
#     #   #. .#. .# # #   # #         # #
# ####### # # ### # # ### # # ####### # #
# #     # # #   #.# #     # #   #   # # #
# # ##### # ##### ######### ### ### # # #
# # #   # # #   #. . .  #   # #     # # #
# # ### # # # # # ### # ##### ####### # #
# # #   # #   # #   #.#           #   # #
# # ### # ##### ##### ########### # # ###
#   # #     #   #. . .      #   # # #   #
##### ### ### ### # # ####### # # # # # #
#   # #   #   #  .# #       # # # # # # #
### # ##### ### # ######### # # # # ### #
#   #     # #   #. .  # # #   # # # #   #
# ####### # # ##### # # # ##### # ### # #
# #     # # # #. . .# # #       #   # # #
# # ### # # # # ##### # ########### # # #
#   #       # #.#     #             # # #
############### #########################
