################### ############### #####
#   #       #     #.#   #    . . . .#   #
### ####### # ##### # # # # # ### # ### #
# #     # # # #  . .# # # # #. .# #   # #
# ##### # # # ### ### # ### # # ##### # #
#         # #   #.#   #   # # #. .  # # #
######### # ### # ####### # ##### ### # #
#     # #   # # #. . . . .#     #. .#   #
# ### # ### # # ######### ####### # #####
# # # #       #         #.#. . .# #. . .#
# # # ####### ######### # # ### # ##### #
# #   #   #       # #   #. .# #.#     #.#
# # ### # ####### # # ####### # ####### #
# # # # #       #   #       #. .  #  . .#
# # # # ####### ### ####### # ##### # # #
# # # # #   #   # #       #. .#   # #.# #
# # # # # ### # # ####### # ##### # # # #
# # # #   #   # # #     #  . . . .# #.# #
### # ##### ### # # ### ### ##### # # # #
#     #     # # # # #     # #   #.# #.# #
##### # ### # # # # ### # ### ### # # # #
#   # # #   # # #   #   #    . . .# #.# #
# # # ### ### # ##### ####### ####### # #
# # #   # # # #       #      . . . .#.# #
# ##### ### # ########### ### ##### # # #
#     #         #   #     #   #   #. .# #
# ### ##### ### # ### # ### ### # ### # #
# #   # #   #     #   # #   #   #     # #
# # ### # ####### # ### # ### ######### #
# #   #   #       #   # # # # #   #     #
# ############### ##### # # # ### ### ###
#                       # # #     #   # #
################# ##### # # # ##### ### #
#   #       #     #     # # # #   #   # #
### ####### ####### ##### # ### ### # # #
#   #     #     # #   #   #   #     # # #
# ### ### ##### # ### # # ### ####### # #
# #   # # #       #   # #   #           #
# ### # # ####### ##### ### ######### ###
#     #                 #   #           #
#########################################
