########################### #############
#       #     #            .    #. . . .#
# ### ### ##### ### # ##### ### # ##### #
# # # #   #     #   # #    . .# #.#   #. 
# # # # ######### ### ##### # ### # #####
# # #   #         #       # #.#. .#     #
# # ##### # ############# # # # ####### #
#   #   # #     #       # # #.#. . . . .#
### ### ####### ### ### # # # ### ##### #
#     #       # #   #     # #.  # #   #.#
##### ####### # # ### ####### # ### # # #
#             # # #   #    . .#     # #.#
# ########### ### # ### ### # ######### #
# #               # #   #  .# #   #. . .#
# # ##### ### ####### ### # # # ### #####
# # #     #   #   #   # # #.# #. . .    #
### # ##### ### # # ### # # ### #########
#   # #     #   # # #   # #. .#. .#     #
# ### # ##### ### # # ### # # ### # ### #
# #   # # #   #     #   # # #. .#.# #   #
# ### ### # # # ### ### # # ### # # # ###
# #   #   # # # #   # # # # # #. .# # # #
### ### ### # # # ### # # # # ### ### # #
#   #   #   # # # # #   # # #   #       #
# ### ### ### # # # # ### # ### #########
# #   #   #   # # # #   # #   # #       #
# # ########### # # ### # # ### ####### #
#     #   #   # # # #     #             #
# ##### ### # # # # # # # ### ###########
#   #   #   #   #   # # #   #   #     # #
# # # ### ##### # ### # ### ### # ### # #
# # #     #   # #   # #   #   # #   # # #
# # ####### # ##### # ### ### ####### # #
# # #     # #     # #   #   #     #   # #
# # # ### ####### ### # ### # # ### ### #
# #     #   #   #   # #   # # #         #
# ######### # # ### ##### # ### #########
#   # #     # #         # #   #   #     #
# # # # ############### # ### ##### ### #
# #   #             #       #       #   #
#########################################
