########### #############################
#    . . .#.              #             #
# ### ### # ##### ### # ### # ######### #
# #  .# #. .#   # #   # #   #   #   # # #
# # # # ### ### # # # # # ##### # # # # #
# # #.#   #     # # # # # #     # #   # #
# ### ### ######### # # # # ### ##### # #
#   #. .# #         # #   # #   #   # # #
### # # # ##### # # # ##### ##### ### # #
# # # #.#   #   # # # #   #       #   # #
# # ### ### # ##### # ### ######### #####
#   #. .# #   #     # #   #         #   #
# ### # # ########### # ### ### ####### #
# #  .#   #         # #   # # #     #   #
# # # ##### ####### ### # # # # ##### ###
# # #. .    #     #     #     #         #
# # ### ##### ### #######################
# #   #.        #     #       #         #
# ### # ############# # ### ### ### ### #
#   # #. . .#         # # #       #   # #
### # # ### ########### # ####### ### ###
# # # #   #. . . . . .  #. .    #   #   #
# # # ######### ##### ### # ### ### ### #
#   #     #   # #. .#.#. .#. .#   # #   #
######### # # ### # # # ##### ### # # # #
#       #   # #. .#. .#.# #. .  # # # # #
####### ##### # ##### # # # ### # # # # #
#     #       #.#     #. .#. .# # # # # #
# ##### ####### ######### ### # # ### # #
#     # #    . .#. . . . .#. .# #   # # #
##### ### ### ### ######### ####### # # #
#   #     #  . . .      #. .#     # # # #
# # ################### # # # ### # ### #
# #   #    . . .#. . .# #.# # #   # # # #
# ### # ### ### # ### ### # # ### # # # #
#   # # #  . .#. .# #. . .# #   #   #   #
### # # ### # ##### ##### # ### ### ### #
# # # # #   #.#     #   # # #   # # # # #
# # ### # ### # ##### # ### ### # # # # #
#       #   #.#       #     #   #   #   #
############# ###########################
