############# ###########################
# #   #      .                          #
# # # # # ### ##### ####### ######### ###
# # # # # # #.  # #       #   #     #   #
# # # ### # # # # ##### # # ### ### ### #
#   # #   # #.#   #   # # #       # # # #
# ### # # # # ####### # # ######### # # #
# # # # # # #.#. . .# # # #         #   #
# # # # ### # # ### # ### # ##### #######
# # # #   # #. .  #.# #   #     # #     #
# # ##### # # ##### # # ####### ### ### #
# #     #   #   #. .# # # #   # #   # # #
# # ### ######### # # # # ### ### ### # #
#   # #        . .# # # #     #   #   # #
##### ######### ### # # ##### # ### # ###
 . . . .#    . .#   #     # #   # # #   #
####### # ### # # ####### # # ### # ### #
# #. . .# #. .# # #   #   #   #     # # #
# # ####### ### # # ### ### ### ##### # #
# #.#  . . .# # # #     #       #     # #
# # # # # ### # # ####### ####### ##### #
# #.# #.# #   # #       #       # #   # #
# # ### # # ### # # ##### ##### # ### # #
# #. .#.# # #   # #         #   #   # # #
# ### # ### # # # ######### ####### # # #
#. . .#. .#   # #         # #       #   #
# ####### ############### ### ###########
#.#    . .            #   #   #   #     #
# ##### # ######### # ##### ### ### ### #
#. . . .#         # #         #     # # #
### ####### ### # ######### ######### # #
#   #     #   # #   #     #           # #
# ### ### ### # ### ##### ##### ##### # #
#   # # # # # #   # #     #   #     #   #
# # ### # # # # # # # ####### ##### #####
# #   # # #   # # #           #   # #   #
##### # # ##### # ### ######### ### # # #
#     #   #     #   #             # # # #
# ##### ### ####### ############# ### # #
#     #     #                   #     # #
#########################################
