######################### ##### #########
#             #. . . . . .#    .        #
# ########### # ########### ### ##### ###
# #     #    . .#. . .#   #   #.    #   #
# ##### ##### ### ### ### ### # ####### #
#       #    . . .#  . . . .# #.  #. .# #
######### ### ############# # # ### # ###
#   #     #   #   #       #.# #. . .#. .#
### # ######### ### ##### # ####### ### #
#   #     #   #     #   #  . . . .#   #.#
# ### # # # # ##### # ########### ### # #
# #   # #   # #     #         #  . .# #.#
# ######### # ########### ### ##### ### #
#         # #     #   #   # #      . . .#
######### ##### ### # # ### ######### # #
#       #     #     # # # #           # #
# ##### ##### ######### # ### ######### #
# #   #         #       #     #         #
### # ######### # ### ####### ######### #
#   # # #     #   #   #           #   # #
# ### # # ### ##### # ########### # # # #
#   # # # #     # # #       #   # # # # #
# # # # # ### # # # # ##### # ### # # # #
# # #   # #   # #   #   #   # # #   # # #
# # ### ####### ######### ### # ####### #
# # #               #     # #   #       #
# # ############### ##### # # ### # ### #
# #   #   #   #   #   # # # # #   # #   #
### # # ### # ### ### # # # # # # ### # #
# # # # #   #   # #   #   # # # # #   # #
# ### # # ##### # # ####### # ### # ### #
# #   #   #     #         #   #   # #   #
# ####### ############### ### # # # #####
#   #                       #   # #     #
### ####### ############### ### ##### ###
#   #     # #           #       #   #   #
# ### ### ### ### ##### ######### # ### #
# #   # # #   #   #   #           #     #
# ### # # # ### ##### ######### ####### #
#     #     #         #         #       #
#########################################
