##################### ##### #############
#       # #       # #.#    .            #
# ### # # # ##### # # # ### ####### ### #
# #   # #     #   # #.#   #.      # #   #
### ### ##### # ### # ### # ##### ### # #
#   # #   # # #   # #. .# #.  #   #   # #
# ### ### # # ### # ### # # ### ### #####
#   #     #   # # # # #.# #. .#   # #   #
### # ### # ### ### # # # ### ### # # # #
#   # # # # #. .    #. .#   #. .# #   # #
####### # # # # ##### ##### ### ####### #
#     #   # #.#. . . .#     #. .#       #
# ##### ### # ######### ##### # # ##### #
# # #   #   #. . .#   # # #  .# # # #   #
# # # ### ####### # ### # # # # ### # ###
# #     #   #   #.#     #   #.#   #   # #
# # ####### # ### ########### ### ##### #
# # #   # # # #. .#. . .#. . .# #       #
# # # # # # # # ### ### # # # # ####### #
# # # #   #. . .#  .#  . .# # #       # #
# # ##### # ####### # # ### # ####### # #
# # #   # #.#  . . .# # #   #     #   # #
# # # # # # # # ### ### # # ##### # ### #
# #   # #  .# #.#   #   # # #   # # #   #
# ##### ### # # ##### ### ### # # # # # #
#     #    .# #.#     #   #   # # # # # #
##### ##### ### # ####### # ### # # # # #
#       #  . . .#       # # #   #   # # #
# # ### # ##### ####### # # # ####### ###
# # # # #   #   # #   # # # #           #
# # # # ### # ### ### # # # ######### # #
# # # #   # #   #   #   # # #         # #
# # # ### ### # ### ##### # # ######### #
# # #   #   # # #   #     # #         # #
# # ### ### ### # ### # ### ########### #
# #   #         # #   # #   #   #       #
# ############### # ### # # # ####### # #
# #   # #       #   #   # # #   #     # #
# # # # # ######### ##### # ### ####### #
#   #   #           #     #   #         #
#########################################
