################### #####################
#       #    . . .#. .        #         #
# # ### # ### ### # # ##### # # # ##### #
# # #     #. .# #.# #.#   # # # # #     #
# # ####### # # # ### # # # ### # # #####
# #   # #. .# #  . . .# #   #   # # #   #
# # # # # ############# ##### ### ### # #
# # # # #. . . .#       #     # #   # # #
# ### # # ##### ######### ##### ### ### #
#   #   # #   #. .#. . . . . . .  #   # #
### ### # ### ### # ########### ### ### #
# #   # #   #   #.#.#         #. .#     #
# # # ##### ### # # ######### ### #######
# # #     #   # #.#. . .#    . .#. .    #
# ########### # # ##### ##### # ### ### #
#           #   #. . .#. . . .#.# #.#   #
######### # ##### # # ######### # # #####
#   #     #       # #. . .#. . .# #. . . 
# ### ### ####### # ##### # ##### #######
#     #   #   #   # #   #.#. . .# #     #
######### # # # ### # ### ##### # # ### #
#   #   #   # # # # #   #. .  #.# # # # #
# ### ### ### # # # ### ### # # # # # # #
#     # #   # #   #     #. .# #. .# #   #
# ##### ##### ########### # # ### ### ###
# #         # #        . .# #   #.#   # #
# ######### # # ####### ######### # ### #
#   #         # #      .#. . . . .  #   #
### ######### # # ##### # ############# #
# #         # # #   #. .#. .#           #
# ######### ### ##### # ### # ######### #
#   #     # #   #. . .#   #.#     #   # #
# # # ##### # ### ######### ##### ### ###
# # #   #   # # #.#. . . . .    #   #   #
### ### # ### # # # ##### ##### ### ### #
#   # # #   #   #.#.#   #   #   #   # # #
# ### # ### ##### # # # ### ##### ### # #
# #     # #      . .# # # #           # #
# ### # # ####### # ### # # ########### #
#     #           #       #             #
#########################################
