##################################### ###
#             #                  . . .  #
# ########### # ################# # # # #
# # #. . . .  #   #           #. .# # # #
# # # ##### ##### # ########### ### # # #
#   #.#   #.#   #   #. .#  . . .#   # # #
##### # ### # # ##### # ### ##### ### ###
 . .#.#   #.# #. . . .#. .#. .#   # #   #
### # ### # ### # ####### ### # ### ### #
#  . .#   #. .#.# #     #. .#.# #. .#   #
# ### # ##### # # # ### ### # # # # #####
# # # #     #. .# #   # #. .#.# #.#. . .#
# # # ##### ######### # # ### ### ##### #
#   # #   # #     #   # #.#  .#. .# #. .#
##### ### # ##### # ##### # # # ### # ###
#     #   #     #  . . . .# #. .    #. .#
# ##### ####### ### ################# # #
#     # #   #     #.#      . . . . .# #.#
# ### # # # ##### # ####### ####### # # #
#   # # # #   #   #.#. . . .#  . . .# #.#
##### # # ### ### # # ######### ####### #
#   # #   #     #  . .#   #    . .#  . .#
# # # ######### ### # ### ####### ### # #
# # #   #           # #   #     #.#. .# #
### # # ##### ####### # ### ### # # # # #
#   # #     #   #     # # #   #  . .# # #
# ##### ### ### ### ### # ### ### # ### #
#   # # #   #   #   #   # #   #   # #   #
### # ### ### ### ### ### # ### ### # # #
#   #     #   #   #       # #   # # # # #
### ####### ### ##### ### ### ### # # ###
#           # #     # #       # # # #   #
# ######### # # # # ### ####### # # ### #
#   #       #   # #   # #   #   # # # # #
##### ### ####### ### # # ### ### # # # #
#     #   #     # # # # #   # #   #   # #
# ##### ### ##### # # ### ### # ####### #
#   #       #   # # #   # #   #       # #
### # ####### # # # # # # # ######### # #
#   #         # #   # #   #             #
#########################################
