# #######################################
#.  #. . . .            #         #     #
# ### ##### ########### ######### # ### #
#. .#. .# #.      #   #   #       #   # #
# # ### # # ### # ### # # # ######### ###
# #. . .  #.  # #   # # #           #   #
# ##### ### # ### # # ### # ####### ### #
# #   #   #.#   # # #   # #   #   #     #
# ### ##### ### # # ### # ### ### ##### #
#   #   #. .#   # #     #   #   # #   # #
# # ### # ### ############# ### # ### ###
# # #   #.# # #     #     #   # #   #   #
### # ### # # # ### # ### ### # ### ### #
#   #   #.#   #   #   # #   # # # #     #
# # ### # ############# ### # # # ##### #
# #   # #. .          #   #   # # # #   #
# ##### # # ##### ### ### ##### # # # ###
#       # #. .  #   #   #   #   # #   # #
# ####### # # ##### ### ### # ### # ### #
# #       # #. .#     #     #   #   #   #
# # ### # # # # ################# ### ###
# #   # # # # #. . .      #       #   # #
# ### ### # ####### ### ### ####### ### #
# # # #   #   #   #.#   #         #     #
# # # # ##### ### # ##### ####### ##### #
#   # # #     #   #. .      #   #     # #
##### ### # ### ### # ####### # ####### #
#     # # # #   #   #. .      #         #
### # # # ### ######### #################
#   # # #   # #  . . .#. . .    #       #
# ##### ### # # # ### ##### ### # ##### #
# #       #   # #.#  . . . .  # #   # # #
# # ########### # ########### # ### # # #
#   #   #   #   #. .# #       #     #   #
# # ### # # # ### # # # ##### # ####### #
# #     # # # #   #.#   #   # # #   #   #
# ####### ### ##### ####### ### # # #####
#     #   #   #   #. .  #   #   # #     #
# # ### ### ### # ### # # ### ######### #
# #     #       #   #.#     #           #
##################### ###################
