##################### ##### #############
#     #       # #   #.#   #. .          #
# ##### ### # # # # # # ### # # ####### #
# #   #   # # # # # #.#     #.#       # #
# # # ##### # # # # # ####### ### ### # #
# # #   #   # # # #  . .#   #. .#   # # #
# # ##### ### # # ##### ### # # ### ### #
#   # #   #     # #    . .#   #.  #   # #
# ### # # ##### ### ##### ##### # # # ###
# # # # #     #     #   #. .#. .# # #   #
# # # # ##### ####### # ### # ### ### # #
# # # #     # #   #   #   #.#.# #   # # #
# # # ####### # ### ####### # # # # ### #
#   # #   #   #     # #. . .#.# # # #   #
### # # # ##### ##### # ##### # ### # # #
# # # # #     # # #. .#.#. . .# #   # # #
# # # # ##### # # # # # # ### # # ### # #
# # # # #     # # #.#. .#. .# #   #   # #
# # # # # ##### # # ##### # ####### # # #
# # # # # #     #. .#     #.#       # # #
# # # # ### ##### ### ##### # ####### # #
# # # #       #  .# # #. . .#   #     # #
# # # ####### ### # # # # # ##### ##### #
# #       #      . .# #.# # #     #     #
# ####### ######### ### # # # ##### #####
#               #  . . .# # # #   #     #
############# # ####### # # ### # ##### #
#             #   #     # # #   #   #   #
# ### # ### ##### ####### # # ### ### # #
# #   # #   #   #   #     # # #   #   # #
# # ##### # # ##### # ##### ### ### ### #
# # # #   # #         #         # # #   #
### # # ### ########### ### # ### # #####
#   #   # #     #   #   #   # # #   #   #
# ####### # ##### # # # # # # # ##### # #
#     #   #   #   #   # # # #   #     # #
##### # ### # # ######### ############# #
#   # #   # # # #       #       #     # #
# ### ### ### # ####### ### ##### ### # #
#       #     #           #         #   #
#########################################
