####################### #################
#   #       #     #    .      #   #     #
# # # ##### # # # ### # ### ### # # ### #
# # # #   # # # #     #. .#     #     # #
# ### # # ##### # ####### ############# #
#   # # #       # #    . .            # #
### # ####### ### # ### # ########### # #
# # #         #   # #  .# #. . . .# # # #
# # ### ########### # # ### ##### # ### #
# #     #     #     # #. . .#   #.# #   #
# ####### ### # ### # ### ##### # # # ###
# #       #     #   #   #       #.#   # #
# # ### # ####### ##### ######### ##### #
#   #   # #     #     #     #    . . . .#
##### # # ##### ##### ##### # ######### #
#   # # # #   # #   #     # # #. . .#. .#
# # # # # # # # ### ####### ### ### # # #
# #   # #   # #   #         #. .#  . .# #
####### # # # ### # ######### ####### # #
#       # # #   #   #  . . . .#     # # #
# # ##### # # # ### # # ##### # ### # # #
# # #   # # # # #   # #.#   # # # # # # #
# ### # # # ### # ### # # # # # # # ### #
#   # #   # #   #   # #.# #   # # #     #
# # ######### ####### # ####### # #######
# #   # #     #       #. . .  #   # #. . 
##### # # # ### ####### # # # ##### # ###
#     #   # # # #     # # #.#     #. .  #
# ### ##### # # ##### # # # ##### # #####
#   # #   #   # #   # # # #. .#   #.#   #
# # ### ####### # ### # # # # ##### # # #
# #       #     # # #   # # #.#. . .# # #
# ######### # ### # ##### # # # ##### # #
#       #   #   #   #   # # #.#.  #   # #
######### ### # ### # ### # # # ### ### #
#         #   #     #   # # #. .  # # # #
##### ### # # ######### # # ##### ### # #
#   #   # # # #     #     #     #     # #
# # ### # # ### ### ########### ####### #
# #     # #       #           #         #
#########################################
