####### #################################
#      .  #. .          #     #   #     #
# ### # ### # ### ##### # ### ### # ### #
# #   #. . .#. .#     # #   #   # #   # #
### ### ####### ### # # ####### # ##### #
#   # #       #.  # # #   #   #     #   #
# ### ######### # # ##### # # # ##### ###
# #. .#  . . . .# #     # # # #   #     #
# # # ### ####### # # ### # ### ### #####
# #.#. . .#       # #   # #   # #   #   #
# # ####### ####### ### ### # # # ##### #
# #.#       #. .  #   #     #           #
### # ####### # # ### # ####### #########
#. .# #. . . .#.#   # # #     #         #
# # ### ####### # # # ### ### # ##### ###
#.# #. .#   #. .# # #   # # # #     #   #
# ### ### # # # # ##### # # ### # ##### #
#. . .#   # #.# #   #   # #   # #     # #
# ##### ### # # ### ##### ### ##### ### #
# #   # #   #.#   #     #   #   #   #   #
# # # # ##### ### # ### ### ### # # # ###
#   # # #. . .# # #   #   # #   # # # # #
# ### # # ##### # ### # ### # ### # # # #
#   #   #.#. .#   #   #     #     # #   #
######### # # ########### ####### # ### #
#        . .#. . .      #       # #   # #
# ####### # # ### ##### ####### ##### ###
# #     # # #   #. .  #       #     #   #
# ### # # # ####### # ##### ####### ### #
# #   #   # #. . . .#     #       #   # #
# # ####### # ##### ##### # # # ##### ###
# #       # #.# #   #   # # # #     #   #
# ####### ### # # ### # # # ##### # ### #
#   #     #. .#   #   #   #     # #   # #
### # ##### ######### ########### ##### #
#   # #    . .  # #   #   #       # #   #
# ### ####### # # # ### # # ### # # # ###
# # #       #.# # # #   # #   # # # # # #
# # # ##### # # # # # ####### # # # # # #
#   #   #   #.#   #   #       # #   #   #
############# ###########################
