# #######################################
#. . .      #. . . . .                  #
# # # ##### # ####### ####### ######### #
# # #. . .# #.#     #.      #         # #
# ####### ### # ### # ########### ### # #
# #. . .#. . .  # # #. . . .  #   #   # #
### ### # ####### # ####### # # ####### #
 . .#. .# #. . . .# #. . .#.# # #     # #
##### ### # ##### ### ### # # # ##### # #
#   #. .# #.#   #.#. .#  . .# #     # # #
# # ### ### # ### # ####### ##### ### # #
# #   #. . .#. .#.#. . .#   #. .#     # #
# ### ####### # # ### # # ### # ####### #
#   #   #  . .#.#. .# #.# #. .#. .  #   #
### ### ### ### ### # # ### ##### # #####
# #   #   #.  #. . .# #. .#.#   #.#     #
# ### ##### ######### # # # # ### ##### #
# # # #   #.#       # # #. .  #. .# #   #
# # # # ### # ####### # ####### # # # # #
# # # #. . .# #       # #   #. .# # # # #
# # # # ##### # ####### ### # ### # # # #
# # # #.#   #   #     #     #. .# #   # #
# # # # # ########### ####### # # #######
# #   #. .#      . . .#   #   #.#       #
# # ##### # ##### ### ### # ### ####### #
#        .#   #. .#  . . .# #. .#     # #
######### ##### # ####### # # # # ### # #
#        . . . .# #     #.# #.# #   #   #
# ##### # ####### # ### # ### # # # ### #
# #     # #       # # # #. . .# # # #   #
# # # ### # ####### # # ##### # ### #####
# # # #   #       # #   #     # # #     #
### # # ########### ### ####### # ### # #
#   # # #   #       #           #     # #
# ### # # # # ####### ####### ######### #
#   # # # # #   #   # #       #   #     #
### ### # # # ### # ### ####### ### ### #
# #   # # # #   # # #   #       #   # # #
# ### # ### ### # ### ####### ### # # # #
#     #     #   #     #           # #   #
#########################################
