############################### #########
#             #       #      . .#       #
# ########### # ### # ##### # # ####### #
#   #         # #   #       #.#       # #
### ### ##### ### ####### ### ##### ### #
# #   #   # # #   #     # #  .    #     #
# ### # # # # # ### ### ### # ####### ###
# #   # # #     #   #       #. . .  #   #
# # ########### # ########### ### # ### #
# # #   #       # #         # # #.#   # #
# # # # # ####### ######### # # # ### ###
# # # # # #       #. .#   # #   #.  #   #
# ### # # ### ##### # # ### ##### ##### #
#     # #   # #  . .#.#  . . .#. .#   # #
####### ### # # # ### ### ### # # # ### #
#     #     # # #.#  . . .#  .#.# #     #
##### ####### # # ########### # # ##### #
#   # #       # #. .#       #. .#   #   #
# # # # ### ### ### ####### ### ### #####
# #   # #     #   #. . .  #     # #     #
# ##### ### # ### # ### ######### ##### #
# #     #   #   # #   #. . . . . .#   # #
# # # ### ### ### ### # ####### # # # # #
#   # #   # #   #   # #   #   # #.# # # #
####### ### ##### # # ### # # # # # ### #
#   #   # #       # #   # # # # #.#   # #
# ### ### ### ### # ### # ### ### ### # #
#   # # # #     # # #   #   #   #.  #   #
### # # # ### # ### # # # # ### # # #####
# # # # #     #   # # # # #     #.#     #
# # # # ######### ### # ######### ##### #
#   # #       #   #   # #   #    . . .# #
# ### ####### # # # # # # # ##### # # ###
#     #     #   # # # # # # #   # # #. . 
# ### # ######### # ### # ### # # # #####
# #   #           #   # #     #   # #   #
### ################# # ##### ##### ### #
#   #     #       #   # #     #   #     #
# ### ### # ### # # # # ####### # #######
#   #   #   #   #   # #         #       #
#########################################
