##################### ###################
#      . . .#. . .#. .            #     #
# ##### ### # ### # # ##### ### ### ### #
#   #. .#  . .#  . .#     #   #   #   # #
### # ########### # # ### # ##### ##### #
#   #.#         # # #   # #     #       #
# ### # ####### ### # # # ### ###########
# #. .# #     #     # # #   #           #
### # # # ### ####### # ### # ### #######
#. .# # # # # #     # #   # #   #       #
# ##### # # # ### # ### # # ##### ##### #
#.# #   # # #     #     # #     # # #   #
# # # ### # ##### # ##### ##### # # # # #
#.#   #   # #     # #     #   # #   # # #
# ####### # # ##### # ##### ### ##### ###
#. .    # # # # #   # #     #   # #     #
# # ### ### ### # ### # ##### # # # # # #
# #.  #     #   # #     #     #   # # # #
# # ##### ### ### ####### ### ##### # # #
# #. .  #   #   # #   #   #   #     # # #
# ### # ####### # # # # ####### # ##### #
#   #.#       # #   # #       # # #   # #
##### ##### # # ##### # # # # # ### # ###
 . .#. .  # # # #   # # # # # #   # #   #
### ### # # ### ### # # ####### # # ### #
# #. .#.# #   #     # #       # # #   # #
# ### # # ### ### ### ####### # # ##### #
# #. .#.#   #   # #   #     # # #       #
# # ### ### # # # # ### ##### # #########
#  . . .# # # #   #   # #     #     #   #
####### # # # # ##### # ### ####### ### #
#     # #   # #     # #     #   # #     #
# ### # ##### ##### # ####### # # ##### #
#   # # #   #     # #       # #   #   # #
### ### ### ##### # # # # # ##### ### # #
# #     #   #     # # # # #     # #   # #
# ### ### ### ##### # ####### ### # ### #
# #   #   #   #   # #   #   #     # # # #
# # ### ##### # # # ### ### ####### # # #
#   #         # #     #             #   #
#########################################
