### #####################################
#  .    #. .          #     #       #   #
### ### # # ##### ##### # ### ##### # ###
#. .#   #.#. . .#     # #   # #     #. . 
# ### ### ##### ##### # ### # ####### ###
#.# # #  .#   #. .  #   #   #. . . . .  #
# # # ### ### # # ########### ###########
#.# #   #.#   # #. . . . .#. .#         #
# # ### # # ##### ####### # ### ####### #
#.#   # #.# #   #       #. .      #     #
# ### # # # # # ################### # # #
#. .#   #.# # #   #               # # # #
# # ##### # # ### # ####### ##### # ### #
# #.#. . .  # # #     #   #     # # #   #
### # ####### # # ##### ####### ### # # #
#. .#. .      # # # #   #     #   # # # #
# # ### ####### # # # ### ### ##### # # #
#.#   #.#       #   #   # #         # # #
# ### # # ### ######### ##### ##### # # #
#. .# #.# # #         # #   # #     # # #
# # ### # # # ######### # # ### ##### ###
# #. . .#   # #         # #   #   # #   #
# # # ####### # ######### ### ### # # # #
# # #           # #     #   #     #   # #
# # ######### ### # ##### # # ######### #
# #   #     #   #   #   # # # #       # #
# ### # ### ##### # # # ### ### ####### #
#   # #   #     # # # # #   #   #       #
# # ### # ##### # # ### # # # ### # ### #
# #     #     # # #   # # # # # # # #   #
# ####### # # # ##### # # # # # # ### # #
# #     # # # #   #     # # # # #   # # #
# # ### # # # ### # ##### # # # ### # # #
# # #   # # #   #       # # # # # # # # #
# ### ##### ### ### ### ### # # # # ### #
#   # #       #   # #   #   # # # # #   #
# # # # ### ##### # # ### ### # # ### # #
# # # # #   #   # # # #   #   #       # #
# # # # ##### ### # # ##### ########### #
# #   #     #     # #       #           #
#########################################
