# #######################################
#.  #. .              # #   #     # #   #
# ### # ######### # ### # # # ### # # # #
#. . .#.    #   # # #   # # # #   #   # #
# # ### ### # # # # # ### # # # ####### #
# # #. .  #   # # # #     # # #         #
# # # ### ####### # ####### # ###########
# # #. .# #       #     # #   #       # #
# ##### # # ########### # ### # ##### # #
#     #.# # #           #   # # # #   # #
####### # # ############# ### # # # ### #
#. . . .# #               #   #   #   # #
# ### # # # ### ### ####### ####### ### #
#.#   # # #   #   #             #       #
# # ### # ### ### ############### #######
#.# #   # #   # #           #     #     #
# ### ### # ### ######### # # ##### ### #
#. .# #   # # #   #     # #   #       # #
# # # # # # # # # # ### # ##### ####### #
# #.# # # #   # # # #   #           #   #
### # ### ####### # # ######### # ### # #
#. .#   #       #   # #   #   # # #   # #
# ##### ### # ### ##### ### # # # # ### #
#.#   #   # # #   #     #   # # # # # # #
# # ### # # # # ### ##### ### # # # # # #
#.#   # # # #     #   #     # # # # #   #
# ### ### # ######### # ##### # # # #####
#. .#   # #   # #   # # #     # # #     #
# # ### # ### # # # # # # ### # # ##### #
# #. .#     #   # # # # # # # # # #   # #
# # # ########### # # # # # # # # # ### #
# # #. . .    #   #     # #   # #     # #
# ### ### ### # ##### ### ##### ##### # #
#   # # #.  #   #   #   #     #   #   # #
### # # # ##### ### ### ##### ### # ### #
#   #   #. .  # #     #   #     # # #   #
# ######### # ### ####### # # # # #######
# #   #   #.#     #   # # # # # #     # #
# # # # # # ######### # # # # ####### # #
#   #   # #. . . .    #   # #       #   #
################# #######################
