######### ###############################
#      . .    #         #   #           #
# # ### # # # # # ##### # # # ##### ### #
# # #  .# # # # #   #   # # # #   # #   #
### # # # # # # ### ####### # ### # # ###
#   # #.# # # #   #     #   #   # # #   #
# ##### # # # ### ### # # ##### # # ### #
# #  . .# # # # #   # # #       # #   # #
# ### ### # # # ### ##### ####### # # ###
# #. .#   # #   #         #   #   # #   #
### ####### ##### ######### # # ####### #
#. .#   #     #   # #       # # #     # #
# ### # # ##### ### # ##### ### # ### ###
#.#   #   #         #   #       # # #   #
# ######### ########### # ####### # #####
#.#. . .    # #     #   # #   #   #     #
# # ### ##### # # ####### # # # ####### #
#. .  #.#. . .  #     #   # # #       # #
# ##### # ### ##### ### ##### # # ### # #
# #   #. .  #. . .#           # #   # # #
# ### # ### ##### ############# ### # # #
#     #   # #   #. . .          # # # # #
# # ##### ### # ### # ########### # ### #
# #     #     #   # #. .          #     #
# ########### # # # # # #################
#           # # # # # #. . . . . .      #
# ######### # # # # ############# #######
#         # # # # #     #       #. . . . 
########### # # # ##### # ##### # # #####
#           # # #     # # #     # #     #
### # ##### # # # ##### # ####### #######
#   # #     # # #     #   #     #     # #
# # ### ##### # # ### ##### ##### ### # #
# # #   #     # #   #         #   #   # #
# # # ### # ### ########### ### # ##### #
# # # #   #   #           # #   # #   # #
# # # ####### ########### # # ##### # # #
# # #   #     #         # # #   #   # # #
# ##### # ##### ##### ### ##### # ### # #
#     # #           #   #     #     #   #
#########################################
