######################### ###############
#                        . .      # #   #
# ##### ####### ########### ### # # # # #
#   #   #       #   #    . .  # #   # # #
##### ### ### ### # # ### # ### ##### # #
#     #   # # #   #   #. .# #       # # #
# ##### # # # # ####### ##### ####### # #
#     # # #   # #  . . .#     #     # # #
##### # # ##### # # ############### # ###
#     # #     # # #. . . .  #. .    #. . 
# # # # # ### # ### # ### # # # ##### ###
# # # # #   # #   # #   #.# #.#. . . .  #
# ### # ### ##### # ### # ### ###########
#   # #   #     # #   # #. .#. . .#     #
### ##### # ### # ### # ### ##### # ### #
# #     # # # # # #   # #. .    #.# #   #
# # # ### # # # # ##### # ####### ### ###
# # # #   #   # #   #   #.#. . . .#   # #
# ### # ####### ### # ### # ####### ### #
#   # # #         # # #. .#.            #
### # # ######### # # # ### #############
# # # #         # # # #.#. .    #       #
# # ########### ### ### # ### ### # ### #
# #   #   #   #   #   #. .  #     #   # #
# ### ### # ##### ### # # # ######### # #
# # # #   # #   #   # # # #         # # #
# # # # ### # ##### ### ##### ##### # ###
# #   # # # #   #   #   #   #     # #   #
# ### # # # ### ##### # # # ##### # ### #
#   # #     #         # # #   #   #   # #
### # # ####### # ### ### ### # # ##### #
#   #   #       # #   #   # # # # #     #
# # ### ### # ### # ### ### # # # # ### #
# #         # #   # #     #     # #   # #
# ############# ### ### ##### # # ### ###
# #       #     #   # # #   # # #   #   #
# # ##### ####### ### # # # ### ### ### #
# # #   #       #   # # # #   #   #   # #
### # ######### ### # ### ### ####### # #
#   #               #     #           # #
#########################################
