####### ############################### #
# #   #.#            . .#   #        . .#
# # # # ############# # ### # ####### # #
#   # #. .#        . .#. .#   #  . . .# #
# ####### # ####### ##### ##### # ### # #
# #  . . .#     #. .#    .#     #.#   # #
# ### ######### # ####### ####### # ### #
#    . .#  . .# #.#      . . . .#.#   # #
####### ### # ### # ########### # ### # #
#      . . .#. .#.#   #       #.#.  # # #
# ##### # ##### # ##### ##### # # ### # #
# #     # #    . .#     #   #  .#.#   # #
# # ##### # ####### ##### # ### # # ### #
# #   #   # #     # #   # #    . .# #   #
# ##### ### # ### # # # # ##### # # ### #
# #     #   # #     # # #     # # #   # #
# # ##### ### ######### ####### # # # # #
# # #   # #     # #   #       # # # # # #
# # ### # # ### # ### ### ### ### # # # #
# #     # # #   # # #   #   #     # # # #
######### ### ### # ### ### ######### # #
#     #   #   #   #       #   #       # #
# ### ### ##### ######### ### # # ##### #
# #       #   # #             # # #     #
# ### ### # # # # ############# ### # ###
#   # # # # # #   #             #   # # #
# # ### # # # ##### # ######### # ### # #
# #     # # #   # # # # #   #   # # #   #
# # # ##### ### # # # # # # ##### # # # #
# # #   #   #   #   # # # #     # #   # #
# # ##### ##### ##### # ####### # ##### #
# #     # #   # #     #   #     #   #   #
# ##### ##### # # ####### ### ### # # # #
#     #       #   # #   #   # #   # # # #
# # # ############# # # ### # ##### # ###
# # # #       #     # #   #         #   #
# # ### ### ### ##### ############### # #
# #     # # #   #   #     #     #   # # #
# ####### # # ### # ##### ### ### # ### #
#         #       #     #         #     #
#########################################
