################### #####################
# #     #    . . . .        # #         #
# # ### # ### ### # ### ### # # ### ### #
# # #   # #. .#   #   # #   #     # #   #
# # ##### # ### ##### # # ####### #######
# # #     #. .# #. .# # #     # # # #   #
# # # ### # # ### # # # ##### # # # # # #
#     #   # #. . .#.# #   #   #     # # #
########### ##### # # ### ##### ##### # #
#     #     #   # #.#   #   #     #   # #
# ### # ### ### ### ### ### # ##### ### #
# #   # #   #   #. .  #   #         # # #
### ### # ### ### ####### ########### # #
 .# #   #   # #  . . .  #   #         # #
# # ### ##### # # ### # # # ####### ### #
#.#   #       # #   #.# # # #       #   #
# ### ############### # # # # ####### ###
#.#. . . .#    . . . .# # #         #   #
# # ##### ##### ### # # ##### ###########
#.#.#   #. . . .#   # #     # #         #
# # # # ####### # ### ##### ### ####### #
#. .# # #       #   #     #         #   #
# ##### # ####### # # ### # ######### # #
# #   #   #     # # # # # # #   #   # # #
# ### ##### ### ### # # # # ### ### # # #
# #   #     # #     #   # #     # #   # #
# # ##### ### ########### ####### ### # #
# #       #                     #     # #
# # ####### # ######### ############### #
# # #       # #         #               #
# ### ##### # # ######### ##### ##### # #
#   # #     # #         # #     #     # #
# # ### ### # ########### # ##### ##### #
# #   # #   #   #   # #   # #     #     #
# ### # # ##### # # # # ##### ##### #####
#   # # # #   #   #   # # #   # #   #   #
##### # ### ########### # # # # # ##### #
#     # #   #   #   #   #   # # # #   # #
# ####### ##### ### # # ####### # # # # #
#               #     #         #   #   #
#########################################
