################################# #######
# #     #       #      . . . . . .      #
# # ### ### ##### # ### ### ### # ##### #
# # #     # #     # #  .#   #   #     # #
# # ##### # ### ### # # # ### ### ### # #
# #   # # #     #   # #.# #   #   #   # #
# ### # # ####### ### # ### # # ### #####
#     #   #       #   #. .# # #   # #   #
####### # # ############# # ##### # ### #
#   #   #   #      . . . .# #   # # #   #
# # # # ##### ##### # ### # # # ### # ###
# #   # #   # #. . .# #   #   #   #   # #
# ### ### # # # ##### # # # # ### # # # #
# #   #   #   #.#   # # # # #   # # # # #
####### ####### ### ### ### ##### # # # #
#       #   #  . .#   #   # #     # # # #
# ### ### # # # # ### # # # # ### # ### #
# #   #   # # # #.  # # # # #   # #     #
# ##### ##### # # ### ### # ### # #######
#     # #     # #. .#     #   # #   #   #
### # # # # ### # # ######### # ### # # #
#   # # # # #   # #. . .    # #   #   # #
# ### # ### # # # ##### ### ### ####### #
# #   #     # # # # #. .  #   # #     # #
# # ######### # # # # ### # # ### ##### #
# # #     #   # #   #.# # # #   # #     #
##### ##### ######### # # # # # # # ### #
#   #       #      . .#   # # # #   #   #
# # ##### ### ##### ####### ### #########
# # #   # #   # #. .#   # #   #         #
# # ### # # ### # # ### # ### ### ##### #
# #   #   #     #.# #     # #   # #   # #
# ### ########### # ##### # ##### # # # #
# # #        . . .#   #     #     # # # #
# # ######### # # # # ##### # ####### # #
# #      . . .# # # #   # #   #     #   #
# ####### ### ### # ### # # ### ### #####
# #. . . .#   #   # # # #   #   # # #   #
# # ########### # # # # ##### ### # ### #
# #.#           # #   #           #     #
### #####################################
