##### ###################################
#  . .    #     #     #   #       #     #
### # ### ##### # ### # ### ### # # #####
#. .#   # #     # #   # #     # # #     #
# ##### # # ####### ### # ##### # ##### #
#.#     #           #       # # # #   # #
# ################### ####### ### # # # #
#. . . .            #   #   #   # # #   #
# ##### ####### ### # ### # ### # ### ###
#   # #. . . .#   # # #   # #   #   # # #
# # # # ##### ### ### # ##### ##### # # #
# #   # #. . .  #       # #   #   # #   #
######### # # # ######### # ### # ##### #
#  . . . .# # #   #           # #     # #
# # # ##### # ##### ########### ### ### #
# #.# #     #   #   #     #     # #   # #
# # ### ##### # # ### ##### ##### ### # #
# #. .# #     # # #   #   # #     # # # #
# # # # ##### ### # ### # # # ##### ### #
# # #.#     #       #   #   #. .    #. . 
# # # ##### ##### ### ####### # ##### ###
# # #.    #   # # #   # #. . .#. .#. .# #
# # # ####### # ### ### # ####### # ### #
# # #. .#     #   # # #. .  #   #. .  # #
# ### # # ####### # # # ##### # ####### #
#   # #.#         #. . .      # #       #
# # # # ########### ############# #######
# # # #. .#. .  #. .              #     #
# # ##### # # ### ################# ### #
# #   # #. .#. .#.#           #     #   #
# ### # # ### # # # ####### ### ##### # #
# # #   #   # #. .  #     # #   #   # # #
# # # ##### ### ##### # # # # ### # # # #
# # # #   #   # #     # # #   # # # # # #
# # # ### # # # # ##### ####### # ##### #
#   # #   # # #   #   #     # # # #   # #
##### # ### # ##### ##### # # # # # # ###
# #   #   # #       #     # #   #   #   #
# # ##### ######### # ####### ######### #
#   #               #                   #
#########################################
