################# #######################
#  . . . .#  . . .    #       #       # #
### ##### ### # # ### # ##### # # ### # #
#. .#   #. .#.# #   # # #   #   #   # # #
# ### # ### # ##### # # # # ##### ### # #
#.#   #   #.#. .  # # # # #   # #   #   #
# ####### # ### # # ### # ### # # # #####
#.#   #   #.#. .# #   #   # #   # # #   #
# # # # ### # # # # # # ### ##### ### # #
#.# # # # #.#.# # # #           #     # #
# ### # # # # # # ### # ####### ####### #
#. .# # # #.#.# #   # # #     #       # #
### # # # # # # # # # ### # # # # ### # #
#. .# #  . .#.# # # # #   # # # #   # # #
# # # ### ### # # # # # ### # # ### # # #
#.# #    . . .# # # # # #   # #   # # # #
# ########### # ### ### # ### ##### # # #
#. . . .#     #   #     #   # #     # # #
# # ### ######### # # ##### # # ####### #
# #   #. . .    # # # #   # # #   #   # #
# ######### ### # # # # ##### ### # # # #
# #. . . .#.#   # # # # #   # #   # # # #
# # ##### # ##### # # # # # # # # ### # #
# #.#    . .#     # # #   # # # # # # # #
### # ### # # ### # # ##### # # # # # # #
 . .# #   # # #   # #       # # # # #   #
####### ### # # ### ######### # # # ### #
#     # #   # #   #   #     # # #   # # #
# ### ### ### ####### # ### # # ##### # #
#   #     #       #   #   #   #     # # #
# # ##### ### # # # ########### ### # # #
# # #     #   # # #         #   # # # # #
# # ####### ### # ######### ##### # # # #
# #     # # #   #     # #   #     # # # #
# ### # # # ######### # # # # ##### # # #
#   # # # #         # #   # # #   # #   #
### # # # ######### ##### ### ### # #####
# # # # #     #   #   #   #   #   #     #
# # # ### ##### # ### ##### ### ### ### #
#   #           #   #         #     #   #
#########################################
