################### #####################
#    . . . .#  . . .      #             #
# ### ##### # # ### # ##### ########### #
#   #.#   #.# #.#   #       #     #   # #
##### # ### ### # ########### ### # ### #
#. . .#   #. . .# #. . . . . . .# #     #
# ### ### # ### # # ########### # ##### #
#. .#   # # #   # #.#       #. .# #   # #
# # ### # ### ### # # ####### # # ### ###
# #. .# #   # #   #.# #. . . .# #   #   #
# # # ##### ### ### # # ########### ### #
# # #. .  # #   #  .# #. .#         # # #
# ##### # # # ##### # ### ########### # #
# #   #.# #   #    . .# #. . . .#. . .  #
# # ### # ########### # ##### # # ### ###
#   #. .#           #. .#   # #. .  #. . 
##### # ########### ### ### # ####### ###
#. . .#     #. . .# #. .#   #   #   #   #
# ########### ### ### ### ##### # # ### #
#. . . .#. . .  #. . .  # #   # # # # # #
# # ### # ####### # ##### ### # ### # # #
# #   #. .  #   # #       #   #       # #
# ##### ##### # # ######### ####### ### #
#     #     # # #           #     # #   #
# ### ##### ### ####### ######### # ### #
#   #     #     # #   #         # # #   #
# # ### # ####### # # ### ##### # # # ###
# #   # #   #       # #     # # # # # # #
##### # # ### ### ##### # # # # # # # # #
#     # #     #     #   # #   #   # # # #
# ### # ### ### # # # # # ##### ### # # #
# #   #   #   # # # # # # #   # #   #   #
# ####### ##### # # # # # ### # # ### ###
# #   #   #     # # # # #   #   #   #   #
# # # ##### # ### ### # ### ####### #####
#   #     # # # # #   #   #   #   # #   #
######### ##### ### # ##### ##### # # # #
#       #       #   # #   #     # #   # #
# ############### ##### # ### # # ##### #
#                 #     #     # #       #
#########################################
