########### ################# ###########
#   #     #.#      . . .#    . . .      #
# # ### # # ####### ### ##### # # ### # #
# #     #  . . . . .# #. . .# # #.#   # #
# ################### ##### # ### # #####
# #       #     #     #   #.# #. .#     #
# # ####### ### # ##### ### # # ####### #
# # #     #   #   #     #. .# #. .    # #
# # # ### ### ##### ##### ### ### ### # #
# # # # #         # #. . .# #   #. .# # #
# # # # ######### # # ##### ####### # # #
# #   #     #   # #  . . .#. . . . .# # #
# ######### # # # ####### # # ####### # #
#   # #     # # #     #  .#.# #       # #
# # # # ### # # ##### ### # ### ####### #
# #   #   # # #          . .#   # #     #
# ####### # ######### ####### # # # ### #
#       # #   #     # #       # #   #   #
# ### # # ### ### # ### # ##### ####### #
#   # # #   #     #     # # #   # #     #
### # # ### ######### ### # # ### # # # #
# # # #   # #         #   #   # # # # # #
# # ##### ############# # ##### # # # # #
# #     # #             #         # # # #
# # ### # # ### ######### ##### ### # ###
# # #   # # #   #       #     #   # #   #
# ### # # # ##### # ### ##### ##### ### #
#     # # # #   # #   #   # #   #   #   #
##### # # # # # # # # ### # ### # ##### #
# #   # # #   # # # # # #     # # #   # #
# # ### # ##### # ##### ##### ### # # # #
#   #   # #   # #     #           # # # #
##### ### ### # ##### ####### ### # ### #
#     #       #     # #   #   #   #     #
# ############# # # # ### # ### ### #####
# #   #   #   # # # #   # # # # #   #   #
# ### # # # ### # # ### # # # # ##### # #
#     # #   #   # #   #   # # #     # # #
####### ##### ### ### ##### # # ### ### #
#             #   #   #       #   #     #
#########################################
