### #####################################
#. .#. . . .    #       #     # #       #
# ### ##### # ### ### ####### # # ##### #
#.#. .    #.#     # #       #   #   #   #
# # ####### ####### ####### ### ##### ###
#.#.#. .#. .#. . . .  #   #   # #     # #
# # # # # ### ##### # # # ### # # ##### #
#.#.#.#. .#. .# #. .# # #   #           #
# # # ##### ### # # # # ### ### #########
#.#.#. . . .    #.# # #   #   # #   #   #
# # ############# # # ### ### # # # # # #
#. .    # #. . . .# #   #   # # # # # # #
# ##### # # # ######### ##### # ### # # #
#     #   #.# #. . .  #       #     # # #
##### ##### ### ### # # # ######### # # #
#   #   #  . . .  #.# # #         #   # #
# # ### # # ####### # # ####### # ##### #
# # #   # #     #. .# # #     # #   #   #
# # # ######### # ### # # # # ### # #####
# # #         # #. .# # # # #   # # #   #
# ########### ##### # ### # ### # # # # #
#  . . .#   #   # #.#     #   # # # # # #
### ### ### ### # # ####### # # # # # ###
 . .#  . .#   # # #.  # #   # # # # #   #
######### ### # # # # # # ##### ### ### #
#       #.  # #   #.#   # #   #   #   # #
# ####### ### ##### ##### # ##### # # # #
#     #. .#  . . . .#   # #   #   # #   #
##### # ### # # # # # # # # ### #########
#   #  .#   #.# # #   # #     #     #   #
### ### ##### # # # ### # # # ##### # # #
#      . .#. .# # #   # # # #     #   # #
# ####### # ##### ### # # ######### ### #
#   #    . .# #   #   # #         #   # #
### # ####### # ####### ######### ### # #
#   # # #     # #             #   #   # #
##### # # ##### # # ### ####### ### ### #
#     # # #     # # #   #     #   # #   #
# ##### # ### ### # ##### ### ### #######
#       #     #   #       #     #       #
#########################################
