######### ###############################
#    . . .        #   #     #   # #     #
# ### ### ####### # # # ### # # # # ### #
# #. .#   #. .#   # #   #   # # #     # #
# # ####### # # ### # ####### # # ##### #
# #. . .#. .#.#   # # #     # # # #     #
# ##### # ### ### ### # ### ### # #######
#     #. .  #. .#   # #   #   # # #. . . 
########### ### ### # ### ### # # # #####
#. . . .# # #. .  #     #   #   #. .    #
# ##### # # # # ############### # ##### #
#.# #. .#   #.# #. . .    #   # #.#   # #
# # # ####### # # ### # ### # # # ### # #
#.#  . . . . .# #.# #.#     # #. .    # #
# ##### ##### ### # # ######### ####### #
#. .#   #   # #. .  #. . . . . .# # #   #
# # ##### ### # ##### ####### ### # # ###
# #. . .#     #.#   #   #   #   # # #   #
# # ### ####### # # ##### # ##### # # # #
# # #. .    #. .# # #     #       # # # #
# ### # ##### ##### # ######### ### ### #
#   #.# #. . .      #   #     #   # #   #
### # # # ############# # ### ### # # ###
#   #.# #. .          # #   #   #   # # #
# ### ##### ####### ### ### ### ##### # #
# # #. . . .      #       # # #     #   #
# # # ##### # ### ######### # ##### #####
#   #     # #   #             #   # #   #
# ####### # ######### # ####### # # # # #
#       # # #       # #         # #   # #
######### # # # ### ##### ### ### # ### #
#         # # #   #         # #   # # # #
# # ##### # # ### ####### # ### # # # # #
# # #   # # #   #   #     # #   # #   # #
### # # ### ####### # ####### ######### #
#   # # #     #   # # #   #   #   #   # #
# ### # # ##### # ### # ### ### # # ### #
# #   # #   #   # #   #   #     # #     #
# # ####### # ### ##### ######### #######
#         #     #               #       #
#########################################
