################################### #####
#   #                           #  . .  #
# # # ### ### ##### ########### # ### # #
# # # #   #     #   #      . . .#   #.# #
# # ### ### ##### ### ##### ### ##### # #
# #     #   #     #   #  . .#  .#. . .# #
# ####### ### # ### ### # ##### # # #####
#     #   #   # #   # # #. .#  . .# #. .#
##### ##### ### ##### ### # # ####### # #
# #   #   # #       #   # #.# #. . . .#.#
# # ### ### ### ### ### # # ### ####### #
# #   # #     #   #     # #. .#. .#   #. 
# ### # # ### ### # ### # ### ### # #####
#   # # # #     # #   # #   #.#. .#     #
### # # # # ### # ### ### # # # ####### #
#   # # # #   # #   #   # # #.#. . .#   #
# ##### ##### ##### ### ### # ##### # ###
#         #   #     # #   # #. . . .#   #
######### # ### ##### # # # ### # ##### #
#   #   #   #   #   # # # #   # # #     #
# # # ##### # # ### # ### # # # ### #####
# # #     # # # #   # #   # # #     # # #
# # # ### # # ### ### # # # # ####### # #
# # # #     #     # #   # # #       #   #
# # ### # ### # # # ### ### # ######### #
# # #   # #   # # # #   #   #         # #
# ### ##### # # ### # ### ### # ### # # #
#     #     # #     # #   #   #   # #   #
####### ############# # ### ##### # #####
#       #           # #   #     # #     #
# # ### ######### # ### # ##### # ##### #
# # #       #     #   # #     # # #     #
# ### ##### ######### ##### # # # #######
#   #     #     #           # # #       #
### ########### # ##### ####### ####### #
# #           # # #     #     #   #     #
# ########### # # # ##### ### ### # #####
#             # # #   # # # #   # # #   #
############### # ### # # # ##### # ### #
#               #   #   #         #     #
#########################################
