######### ################# #############
#   #    . .      #. . . .#. . . . . . .#
# # ### ### ##### # ##### ############# #
# # #   #. .#     #. .# #.#. . .  #. . .#
### # ### ########### # # # ### ### ### #
#   # #  .#. . . .  #.  #. .  #. . .  # #
# ### # # # ##### ### ####### ##### # ###
#     # #. .    #. . .#     # #   # #   #
### ### # # ########### ### # ### # ### #
#   #   # # #             # #   # #   # #
##### # # ### ##### # ##### ##### ### ###
#   # # #     #   # #     #         #   #
# # # # # ##### # # ##### ### ##### # # #
# #   # # # #   # #     #   # #   # # # #
# # # # # # # ### ##### ### ### # # ### #
# # # # # # # # #     #   #     # # #   #
# # # # # # # # # ### # ######### # # ###
# # # # #   #   # #   #     #     # # # #
# ### # ##### ### # # ##### ####### # # #
#   # #         # # #   # #     #   #   #
# # # ######### ### ### # # # ### # # ###
# # #         #   #   #   # #   # # #   #
# # ######### ### ############# # ##### #
# #         #   #     # #     # #     # #
# ####### # ### ##### # # ### # ### # # #
#   #   # #   # #     #   #       # # # #
# # ### # ### # ################### # # #
# # #   #   # # #       #         # # # #
# # # ### ### # # ### # # ####### # ### #
# #   #   #   #     # #   #     # # #   #
# # ### ### ### # ### ####### # ### # ###
# #   # #   # # #   #     #   # #   #   #
# ##### # # # # ### # # # ##### # ##### #
# #     # # #   # # # # #     #   #   # #
# # # ### ####### # # # ############# # #
# # #   #         # # # #             # #
# ############# ### # ### ############# #
#   #             # #   # #         #   #
### # # ########### ### # ##### ### # # #
#   # #     #         #   #     #     # #
#########################################
