# #######################################
#. . .    #     #   #         #     # # #
##### ### ### ### # ######### # ##### # #
 .#. .  #     #   #         #   #   #   #
# # # # ### ### ########### # ### # ### #
#.#.# #   #     #         #       # # # #
# # # # # ####### ### ############# # # #
#.#.# # #       # # #             # #   #
# # # ######### # # # ####### ### # # ###
#.#.#         #   # #   #       # # # # #
# # ############### ####### # ### # # # #
#.#. . . . . .        #   # # #   # #   #
# # ######### ######### # ### # ####### #
#.#       #. .          #   # #   #     #
# ####### # # ############# ##### # #####
#. . .# # #.#       #     #     #   # # #
##### # # # ##### # # ### ### ####### # #
#    . .# #. .  # # # # #   #       # # #
####### # ### # ### # # # ##### ##### # #
#   #. .#   #.#   #   # #     #     # # #
# # # ####### ### # ### ##### ### # # # #
# # #.#  . . .  # #     #       # #   # #
# ### ### ##### # ####### ##### # ### # #
#   #. . .#     # #       #   # #   # # #
### ####### ##### ######### # # ### ### #
# #         #     #         # #   #     #
# ############# # # ######### # # # #####
#       #       # #       # # # # # #   #
##### # # ### # # ####### # ### # # # ###
#     #   # # # # #             # # #   #
# ####### # # # # ######### # # # ##### #
#   #     #   # #   #       # # #     # #
# # # ######### ### # ####### # # # ### #
# # # #     # # # # #   #     # # #     #
##### ##### # # # # ### # ##### #########
#     # #   # #   #   # # #   #   #     #
# ### # # ### ####### # # ### ### ##### #
#   # # # # #         # #   #   #     # #
# # ### # # ####### # # ### ### # ### # #
# #     #           # #   #     #   #   #
#########################################
