### ################# ###################
# #.#  . . . . . . .#.      #     #     #
# # # # ### ####### # ##### ##### # ### #
#  .# #.#   #     #. .    #   #   #   # #
### # # ##### ### ### ### # # # ##### # #
# #.# #. . .# # # #   #   # #   #     # #
# # ### ### # # # ##### ### # ### #######
# #. .#   #.#   #   #   #   #   # #     #
# ### ##### ####### ### # ####### ##### #
# # #. . .#. . . .#     #       #       #
# # ##### # ##### ############# # #######
# #. . . .#     #. .          #         #
# # ############### ##### # # # # ### ###
# #. .#    . .#. . .    # # # # # # #   #
# ### ##### # # ### ### ### # # ### ### #
#   #. . . .#.#.#   #   #   # #   # # # #
### ##### ### # # ####### # # ### # # # #
#   #     #  . .# # #     # #   # #   # #
# ######### ### # # # ##### # # # ### # #
# #       # #   # # # #   # # # #   # # #
# # ##### ### ### # # # # ### ##### # # #
#   #         #     #   #   #     # # # #
# # # ####### ####### ### # ### ### # # #
# # # #   #   #     #   # #   #   # # # #
# # # ### # ### ### ### # # # # # # # ###
# # # #   # # # #   #   # # # # # # #   #
### # # ### # # ##### ##### # # # # ### #
#   # # #   #         # #   # # # #     #
# ### # ### ######### # ### # # # #######
#   # #   #   #       #     # # #     # #
# # # ### # # # ############# ### ### # #
# # #     # # # #         #     # # # # #
# # ####### # ########### # # # # # # # #
# # #       #     #       # # # # # # # #
# # ######### # # # ######### # # # # # #
# #     #     # #   #         # #   #   #
# ##### ####### ##### ######### #########
#   # #       # #   # #     #       #   #
# # # # ##### ### # # ##### # # ### ### #
# #   #     #     # #       # #   #     #
#########################################
