########### #############################
#   #      . . .    #. .  #. .    #     #
# # ### ####### ##### # ### # ### # ### #
# #   #   #   #. . . .#. . .#.  # # #   #
##### ### # # ####### ####### ### ### ###
 . . .# #   # #. . .#       #. .#     # #
##### # ####### ### ######### # ####### #
#   #.#      . .#  .#    . .# #. . . . .#
# ### ####### ##### # ### # ########### #
#    . . . . .#   #.# #. .#.#. . .#. . .#
##### ######### # # ### ### # ### # # # #
#     #         #  . . .#  . .# #. .# # #
####### ################# ##### ### ### #
#   # #   #   #           #   # #   #   #
# ### ##### # ### ######### # # # ### # #
#     #     #     #   #   # # #   #   # #
# ### ### ####### # # # # ### ##### ### #
# #       #       # # # #   #   #     # #
# # ####### ####### # # ### ### ##### # #
# #   #     #     # # #   #   # #     # #
# ### # ##### ### # # ####### # # ### # #
#   # # #     # #   #       #   # #   # #
##### # # ##### # ######### ### # # ### #
#     # # #   #   #     # #       # #   #
# ##### ### # ##### ### # ##### ### # # #
# #   #   # #   #   # #         #   # # #
# ### ### ##### # # # ### ####### ### ###
#   #   #   #   # # # #   #   #   #     #
### ### # # # ### # # # # ### # ####### #
# #     # # # #   #   # # #   # #     # #
# ######### # ########### # ### # ### # #
#           #             # #     #   # #
####### ######### ##### # # ####### ### #
#       #       # #     # # #       #   #
####### # ##### ### ### # # # ####### # #
#       # #   # #   #   # # # #       # #
######### ### # # ##### # # # # ### ### #
#   #     #     # #     # # # # #   # # #
# # # ##### ### ### ##### # ### # ### # #
# #   #     #       #     #     #     # #
#########################################
