############# ###########################
# #     #    .      #. . . .    # #     #
# # ### # ### ####### ##### ### # # ### #
# # #     #  . . . . .#. . .# # # # # # #
# # ####### # ######### # # # # # # # # #
#   #     # #     #   #.# #   # #   # # #
##### ### # ##### # # # ####### ##### # #
#       # #     #   # #. . . .#       # #
# ####### ##### ##### ### # # ##### ### #
#   #   #     #     #   # # #.    #     #
### # # ##### # ### ### # ### ###########
#   # #     # #   # # # #   #. . .      #
# ### ##### ####### # # ### # ### ##### #
# #   #     #       #     # #   #. .  # #
# ##### ### # ############# ##### # ### #
# #     # #   #  . . .# #   #. .# #.#   #
# ####### ####### ### # # ### # # # # # #
#       #  . . . .# #.#   #. .#.# #.# # #
####### ### ##### # # ##### ### ### # ###
#    . . . .#   # # #. . . .#  . . .#   #
##### ### # # ### # ######### ##### # # #
 . . .#   # #     #   #       #     # # #
####### ### # ####### ######### ##### # #
#     # #   # #     #           # # # # #
# ##### ### # # ### ############# # ### #
#       #   # #   #   #         # #   # #
##### ### # # ### ### # ####### # ### # #
#   # #   # # #   # # # #     # #     # #
# ### # # ### # ### ### # ##### ### ### #
#     # #   # #   #   # #               #
####### # # ### ##### # ############### #
#       # #           #     #     #   # #
# ### ################# ######### # # # #
# # #       #   #       #       # # # # #
# # ####### # # # ### # # ### ### # ### #
# #   #   # # # # #   # #   #     #     #
# ### # # # ### # ##### ### ####### ### #
#   #   # # #   #     #   #       # #   #
# # ##### # # ### # ##### ####### ### # #
# #       #   #   #     #       #     # #
#########################################
