################################### #####
#        . . . . .#    . . .#  . . .    #
# ####### ####### ##### ### ### # # ### #
#   #  . .#     #. .#  .# #. . .# #   # #
# # # # # ##### ### ### # ############# #
# # # #.# #. .#    . . .#     #         #
### # # # # # ####### # ##### # # #######
#   # #.# #.#. . .#   #   #     # #     #
# ##### ### ##### ####### ####### # ### #
# #   #. . .    #. .    #     # # # # # #
# ### # # ##### ### ### ### # # # # # # #
#     # # #. .# # #.  #   # # #   # # # #
####### ### # # # # ##### # # ####### # #
#     # #. .#.# # #.#     # #         # #
# ##### # ### # # # # ### # ##### ##### #
# #     #.# #.#   #.# #   # #   #       #
# # ##### # # ##### # ##### ### # ##### #
#   #  . .# #. .#  .#     #   # #     # #
##### # ### ### ### ### ##### # ##### ###
# #   #.#   # #. .#. .#   # #   #   #   #
# # ### # ### ### # # ### # ##### # # # #
#   #  .#  . . . .# #.  # #       # # # #
##### # ### ######### # # ######### ### #
#     #. .#.#    . . .# #         #     #
######### # # ### # # # # # ### # #######
 . . . . .#.# # #.# # # # # #   # #     #
########### # # # ### # # ### # # # ### #
# # #. .#. .#   #.#   # # #   # # #   # #
# # # # # ####### # ### ######### # # ###
# #  .#. .#    . .# # #     #     # #   #
# ### ######### # # # # # # ####### ### #
#   #. .#. . . .# #   # # #           # #
### ### # ##### # ##### ####### ##### # #
#   #  . .# #   # #   #       #   #   # #
# ####### # # ### # # ####### ### ##### #
#     #   #   #   # #       #   #   #   #
##### ######### ### ####### ### ### #####
#   #         # #   #     #       #     #
# ########### # # ### ################# #
#               #   #                   #
#########################################
