####################### ### #############
#     #    . . .#. . . .  #.#   #       #
# ### # ### ### # ### ##### # # # ##### #
# # # #   #.#  . .#   #. . .# # # #   # #
# # # ##### ##### # ### ##### # # # ### #
# #. . . . .#. .# # #  .#     # # # #   #
### # ##### # # ### ### ####### # # # ###
#. .# #. .# #.#. .#   #. . . .  # # # # #
# # ### # ### ### ### ####### ##### # # #
#.# #. .#. . .  #.  # #   #. .      #   #
# ### ########### ### ### # ########### #
#. . .        #. .#   #   #.# #         #
# # ########### # # ### ### # # #########
# #   #. . . . .# # #   # #. .#         #
# ### # ### ####### # ### ### ### ##### #
# #   #. .# #. . .# #. . . . .  # #   # #
# ##### # ### ### # # ########### # # ###
#     # #. .#.# #.# #.#   #   #   # #   #
# ### ### # # # # ### ### # ### ### ### #
#   #   # #. .# #. .#. .# # #   # #   # #
### ### # # ### ### ### # # # ### ##### #
#   # # # #   #   #. .#. .# # # #   #   #
##### # # ####### # # ### # # # ### # ###
#     # #       # # #.  #. . .#   # #   #
# ##### ### # ### # # # ##### # # # ### #
# # #     # #     # #.#     #.# #     # #
# # # # # ######### # ####### # ### ### #
#   # # #   #     # #. . . . .#   #     #
### ### ### # ### # # ############# #####
#         #     # # #               #   #
# ##### # # ##### # ############# ### # #
# #     # #   #   #   #         #   # # #
# # # ### ##### # # # # # ##### ##### # #
# # # #   #     # # #   #     #     # # #
# # # # ### ####### ######### ##### # # #
# # # #   #       #   #     # #     # # #
# # # ### ####### ### # ##### ######### #
# # #   #       #   # #     #       # # #
# # ############### # ##### # # ##### # #
# #               # #       # #         #
#########################################
