##### ############################### ###
#   #.#   #       #       #       #  .  #
# # # # # ##### # ### ### ### ##### # ###
# # #.# #       # #   # #   #       #. .#
### # # ######### # ### ### ########### #
#   #.#   # #. . .#   #. . .#      . . .#
# ### ### # # ### ##### ### # ##### ### #
# # #.  #   #.# #. . . .#  .#   #. .# # #
# # # ####### # ########### ### # ### # #
# # #.#  . . .# #          . .# #.#   # #
# # # # # ### # # ########### ### # ### #
# #. .# #.# # # #     #   #  . .#.#     #
# # ##### # # # ####### # ##### # #######
# #. . . .# # #     #   #   #  .#. .    #
# ##### # # # ##### # ##### ### # # ### #
#       # #   #       #   #    .# #. .# #
######### ### ######### ####### # ### ###
#       # #   #           #   #.#   #. .#
# ##### # # ### ####### # # # # ####### #
# #   # # # # # #     # # # #  . . . . .#
# ### # # # # # # ### # # # ####### ### #
# #   #   # # # #   # # # # #   #   #   #
# # ##### ### # ### ### # ### ### ### # #
# # #     #   #   #   # #     #   #   # #
# # # ##### ######### # ####### ### ### #
# #   # #   #       #           #   #   #
# ##### # ### # ### ##### ####### # # # #
#       # #   # # # #     #       # # # #
# ### ### ##### # # ### ### ##### # # ###
#   #   #       #       #   #     # #   #
### ### ################# ### ##### ### #
# #   #     #         #   #   #     #   #
# ### # ############# ### # # ####### ###
#   # #             #   # # #       #   #
### # ##### ########### # # ### #########
#     #   #   #   #     # #   #         #
##### # # # ### # # ##### ### ######### #
#     # # #     #     #     # #   #     #
# ##### ############### # # ### # #######
#     #                 # #     #       #
#########################################
