############################# ###########
#         #                  . . . . .  #
### ### # ######### ####### # # ##### # #
#   #   #         # #   #   # #   #. .# #
# ### ########### # ### ##### ### # ### #
#   # #             #   #   #   # #.#   #
##### ########### # # ### # ### ### #####
#   #     #       # #     #     #. .#. .#
# # ############### # ########### ### # #
# #   #         #   # #    . . . .#. .#.#
##### ######### # ##### ### ####### ### #
#   #   #     #   #     # #. .#. . .# #.#
# ##### ##### ####### # # # # # ### # # #
#               #     # # # #. .  #   #.#
############### # ### # # # # # # ##### #
#                 #   # #   # # # #. . .#
# # ################### ##### ### # #####
# # #       #       #   #   #   # #. . .#
# # ####### # ####### ### # ### # ### # #
# #       # # #   #   #   # #   #   # #.#
# ####### # # ### # # ### ### ##### # # #
#   #   # # #     # #   #     #     # #.#
# # # ### # ##### ### # ##### # ####### #
# # # #   #     #   # # #   # # #. . . .#
# # # # # ##### ### ### # # ### # ##### #
# # # # # #   # #       # #   # #.#   # #
### # # # ### # ######### ##### # ### # #
#   # # #   # #         # #     #. .# # #
# ### # ### # ######### # ### ##### # # #
#   # #   #   #       #       #. . .#   #
### # # # ##### ##### ######### # #######
# #   # #     # # #      . . . .# #. . . 
# ##### ####### # # # ### ######### #####
# # #   #       #   # #  . . . . .#.    #
# # # ### ########### ##### ### # # #####
#   #   # #         #     #   # #. .#   #
### ##### ### ##### ### # ### # ##### # #
#   #     #   #       # # # # # #     # #
# ### ##### ######### ### # # # # ##### #
#     #     #             #   #   #     #
#########################################
