############################# ###########
#                            .          #
# ### ####### ### ### ####### ####### # #
# #   #       #   #   #     #. .  #   # #
### ########### # # # ##### # # # # # # #
#   #     #   # # # #     #   #.# # # # #
# ### ### ### ### ##### # ##### # # ### #
#       #     #   #   # # #. . .# #   # #
# # ##### ##### ### # ### # ######### ###
# #     # #     #   #   # #. . . .  #   #
# ##### # # ### # ##### # # # ### ##### #
#   # # # #   #   #   # # # #   #.#   # #
### # # # ### # ### ### # # ### # # ### #
#   #   # #   #     #   # #   # #.# #   #
# ######### ######### ### ### ### # # # #
# #   #     # #   #   #     #   #.#   # #
# ### # ##### # # # ### # ##### # #######
# # # #   # #   # # #   #     # #. .    #
# # # # # # # ### # # ##### ### # # ### #
# #   # # # # # # # # #     #   # #.# # #
# # ##### # # # # # # # # # # ##### # # #
# #       # #   # # # # # # # #  . .#   #
# ####### # ### ### # # # # # # # # #####
#   #     # #     # # # # # # # #.# #. .#
### ####### # ### ### # # ### # # ### # #
# # #       # #       # #   # # #. . .#.#
# # # ######### # ########### ######### #
#   #     #     # #           #. . . .#.#
######### # # ##### # ######### ##### # #
#   #   # # # #     # #     #  . .# #.#.#
# # ### # ### # ##### # ### # # # # # # #
# #   #       #   #   # #   # # #.# #. .#
# ### ########### ### # # ### # # # # # #
#   #   #         #   # #     # #.# # # #
### ### # # ####### # # ######### # ### #
#   #     #   #     # # #       #.#     #
############# # ##### # # ####### #######
# #           #     # # # #  . . .  #   #
# ##### ############# # # # # ### # ### #
#       #             #   # #.#   #     #
############################# ###########
