######### ################### ###########
#      . .#   # #. . .#. . .#.#   #     #
### ### # ### # # ### # ### # # ### ### #
#   #. .#     # #.# #.#.# #.#. .    #   #
# ### ######### # # # # # # ### #########
#   #.#. . . .  #.# #.#. .#.#. .#     # #
### # # ##### ### # # ### # # ### ### # #
#   #. .    #. .#.  #. . .#.#.  #   #   #
# # # # ### ### # ######### # ######### #
# # # #   #   #. .    #   #. .#       # #
# # # ### ### ######### # # ### ### ### #
# # # # #   #     #     # #       #     #
# ### # ######### # ##### ###############
#   # #         #       #               #
# # ### ##### # # ########### ######### #
# #         # # #   #       #     #     #
# # ####### # # ##### ##### ### # # # # #
# #       # # # #     #   #   # # # # # #
# ####### # ### # ####### # # # ### ### #
#       # # #   #   #     # # # #   #   #
# ### # # # ##### ### ########### ### ###
#   # # # #     #     #         #   # # #
# # ### # ##### # ############# ### # # #
# # #   #     #   #         #       #   #
# # # ##### ####### ####### ##### #######
# # #     #       #     #   #   # #     #
# # ##### ### ### # ######### # ####### #
# #     #   #   # # # #       #     #   #
# ##### # # # # ### # # ######### ### ###
#     # # # # #   # # # #       #       #
##### # # # # ### # # # # ###############
#     # # # #   #     #   # #           #
# ### # # # ##### # ### ### # ######### #
# #   # # #     # #           #     #   #
# # ### ####### # ################# # ###
# #   #     # # #             #   # # # #
# ### ##### # # ##### ##### ### # # # # #
#   #     #   #     #     #   # # # # # #
# # ########### ####### # ### ### # # # #
# #           #     #   #   #       #   #
#########################################
