################# ##################### #
# #   #       # #.#    . . . .# #      .#
# # # ### ### # # ##### ##### # # ##### #
# # #   #   # #  . . .#.#    . .# #. . .#
# # ### ### # ####### # ####### ### # # #
# # # # #   #   #   #.#. . . .#. . .# # #
# # # # # ##### # ### # ##### ### ##### #
#   # # # #     # #. .# # #. .#   #     #
##### # # ####### # ### # # ### ### ### #
#     # #       #. .# # # #. .# #   # # #
# ### # ####### # ### # # # # # # ### # #
# #           #  .# # #   # #.# #   #   #
# ########### ### # # ##### # ##### #####
#       #        . . . . .# #. .  #     #
# ##### ######### ####### ##### ####### #
#     #       # # #      . . .#. .#   # #
####### ##### # # # ######### ### # # # #
#     #   #   #   #   #      . . .# #   #
# ### ################# # ##### ### ### #
#   #                 # # #     #   # # #
# # ####### ######### # # # # ### ### # #
# #   #       #     #   # # # #   #   # #
# # # # ##### # ### ### # # # ##### ### #
# # # # #     #   #     # # #     # #   #
# ### ### ############### # ##### # ### #
# #   #   #               #     # #     #
# # ### ### ############### ##### #######
# # #   #   # #           # #     #     #
# # ######### # ####### # ### # ### ### #
# #   #     # # #       # #   # #   # # #
# # # ##### # # # ### ### # ### ##### # #
# # #   #   #   #   # # #   #           #
# ##### ### ######### # ### # # # ##### #
# #     #             # #   # # #     # #
####### # # # ####### # # ### # ##### ###
#   #   # # # #       # # #   #     #   #
# # ##### ### # ####### ### ##### ##### #
# #     # #   # #     #   # #   #     # #
# ##### ### ### ##### ### # # ####### # #
#     #     #         #     #         # #
#########################################
