##################################### ###
# #     #     #                      . .#
# # ##### # # ##### ################### #
# #       # #   #   #       #. . . .#. .#
# ######### ### ### # ####### ##### # # #
#           # #   # # #. . . .#    . .# #
############# ### # # # ####### #########
#       #   # # # # # #. . .#   #. . . .#
####### # # # # # # # # # # ##### ##### #
#       # #   #   #   # # #. . . .#   #.#
# ##### # ##### ### ### # ### ####### # #
#     # # #   #   #   # #   #     #   #.#
####### # # # ### ##### ### ##### # ### #
 . . . .  # # # # #     #   #   #   #. .#
####### ### # # # ### ######### ##### # #
#   #. .#   #   #     #  . . .# #    .# #
# # # ### ########### # # ### # # ### ###
# # #.# # #     #     # #.# #.# # # #. .#
# # # # # # ### # ##### # # # # # # # # #
# #  .# # #   # # #     #.#. .#   #   #.#
# ### # # ### # # ### ### # ########### #
# # #. . .#   # # #   #. .#.#    . . . .#
### ##### ##### # # ### ### ##### # ### #
#   #   #.#     # # #. .#  . . . .# #   #
# ##### # # ####### # # ### ### ### # # #
#     #  .#       # #.# #   # # #   # # #
##### ### ####### # # # # ### ### ### ###
#       #. .#  . .# #.# # #     # #     #
####### ### ### # ### # # ##### # ### # #
#     #   #. .#.#. . .# # #   # #   # # #
# ### ### ### # ####### # # ### ### ### #
#   #     #  . .#   #   # # #   #   #   #
# # ##### ### # # # ##### # # ####### # #
# # #   #   # # # # #     #   #       # #
### # # ### # # # ### ####### # ##### # #
#   # #   # # # #     #         #     # #
# ### ##### ### ############### ####### #
#   #     # #   #     #   #     #     # #
# # ##### # # ### ### # # ### ### ### # #
# #     #     #   #     #     #     #   #
#########################################
