################### #####################
#         #        . . .      #   #   # #
# ####### ### # ### # # ##### # ### # # #
# #   # #     # #   # #.#   # #     #   #
# ### # ####### ### ### # # # ######### #
# #   #         #   #. .# #     #     # #
# # ##### ####### ### ### ##### # ##### #
#   #     #       #  . .#     # # #   # #
##### # ######### # # # ##### ### # ### #
#     #   #       # # #.    # #     #   #
####### # # ####### ### ##### # ##### ###
#     # # # #     #   #. . .#   #       #
# ### ### # # ### ### # ### ##### #######
# # # #   # # # # #   # #. .        #   #
# # # # ### # # # # # # # ######### ### #
#   # # # #     # # # # #.#. . .  #     #
### ### # # ##### # ### # # ### # #######
# # #     #   #   # #   #. .  #.#       #
# # ######### # # # # ### ### # ####### #
# #     #     # # # #   #   # #. .# #   #
# ##### # ######### ### ### ##### # # ###
#   # # # # #         #   #   # #.#   # #
### # # # # # # ### # ### ### # # ##### #
#   #     # # # #   # # #   #   #. .  # #
# ####### # # # ####### # # ####### # # #
#         #   # #       # # #  . . .# # #
############### # ####### ### # ##### # #
#                       #   # #. .#   # #
####### ######### ####### # # ### # ### #
#       # #     #   #   # # # #. .#   # #
# ####### # ### ##### # ### # # ##### # #
#   #       #   #   # #   # # #. . .#   #
# # ######### ### # ##### # # ##### #####
# #   #       #   #     #   #     #.  # #
# ### # ##### ### ##### ########### # # #
#   # # #   #     #   #      . . . .# # #
### # ### # # ##### # ####### ##### # # #
#   #     # # #     # #  . . .#   # # # #
# ######### # # ####### # ##### # # # # #
#       #   # #         #.#     #   #   #
######################### ###############
