##### ###################################
#. . .#   #   #   #   #           #     #
# # # # ### # # ### # ######### ### #####
#.# # #     #       #   #   #   #   #   #
# ### ######### ####### # ### ### ### # #
#. .#               #   # # # #   # # # #
# # ############### # ### # # # ### # # #
# #. .          #   # #     # #   #   # #
##### ### ##### ####### ##### # ### ### #
#. . .  #   # #     #   #   # # # # # # #
# # # # ### # # # ### ##### # # # # # # #
#.# # #   #   # #   #       # #   # # # #
# # # ### ######### ####### # ### # # # #
#.# #   # #       # #         #     # # #
# ##### # # ##### # # ######### ##### # #
#. . .# #     #   # # # #       #   #   #
# ### # # ##### ### # # # ####### # #####
#   #.# #   #   # # # # #       # #   # #
##### # ##### ### # # # ####### # ### # #
#. . .# #   #   # # #   #     # # #   # #
# # # # # # ### # # ### # ### # ### ### #
#.# # #   # # #   #   # #   # # #       #
# ### # ### # ##### ### ##### # # #######
#. .# #   # #       #   #     # # # #   #
# # # ##### ### ##### ### ##### # # # # #
# #.# #     #   # #. . . .          # # #
# # # # ##### ### # ##### ### ####### # #
# #.# #   #   #  . .#   #.  #   #     # #
# # # ### ####### ##### # # ### # ##### #
# #.#   #       #. . .# #.# #   #     # #
# # ################# # # # ##### ### # #
# #. .#. . . .    # #.  #.#     #   # # #
# # # # ##### ### # # ### ### ### ### # #
# # #. .  #. .#   #. .#. .  #     #   # #
# ####### # ### ### ### ########### ### #
#     # # #.#   # #.# #. . .    #   # # #
##### # # # ##### # # ##### ##### ### # #
#   # # # #. . . . .#   #. .# #   #   # #
# ### # # # ########### # # # # # # ### #
#     #   #             #.# #   # #     #
######################### ###############
