######### ###############################
#   #  . .  #     #     #   #           #
# ### # # # # ### ##### ### # ######### #
#     #.# #     #     #     #     #   # #
### ### # ### ### ### # ######### # # # #
#   #  .#   #   #   #             # # # #
# ### # ### ### ################### ### #
# #   #.  #   #       #             #   #
### ### # ### ####### # ##### ####### # #
#   #  .#   #     # #       # #   #   # #
# ### # ### ##### # ######### # # ### # #
#   # #. .#     # #           # #   # # #
# # ##### ##### # ########### ##### # # #
# #     #. .  # #       #     #     # # #
####### # # ### ##### # ####### #########
#     # # #. .# #   # #         #       #
# ### # # ### ### # # ################# #
# # # # #   #. .# #     #               #
# # ### ### ### # ##### # ###############
#         #   #.#     #   #             #
##### # ####### ########### ######### # #
#   # # #    . .      #     #       # # #
# # ### # ### # ####### ##### ####### ###
# #     # #  .#               #     #   #
# ####### ### ######### ####### ### ### #
# #   #     #. .  #   #   #       #   # #
# # # ##### # # # ### ### # ########### #
#   #     # # #.#     #   # #     #     #
# ######### ### ##### ##### # ### ### # #
# #         #. .    # #     # # #   # # #
# # # ####### # ### ### ##### # ### ### #
# # # #      .#   #     #. .  #   # #   #
### # ####### ### ####### # ##### # #####
#   #   #. . .  #   # #. .#. . .  #     #
# ##### # ##### ### # # ##### # ####### #
# # #   #.#. .# #   #. .#   # #. . .# # #
# # # ### # # ### ### ### # ####### # # #
# # # # #. .#. .#   #.#   #   #   #.# # #
# # # # # ##### ##### # ##### ### # # # #
#   #   #     #. . . .      #     #.#   #
################################### #####
