######################### ###############
#   #   #      . . . . . .              #
# ### # ##### # # ### ### ############# #
#     #       #.# #   #   #     #     # #
############### # # ### # # ### ##### # #
#. . .#      . .# # # # # #   #     # # #
# ### ####### ### # # # ##### ##### # # #
#. .#. . .#  .#   # # #     # #. .#   # #
# # ##### ### # ### # ### ### # # ##### #
# #.#   #.#. .# # #   # #   #. .#. . .# #
# # ### # # ### # ##### ### # ####### # #
# #.#   #. .#   #. . . . .# #. .#. . .# #
# # # ### ### ### ####### # ### # #######
# #.#   # #   #. .#   #. .#   #.#. . . . 
# # ### ### ### ### # # ####### ####### #
# #.  #     # #.#   # #. . . . .#     # #
### # ####### # ##### ########### ### ###
#. .#       #  . . . .      #   # #   # #
# ##### ### ######### ####### # ### ### #
#. .  #   #   #     #.#   #   #   # # # #
### # ### # ### ##### # # # ##### # # # #
#. .#   # #   #   #. .  #   #   #   #   #
# # ### ##### ### # ######### # ##### ###
#.#   #   # #   # #.#   #     #     # # #
# ####### # # # # # # # # ######### # # #
#.#   # #   # # # #.# #   #       #   # #
# ### # ##### # # # # ##### ### # ##### #
#.  #   #     # # #.  # #   #   # #     #
# ##### ####### # # ### # ### ##### #####
#. . .#         #. .#       #       #   #
# # # ########### ### ################# #
# # #. . . .  # #.    #       #   #     #
# # ####### # # # ##### ##### # # # # ###
# # #     #.# #. .          # # # # #   #
# # # ### # ### ####### ### # ### # # # #
# #   #   #. . .#     #   # #     # # # #
# ######### ######### ### ######### # ###
#   #     #   #         #       #   #   #
# ### ### ### # ########### ##### #######
#     #     #             #             #
#########################################
