##################### ###################
#      . . . . . .#  .                # #
### ### ######### ### ### # ### ##### # #
#   #. .#     #  . .#.  # #   #     #   #
# ### ### ### ##### # # # ### ### # #####
#   #.#   #     #  .#.# # # #   # #     #
### # ######### ### # # # # # # # #######
#   #. . .    #    . .# # #   # # #     #
# ####### ### ######### # ##### # # ### #
#       #.#   #         #     # #     # #
####### # # ##### ######### # ######### #
#       #.# #     #         #     # #   #
######### # # # ### ##### # ### # # # ###
#. . . .#.# # # #   #     #   # # # #   #
# ##### # # # # # # # ####### ### # ### #
#. .#. .#.# # # # # # #       #   #     #
# # # ### # ### ### ### ####### # #######
# #.#.#. .#   #   #   #       # # #     #
### # # # ### ### # # ##### # # ### ### #
 . .#. .# #   #   # #     # # #     #   #
# ####### # ### # # # ### ### # ### # # #
# #   #   # #   # # #   #   # #   # # # #
# # ### ### # ### # # # ### # ### ### # #
# # #   #   # #   # # #   # #   # #   # #
### # ### ### ##### # # ### ### ### ### #
#   # #   #       # # # #   #   #   #   #
# ### # # ##### ### ##### ### # ##### # #
# #   # #     # #   #     #   # #     # #
# ### # ##### # # ### ##### # ### # #####
# #   # #   # # # #   #     # #   # #   #
# # # # # # # ### ########### # # ### ###
# # # # # # #   #       # #   # # #   # #
# # # # ### # ######### # # ### ### ### #
#   # #     #     #     # # #     # #   #
# ### ############# # # # # # ### # # ###
# #   #     #       # # # # # # # # # # #
# # # # ### # ##### ### # # # # # # # # #
# # # #   # # #   # #   #   # # #   #   #
# # ##### # # ### ### ##### # # # ##### #
# #       # #   #     #     #   #       #
#########################################
