########### ##### #######################
#          .# #  . . . . . . . . . . .  #
##### ##### # # ####### ######### ### # #
#     #   #.# # # #. .#         #   #.# #
# ##### ### # # # # # ######### ### # ###
#   #   # #.# #   #.#. . . . .#   # #. .#
### # ### # # ##### ######### ### ##### #
#   # # #. .#    . .#   #. . .  #   # #.#
# ### # # ####### ### ### ######### # # #
# # # #  . . . . .#. .#. .  #     #   #.#
# # # ### ######### # # ##### ### # ### #
# #   # # #     #. .#. .#   # #   # #  .#
# # ### # # ### # ######### # ### # # # #
# #     # #   # #.#  . . . .#   # # # #.#
# ##### ##### ### # # ##### ### # ### # #
#     #   # #   #.# #.#    .#   #     #.#
# ### ### # ### # # # ##### ########### #
# #   # #     #  .# #. . .#. . . .#. . .#
# # ### ##### ### ##### # ### ### # # # #
# # #   #   #   #. . .# #. .# #  . .# # #
# # # ### # ### ##### # ### ### # ### # #
# # #     #   #      .# #. .#   # #   # #
# # ######### ####### ### # # ##### ### #
# # #     #         #. . .# #   #   #   #
# ### ### # ####### ### ### ##### ##### #
# #   # # #   #   #     #   #     # #   #
### ### # ##### ######### ##### # # # ###
#   # #   #     #   #     #     # # #   #
# ### # ### ##### ### ### # # ##### ### #
# # #   #       #     #   # #       #   #
### # ######### ######### ########### # #
#   # #       # #         #           # #
# ### ### ### # # ######### ### # ### # #
#         # #     #         #   # #   # #
########### ####### ########### # # ### #
#                   #           # #   # #
# ####### ############# ### ########### #
# # #     #       #     #   #     #     #
# # # ######### ############# ### # ### #
#   #         #               #     #   #
#########################################
