### # ###################################
# #.#. .  #. . . . .                    #
# # # # # # ####### ##### ####### # #####
# #.# #.# #.#     #.  # #       # #     #
# # ### ### # ##### # # # ##### ####### #
# #. .#. .#.# #. . .# # # #   # #   #   #
# ### ### # # # ### # # # # # # # # # # #
#    . .#. .  #.#   # # # # # #   # # # #
####### # ##### # ### # # # # ##### # # #
#     #.# # #. .#   #   # # #     # # # #
# ### # # # # ##### ##### ####### # # # #
#   #  .#   #.#     #   # #     #   # # #
####### ##### # ##### # # # ### ##### # #
#     #. . .#.# #     #   # # #       # #
# ### ##### # ### ####### ### # ####### #
# # #   # #.#. .# #     #   #   #       #
# # ### # # ### # # ### # # ##### ##### #
#   #  . . .#. .# #   # # #     #   #   #
####### ##### # # ### # ### # # # # #####
#     #.#  . .# #   # #   # # # # #     #
# ### # ### ### # # ##### ### # # # # ###
# # # #. .#.# # # #     #     # # # #   #
# # # ### # # # # # ########### # ##### #
# # #    . .# # # #     #     # # #     #
# # ####### # # # ##### # ### # # # #####
#   #       #   #     # # #   # # # #   #
##### ####### # ##### # ### ### ### # ###
#     #       #   #   #   # # # #   #   #
# # ############### # ### # # # # ##### #
# #       #     #   #   #   # # # #     #
# ##### ### # ### # ######### # ### #####
#     #     #   # # #   # # #   #   #   #
# # # ######### # ### # # # ##### ##### #
# # # # #   #   #   # #   # #   # #     #
# ### # # # # # ### ##### # ### # # ### #
#   # #   # # #   #       #     # #   # #
# # # ##### # ### ### ######### # ### # #
# # #     # #   #   # #       #   #   # #
# # ### ### # ##### ### ##### ### ##### #
# #   #     #     #         #           #
#########################################
