####################################### #
# #   #   #                 #          .#
# # # # # ##### ##### ##### ####### ### #
# # # # # #     #         #         #  .#
# # ### ### ### # ### ### ##### ####### #
# # #       #   # # #   # #     #    . .#
# # ##### ####### # ##### ####### ### # #
# # #     #       #       #       #  .# #
# # # ##### # ####### ### # ####### # ###
# # # #     # #       #   # #   #   #. .#
# # # ### # ### ##### # ### # # ##### # #
#   #   # # #   #     # #   # #     # #.#
# ##### # ### ######### # # # ##### # # #
# #     #   #     #   # # #       # # #.#
# # ##### # ### # # # # # ######### ### #
#   #     #   # #   # # #   # #     #. .#
##### ##### # ##### # # ### # # ##### # #
#     #     # #   # # #   #   # #    .# #
# ####### ### # # ### # # ####### ### ###
# # #     # #   # #   # #     #   #  . .#
# # ### # # ##### # ######### # ### # # #
# #     # #     # # #       # # #   # #.#
# ##### ####### # # ####### # # # ##### #
#   #   #     #   #     #   # # # #   #.#
# # # ### ### ########### ### # # # # # #
# # # #   # #           #     # #   # #.#
### # # ### ####### ### ####### ##### # #
#   # # #   #       #     #       #   #.#
# ##### # ######### ##### ### ##### ### #
#     # #   #     # #   #   # #     #. .#
##### # ### # ### ### # ### # # ##### # #
#     #     # #       #   #   #     #.# #
############# ########### ######### # # #
#             #        . . . . . .# #.# #
# ##### ### ### ####### ### ##### # # ###
#     # #   #   #   #  .# # #   #.# #. .#
##### # ##### ##### ### # # # # # # ### #
#   # #   # #     #   #.# # # # #.#   #.#
# ### # # # ##### ### # # # # ### ##### #
#     # #       #     #.#   #    . . . .#
####################### #################
