########### #############################
#. . .#  . .        #   #   #           #
# ### ### # ##### # ### # # # ######### #
#.#  . . .#     # #   #   # # #   # #   #
# # # ### # # # ### # ##### # # # # # ###
#.# # #   # # #   # #       #   # # # # #
# # ### # # # ### ### # ######### # ### #
#.# #   # # #   #   # #           # # # #
# ### ##### ####### # ############# # # #
#. .#     # #     # #   #     #       # #
# # ##### ### ##### ### # # ### ####### #
# #.    #     #       # # #       #     #
# # ########### # # ### # ##### # # #####
# #.  #         # # #   #     # #   #   #
# # ### # ### # ### # ### ### ####### # #
# #. .# # # # # #   #       # #       # #
# ### # ### # # # ####### # ### ####### #
# #. .#     # # # #     # #     #       #
### # ######### # # ### #################
#. .#     #     # #   #     #           #
# # ##### # ##### ### ##### # ##### #####
#.#   #   #     #   #   # #       # #   #
# ##### # ######### ### # ######### ### #
#. . .# # #         # #     #     #   # #
##### # ### ######### ### ### ### ##### #
#. . .#   #       #     # #   #   #     #
# # # ### ############# # # ### ##### ###
#.# #   #     #           #   # #   # # #
# ######### ### ### ########### # # # # #
#. . . .  #       #             # # # # #
# ##### # # ##### ####### ####### # # # #
#     #.# #   #   #   # #   #     #     #
####### # ### ##### # # # # ########### #
#. . . .#   #       # # # #     #     # #
# ####### ########### # # ### ### ##### #
#.#     # #         # #     #   # #     #
# ##### # ######### # ######### # # #####
 .# #   #         # #         # #   #   #
# # # ########### # ### ##### ### ### # #
#   #             #         #         # #
#########################################
