################################### #####
# #   #                . . .#  . . .    #
# ### # ##### # ####### ### ### ### # ###
#     # #     # #  . . .# #. .#.#   #   #
##### # ### ### # # ### # ### # # ##### #
# #   # #   #   # #.#   #    . .# #     #
# # ##### # ##### # ############# # ### #
# # #     # #     #.#. . . .#     #   # #
# # ### ### # ##### # ##### ######### ###
#       #   # #    . .    #. . . .  #   #
### ######### # ######### ####### ##### #
#   #     #   #   #. . .# #. . .#.#     #
# ### ### # ####### ### ### ### # # #####
# #     #   #  . . .#  . . .#  . .# #   #
# ##### ##### # ### ####### ##### # # # #
#   # #   #   #.#   #   #   #     #   # #
### # ### # ### # ### # # ### # # # # # #
# #   #   # #. .# #   # # #   # # # # # #
# ##### ##### ### # ####### ##### # ### #
#       #  . .#   # #       # #   #   # #
##### ### # ####### # ### # # # ##### # #
#   # #   #. . . .# # #   # #   #     # #
# ### # ### # ### # ### ######### # # # #
# # # # #   # #. .#   # #     #   # # # #
# # # # # ##### # ### # # ### ##### # # #
# #   # # #  . .#   #   # # # #     # # #
# ##### # # # # ### # ### # # # ##### # #
# #     # # #.#   # # #   #     #     # #
# ### ### ### ### # ### # ############# #
#   #   #   #. .# # #   # #             #
### # # ### # # ### # ### # #############
# # # # #   # #. .# # #   # #         # #
# # ### # ### ### # ####### # ##### # # #
#       #   # #. .# #   #   # #   # #   #
########### ### # # ### ### # ### #######
#     #     #. .# #   #     #     #     #
# ### # ##### ### # # ####### ##### ### #
# #   # # #  .#   # #       # #     # # #
##### # # # # # ######### ### # ##### # #
#       #   #.#         #           #   #
############# ###########################
