####### #################################
#      . .              #               #
# ### ### ### ### ####### ####### ### ###
# #   #. .  #   #               #   #   #
# ### # ### # ################# ##### # #
# #   #.#   #                 #   # # # #
### ### ######### ######### # ### # ### #
#   #  . . .    # #       # #   # #     #
# ##### ### ##### # ### # ### # ####### #
# #. .#   #.  #   # #   #   # #   #     #
# # # ##### ### ### # ##### # ### # #####
# #.#. . .#. .#     # #   # #   # # #   #
# # ##### # # ####### ### # ##### ### # #
# #. .# #.# #. . .  # #   # #     #   # #
# ### # # # ##### # # # ### # ### # ### #
# #. .# #.#   #. .# # # # # #   # # #   #
# # ### # ##### # # ### # # # # ### #####
# #.#   #. . .#.# #     #   # #   #     #
### # ####### # # # ############# ##### #
#. .#        . .# # #     # #       # # #
# # ######### # # # # # # # ####### # # #
#.# #       # # # # # # # #       # #   #
# # # ##### # # # ### # # # ### # ### ###
#.# # # #   # # #     # # #   # #       #
# # # # # ##### # ### # ##### ###########
 .# # #         #   # #         #       #
### # ############# ### ### ##### # ### #
#   #     #   #   #   #   #   #   #   # #
# # # ### # ### # ### ### ##### ### ### #
# # #   #     # #   #   #         #   # #
# ##### ### ### ####### ########### # # #
# #   #   #   #         # #       # # # #
# # ##### ### ### ####### ####### ### # #
# #       # # #   #     # #   #       # #
# ######### # ##### ### # # # ##### ### #
#   #       #       # # # # #       #   #
# ### ##### ######### # # ########### ###
#         #         # # #   #       # # #
# ############# ### # # ### ####### # # #
#             #   #   #             #   #
#########################################
