# #######################################
#. . . . .      #         #   #   #     #
# ####### ##### ######### # # ### # ### #
# #     #.    #         # # #     # #   #
# ##### # ### ### # # ### # ####### #####
#     # #. .#   # # #       #     #   # #
# ### # # # ### # ########### # # ### # #
#   #   # #. .# # #           # #   #   #
### # ### # # # ### ########### ####### #
#   #   # # #.#     #. . .  # #       # #
######### # # ####### ### # # ######### #
#   #     # #. .  #. .# #.# #. .      # #
# # # # ### # # # # ### # ### # ##### # #
# # # # # # # #.# #. .  #. . .#.#     # #
### # # # # # # ##### ### ### # ####### #
#   # # #   # #. . .#.# #   # #. . . .  #
# ### # ##### # # # # # ### # ####### ###
# #   #   #   # # #. .# # # #       #. . 
# # ### ### # # # ##### # # ######### ###
# #   # #   # # #     # # #         #   #
# ##### # ### # ##### # # ######### ### #
#       # #   #     # #   # #     #   # #
######### # ##### ### ### # # ##### ### #
#   #     #   # #   #   #   #     #   # #
# # # # # # # # # # ### ### ##### ### # #
# # # # # # #   # #   #   #   # # #   # #
# # # # # ####### # ### ##### # # # # # #
# # # # # #   #   #   #         # # # # #
# ### # # ### ####### ##### ##### # ### #
#     # #   # #     #     #       #   # #
# ### ### # # ##### # ### ########### # #
# #   #   # # #     #   #         #   # #
### ### ### # ##### ### ######### # # # #
#   #     # #     #   #   #     # # # # #
# # ##### # ##### ### # # # ##### # ### #
# # #   # #     # #     # # # #   # #   #
# ### # # ####### ####### # # # ### # ###
#   # # #         #       # # #   # #   #
### # # ########### ##### # # ######### #
#   # #             #     #             #
#########################################
