################# #######################
#           #    . . . . .          #   #
# ########### ### # ##### # ##### # # # #
#             #   #     #.# #   # # # # #
############### ######### # # ### # # # #
#          . .# #. . .#. .# #   # # # # #
# ######### # # # ### # # # ### # # # # #
# #. .#  . .#.# #.#  .#.# #   # # # # # #
### # ### ### ### ### # # # # # # # # ###
#. .#. .#.#  . . .#  . .# # # #   # #   #
# ##### # # # ### # # ### ### ##### ### #
#.#    . .# # #   # # #   #     #   # # #
# ########### # ### # # ### ### ##### # #
#. .#         # #   # # # #   #   #     #
# # # ######### ### # # # # # ### # #####
# #.# #         #   # #   # #   #       #
# # # # ######### # # ### # ### ####### #
# #.# # #         # #   # # #     #     #
### # # # ### ### ##### # # # # # # #####
 . .# # # #   #   #     # # # # # # #   #
##### # # # ####### # ##### # # # ### # #
# #   # # # #       # #     # # #     # #
# # ### # # ####### # # ##### # ####### #
# # #   # #   #   # # # #     # #     # #
# # # ####### ### ### # # # # # # ##### #
#   # #     #   # #   # # # # # # #     #
##### # ##### # # # ### # # ### # # #####
# #     #     # # # #   # #   #   # #   #
# ### ### # ##### # ### # # ####### ### #
#   #   # #     # # #   # #   #   #     #
### ### # # ### # ### ### ### ### #######
#   #   # #   # # #   # #   #   #       #
# ####### ### # # # # # ### # # ####### #
#     #   #   # #   # #   # # #     # # #
##### ### ##### ######### # # ##### # # #
#       #     #       #   # #     #   # #
####### ### # ##### # # ### # ######### #
#   #     # # #   # # #   # #         # #
# # ##### # # ### # # ### # ####### ### #
# #         #     # #   #         #     #
#########################################
