######### ##### #########################
#. . . .#.    #.#   #       #           #
# ##### # ##### # # # ##### # ####### ###
#. .#  . .#. . .# # #   # # # #     #   #
# # ##### # ##### # ### # # # # ### ### #
# #.#     #. . .# # # # #   #     #   # #
### # ### ##### ### # # ##### ### ### # #
#. .# # # #   #. .# #     #   # # #   # #
# ### # # # # ### # ##### # ### # ##### #
#.# # #   # #   #.#   # # # #   #   #   #
# # # ##### ### # ### # # # # ##### # ###
#.# #   #     # #.    #   # # #     # # #
# # ### # ##### # ##### ### # ##### # # #
#.#     # # #   #.#     # # # #   # #   #
# ####### # # ### # ##### # # # # #######
#. . . .  # # #. .  #         # #       #
# ### # ### # # ##### ######### ##### # #
#   # #. . .# #. .#   #         #   # # #
# # ### ### ##### # ### ####### # # ### #
# #   #   #. .  #.  #         # # #     #
# # # ### # # ### ### ### ### # # #######
# # #   # # #. . .#   #     # # #   #   #
# ### # # ##### ### ### # ### ######### #
# #   # #     #     #   # # #       #   #
### # # # # # ####### # ### ##### # # ###
#   # # # # #       # # #       # #     #
# ### # # ####### # # ### ##### ##### ###
# # # # # #     # # # #   #   #     #   #
# # # # ### ##### # # # ### ####### ### #
# # # #     #     # #   #   #   #   #   #
# # # ####### ### # # ### ### # # # #####
# #   #     #   # # # #   #   # # # #   #
# ######### ### # # ### ### ### # # # # #
#           # # # #   #   # # # # # # # #
# # ### ##### # # ### ### # # # # ### # #
# #   # #     # # # #   # #   # #     # #
# ### # # ##### ### # # # ### ##### ### #
# #   #   #   #     # # #   #     #   # #
# ########### # ##### ### ####### ##### #
#             #     #             #     #
#########################################
