##### ###################################
#. . .        # #     #     #           #
# ### # ##### # # # # ### ### ######### #
#. .# #     # #   # # # # #   #       # #
# # # ##### ### ### # # # # ##### ##### #
# #.#     #       # # #     #     #     #
# # ############### ### ##### ##### #####
# #.  #. .        #       #   #     #   #
### # # # ####### ### ##### ########### #
#. .# #.#.      #   #   #   # #         #
# ##### # ##### ### ##### ### # ####### #
#.#. . .#.    # # #   #       # #     # #
# # ##### ##### # # ### ####### # ##### #
#. .    #. . .#   #     #       #     # #
# ####### # # ####### ########### ##### #
#       # # #.  #   # #         #   #   #
####### # ### # ### ### ##### # ### # ###
#     # #   #.#   # #   # #   #   # #   #
# ##### ### # ### # # ### # # ##### ### #
#       #   #.#   #. . .  # # #     #   #
############# # ### ### ### ### ##### ###
#. . . . . . .#   #.# #. .#     #     # #
# ######### ####### # ### ####### ##### #
#.#   #     #. . .#. .# #. .  #. . .    #
# # # # ##### ### ### # # # ### ### #####
#.# # # #   #.# #.  #.  # #. . .  #. . . 
# # # # ### # # # ### ### ########### ###
#.# #   #   #.  #. . .  #           #   #
# ####### ### ####### # ######### # ### #
#. .    #. . .#     # #         # #   # #
# # ### # ######### # ##### ### ### ### #
# #.#   #.      # # #     #   #   #   # #
# # # ### ##### # # ####### ##### ### # #
# #.# #. .    #   # #   #   #     #   # #
# # # # ##### ##### # # # ### ##### # ###
# #.# #.#   #   #   # # #   # #     # # #
# # ### ### ### # ### ### # # # # ### # #
# #. . .    #   # #   #   # # # #   # # #
# ############### # ####### # ##### ### #
#                 #         #     #     #
#########################################
