############### #########################
#              .  #. . .    #   #     # #
##### ####### # ### ### ### ### ##### # #
#     #       #. . .  #.  # #         # #
# ##### ##### # ####### # # # ######### #
#   #   #     # #. . . .# #   #   #   # #
# # # ######### # ##### # ####### ### # #
# # # #   #   # #. .#   #       #   # # #
# # # ### # # # # # ######### ##### # # #
# # # #   # # # # #. . . .  #     #     #
### # # ### ### # ####### # # # # ##### #
#   #     #   # #       #.# # # #     # #
# ########### # ######### # # ####### # #
#           #   #. . . . .# # #     #   #
########### # ### # # ### # ### ### # ###
#       #   # #  .# # #   #       # #   #
##### # ##### # # # # # # ####### # ### #
#     #     # # #.# # # # #     # #   # #
# # ####### ### # ### # ### ### ### ### #
# # #   # # #   #. .# #   # #   #   #   #
# # # # # # # # # # ##### # # ### ### # #
# # # #   #   # # #. .  #   # #   #   # #
# # # ####### ### # # ####### # ### # # #
# # #   #     #   # #. .# #   # #   # # #
# # ### # ##### # ##### # # ### ##### # #
# #   #   # #   # #   #.#   #       # # #
# ### ##### # # ### # # ####### # # ### #
#   # #   #   # #   # #. .    # # #   # #
# ##### # ##### # ####### ### # # ### ###
#   #   #   #   # #. . . .  # # #   #   #
##### ##### ### # # # ### ### # # ##### #
#     #   #   #   #.# #   #   # #     # #
# ### # # ### ##### ### ### # # ####### #
# #   # # # #      . .# #   # #   #     #
# ##### # # ######### # ### # # ### #####
#     # #   #    . .#.#   # # #   #     #
# # ### ##### ### # # ### # ##### ##### #
# #   #       #  .#. .#   # #   # #   # #
# ### ######### # ######### # # # # # # #
#   #   #       #.#         # #   # #   #
################# #######################
