### ############### #####################
#  .              #.#   # #   #       # #
# # ############### # # # # ### ##### # #
# #. .    #. . .#. .# #   #     #   #   #
# ### ### # ### # ### ### ####### # ### #
#   #. .# #.# #.#.# #   # #       #   # #
####### # # # # # # ##### ########### # #
#. . .#.# #.# #.#. . . .# #         # # #
# ### # # # # # ####### # # ### ##### # #
#.# #. .# #.# #. .  # #. .# # #     # # #
# # ##### # # ### # # ### # # ##### # # #
#.#       #.#   #.# #. . .# #     # # # #
# ######### ### # # # ##### ##### # # # #
#. .#. . .#. . .#.# #.#     #   #   #   #
# # # ### ##### # # # # ##### # ####### #
# #. .  #.  #. .#.# #.# #   # #         #
# # # ### # # ### ### # # ### ###########
# # # #. .# #.  #. . .  # #   # #       #
# # ### # ### ########### # ### # ##### #
# #   #.# #. .          #   #     #   # #
# ### # ### ######### ### ### ##### ### #
#   # #. . .        #     # #     # #   #
# # # ##### ####### ####### # ##### #####
# # #     #       #               # #   #
### ##### ####### ########### # # # # ###
#       # #         #       # # #   #   #
# ##### # ######### # ##### # # ####### #
# #   # #         # #   #   # #     #   #
# # # # ##### ### ####### ### ####### ###
# # # # #   #   #           #     #   # #
# ### # ### # # ####### ######### # ### #
# #   #     # #       #     #   # # #   #
# # ####### ####### # ##### # # # # # ###
#         # #   #   # #   # # # #   #   #
# ####### # # ### ### # # # ### ####### #
#       # # #   # #   # #   #   #       #
##### # # # ### # # ######### ### #######
#   # # # #   # # # #     #       #     #
# ### # # ##### # # # ### # ### ### #####
#     # #       # #     #     #         #
#########################################
