### ##################### ###############
#  . . . . . .#. . . . .#. . .          #
# ##### ##### # ####### # ### ######### #
# #     #   #. .#     #.#   #. . .#     #
# # ##### # # # # ### # ##### ### #######
# #   #   # # # #   # #. . .#   #. . . .#
##### # ####### ### ####### ##### ##### #
#   # #   #     #       #  . . .#     #.#
# ### # ### # ### ##### ####### ##### # #
#     # #   # #   #   #   #  . .#     #.#
####### # ### # ### ##### ### ######### #
#       # #   # #     # #   #. . . . . .#
##### ### # # # ##### # ### ### ##### # #
#       # # # #   # # #     #   #     # #
# ##### ### # ### # # ##### ##### ##### #
# #   #     # # #   #             #     #
# ### ####### # ############### ##### # #
#   #   #     #                 #     # #
####### # ##### ##### ########### # ### #
#       # #     #     #   #       # #   #
# ####### ##### # ##### ### ### ### # ###
#   #     #     # #     #   #   #   #   #
### # ##### ##### ### ### ### # # ##### #
# #   #     #   #   # #   #   # #     # #
# ##### ### # # ### # # ### ### # # # ###
# #   #   # # # #   #   #   #   # # #   #
# # ####### # # # ########### # # ##### #
# #         # # # #       #   # #   # # #
# ### ####### # ### ### # # # # ### # # #
# #   # #     #     #   #   # #   #   # #
# ### # # ########### ####### ######### #
#     #   # #       #   #   # #         #
######### # # ##### # # # # # # # ### # #
#     #   # # #     # # # # # # # #   # #
### # ##### ####### # # # ### ### ### # #
#   #     #         # # # #   #   #   # #
# ####### ######### ### # # ### ### ### #
#     # # #       # #   #   #   #   # # #
# ### # # # ##### # ######### ##### # # #
#   #   #   #                 #     #   #
#########################################
