############################### #########
#   #          . .#          . .    #   #
# # # ######### # # ######### # # ### # #
# #   #    . . .#.# #   #  . .# #     # #
# ######### ##### # ### # # # # ### ### #
# #    . . .#    .#   # # #.# #   # #   #
# ##### ### ##### ### # # # # ### ### # #
#   #  .#   #. .#.  #   # #.#   #   # # #
### ### # ### # # ####### # ####### # ###
#   #. .#   #.#.#.#       #.#       #   #
# ### ####### # # # ####### # ####### # #
# #  . .  #. .#.#.#     #. .# #     # # #
# ### # ### ### # ####### # # ### ### # #
#   # #.#. .# #.#. . . . .# #   #   # # #
### # # # ### # ############### ### ### #
# # # #. .#   #. .#       #     # #     #
# # # # ### ### # ####### # ##### #######
# # # #     # # #. .    #   # #. . .    #
# # # ##### # # ### ### ##### # ### #####
# # #     #   #   #.#   #. .  #.# #. . . 
# ### ### ####### # ##### # ### # #######
#       # #     # #. . . .#. .#. . . .# #
####### # # ##### # ######### ####### # #
#     # #   #     #       #. .    #. .# #
# ##### ####### # ####### # ##### # ### #
#   #   #       # #     # #. .  # #.  # #
### ######### # # # ##### # # ### # ### #
# #         # # # # #     # #. .# #.#   #
# ##### ### # # # # # # # # ### # # # ###
#       #     # #   # # # # #. .# #.# # #
######### ########### # # # # ### # # # #
#         # #         # # # #. .# #.  # #
##### # ### # ####### ### # # # ### ### #
#     # #   #   #     #   # # #. .#.#   #
# ### ### ### # # ##### ### # ### # # ###
# #   #   # # # # #     #   # # #.#.#   #
# # ### ### # # # # ##### ### # # # ### #
# # #       # # # #   # #   #   #. .  # #
# ### ####### # ##### # # # ########### #
#     #       #     #   # #             #
#########################################
